Date,price,open,high,low,volume,last_highest,last_lowest,sma_3,rsi_14,macd,bollinger_upper,bollinger_lower,ema_20,stochastic_oscillator,atr,on_balance_volume,momentum_14,percent_change,volatility,atr_percent,ichimoku_a,ichimoku_b,parabolic_sar,support,resistance,volume_spike,days_since_last_halving,power_law_exponent,power_law_price
2010-07-18,0.1,0.0,0.1,0.1,80.0,0.1,0.1,,,,,,,,0.0,80.0,,,0.0,0.0,,0.1,0.1,,,0,,,
2010-07-19,0.1,0.1,0.1,0.1,570.0,0.1,0.1,,,,,,,,0.0,650.0,,0.0,0.0,0.0,,0.1,0.1,,,0,,5.373644740036853e-16,0.10000000000000006
2010-07-20,0.1,0.1,0.1,0.1,260.0,0.1,0.1,0.1,,,,,,,0.0,910.0,,0.0,0.0,0.0,,0.1,0.1,,,0,,1.8537338756461478e-16,0.10000000000000002
2010-07-21,0.1,0.1,0.1,0.1,580.0,0.1,0.1,0.1,,,,,,,0.0,1490.0,,0.0,0.0,0.0,,0.1,0.1,,,0,,-3.145841629705387e-16,0.09999999999999998
2010-07-22,0.1,0.1,0.1,0.1,2160.0,0.1,0.1,0.1,,,,,,,0.0,3650.0,,0.0,0.0,0.0,,0.1,0.1,,,0,,-4.085689612550168e-16,0.09999999999999998
2010-07-23,0.1,0.1,0.1,0.1,2400.0,0.1,0.1,0.1,,,,,,,0.0,6050.0,,0.0,0.0,0.0,,0.1,0.1,,,0,,4.4218182507901767e-16,0.10000000000000012
2010-07-24,0.1,0.1,0.1,0.1,500.0,0.1,0.1,0.1,,,,,,,0.0,6550.0,,0.0,0.0,0.0,,0.1,0.1,,,0,,-1.1978320692714865e-16,0.09999999999999998
2010-07-25,0.1,0.1,0.1,0.1,1550.0,0.1,0.1,0.1,,,,,,,0.0,8100.0,,0.0,0.0,0.0,,0.1,0.1,,,0,,-5.0254670815473005e-16,0.09999999999999994
2010-07-26,0.1,0.1,0.1,0.1,880.0,0.1,0.1,0.1,,,,,,,0.0,8980.0,,0.0,0.0,0.0,,0.1,0.1,,,0,,6.313715472715146e-16,0.10000000000000016
2010-07-27,0.1,0.1,0.1,0.1,3370.0,0.1,0.1,0.1,,,,,,,0.0,12350.0,,0.0,0.0,0.0,,0.1,0.1,,,0,,1.187378152783407e-16,0.10000000000000006
2010-07-28,0.1,0.1,0.1,0.1,4390.0,0.1,0.1,0.1,,,,,,,0.0,16740.0,,0.0,0.0,0.0,,0.1,0.1,,,0,,1.2043161532927204e-16,0.10000000000000006
2010-07-29,0.1,0.1,0.1,0.1,8060.000000000001,0.1,0.1,0.1,,,,,,,0.0,24800.0,,0.0,0.0,0.0,,0.1,0.1,,,0,,-1.8868687625750878e-16,0.09999999999999998
2010-07-30,0.1,0.1,0.1,0.1,3020.0,0.1,0.1,0.1,,,,,,,0.0,27820.0,,0.0,0.0,0.0,,0.1,0.1,,,0,,-1.469866781637851e-16,0.09999999999999998
2010-07-31,0.1,0.1,0.1,0.1,4019.9999999999995,0.1,0.1,0.1,100.0,,,,,,0.0,31840.0,,0.0,0.0,0.0,,0.1,0.1,,,0,,-2.3601722034101214e-16,0.09999999999999998
2010-08-01,0.1,0.1,0.1,0.1,2600.0,0.1,0.1,0.1,100.0,,,,,,0.0,34440.0,0.0,0.0,0.0,0.0,,0.1,0.1,,,0,,8.044443964028546e-16,0.10000000000000024
2010-08-02,0.1,0.1,0.1,0.1,3600.0,0.1,0.1,0.1,100.0,,,,,,0.0,38040.0,0.0,0.0,0.0,0.0,,0.1,0.1,,,0,,4.06238389444333e-16,0.10000000000000016
2010-08-03,0.1,0.1,0.1,0.1,9820.0,0.1,0.1,0.1,100.0,,,,,,0.0,47860.0,0.0,0.0,0.0,0.0,,0.1,0.1,,,0,,-1.9109710703781393e-16,0.09999999999999998
2010-08-04,0.1,0.1,0.1,0.1,3490.0,0.1,0.1,0.1,100.0,,,,,,0.0,51350.0,0.0,0.0,0.0,0.0,,0.1,0.1,,,0,,-1.7657139765282107e-16,0.09999999999999998
2010-08-05,0.1,0.1,0.1,0.1,5030.0,0.1,0.1,0.1,100.0,,,,,,0.0,56380.0,0.0,0.0,0.0,0.0,,0.1,0.1,,,0,,4.178366605291181e-16,0.10000000000000016
2010-08-06,0.1,0.1,0.1,0.1,1400.0,0.1,0.1,0.1,100.0,,0.1,0.1,0.1,,0.0,57780.0,0.0,0.0,0.0,0.0,,0.1,0.1,,,0,,-7.702097755283398e-17,0.09999999999999998
2010-08-07,0.1,0.1,0.1,0.1,2620.0,0.1,0.1,0.1,100.0,,0.1,0.1,0.1,,0.0,60400.0,0.0,0.0,0.0,0.0,,0.1,0.1,,,0,,-2.0231115851369905e-16,0.09999999999999998
2010-08-08,0.1,0.1,0.1,0.1,2200.0,0.1,0.1,0.1,100.0,,0.1,0.1,0.1,,0.0,62600.0,0.0,0.0,0.0,0.0,,0.1,0.1,,,0,,-3.723406089235973e-16,0.0999999999999999
2010-08-09,0.1,0.1,0.1,0.1,13630.0,0.1,0.1,0.1,100.0,,0.1,0.1,0.1,,0.0,76230.0,0.0,0.0,0.0,0.0,,0.1,0.1,,,1,,-2.3447563998209706e-16,0.09999999999999994
2010-08-10,0.1,0.1,0.1,0.1,1310.0,0.1,0.1,0.1,100.0,,0.1,0.1,0.1,,0.0,77540.0,0.0,0.0,0.0,0.0,,0.1,0.1,,,0,,-1.762446232153047e-17,0.10000000000000002
2010-08-11,0.1,0.1,0.1,0.1,14060.0,0.1,0.1,0.1,100.0,,0.1,0.1,0.1,,0.0,91600.0,0.0,0.0,0.0,0.0,,0.1,0.1,,,1,,-2.9489220534101095e-16,0.09999999999999994
2010-08-12,0.1,0.1,0.1,0.1,2060.0,0.1,0.1,0.1,100.0,,0.1,0.1,0.1,,0.0,93660.0,0.0,0.0,0.0,0.0,0.1,0.1,0.1,,,0,,-7.18130908045834e-17,0.09999999999999998
2010-08-13,0.1,0.1,0.1,0.1,3590.0,0.1,0.1,0.1,100.0,,0.1,0.1,0.1,,0.0,97250.0,0.0,0.0,0.0,0.0,0.1,0.1,0.1,,,0,,5.274141806736945e-16,0.1000000000000002
2010-08-14,0.1,0.1,0.1,0.1,4400.0,0.1,0.1,0.1,100.0,,0.1,0.1,0.1,,0.0,101650.0,0.0,0.0,0.0,0.0,0.1,0.1,0.1,,,0,,-6.302181196082562e-17,0.10000000000000002
2010-08-15,0.1,0.1,0.1,0.1,4460.0,0.1,0.1,0.1,100.0,,0.1,0.1,0.1,,0.0,106110.0,0.0,0.0,0.0,0.0,0.1,0.1,0.1,,,0,,-2.4768542936345623e-16,0.09999999999999994
2010-08-16,0.1,0.1,0.1,0.1,10730.0,0.1,0.1,0.1,100.0,,0.1,0.1,0.1,,0.0,116840.0,0.0,0.0,0.0,0.0,0.1,0.1,0.1,,,1,,1.2309804889133824e-17,0.10000000000000002
2010-08-17,0.1,0.1,0.1,0.1,13190.0,0.1,0.1,0.1,100.0,,0.1,0.1,0.1,,0.0,130030.0,0.0,0.0,0.0,0.0,0.1,0.1,0.1,,,1,,-2.5336071783124376e-17,0.10000000000000002
2010-08-18,0.1,0.1,0.1,0.1,2950.0,0.1,0.1,0.1,100.0,,0.1,0.1,0.1,,0.0,132980.0,0.0,0.0,0.0,0.0,0.1,0.1,0.1,,,0,,3.0777029691029625e-17,0.10000000000000002
2010-08-19,0.1,0.1,0.1,0.1,740.0,0.1,0.1,0.1,100.0,,0.1,0.1,0.1,,0.0,133720.0,0.0,0.0,0.0,0.0,0.1,0.1,0.1,,,0,,-1.8803907848496378e-16,0.09999999999999998
2010-08-20,0.1,0.1,0.1,0.1,4200.0,0.1,0.1,0.1,100.0,0.0,0.1,0.1,0.1,,0.0,137920.0,0.0,0.0,0.0,0.0,0.1,0.1,0.1,,,0,,1.8645991810931135e-16,0.10000000000000006
2010-08-21,0.1,0.1,0.1,0.1,10440.0,0.1,0.1,0.1,100.0,0.0,0.1,0.1,0.1,,0.0,148360.0,0.0,0.0,0.0,0.0,0.1,0.1,0.1,,,0,,3.5926649638485993e-17,0.10000000000000002
2010-08-22,0.1,0.1,0.1,0.1,18650.0,0.1,0.1,0.1,100.0,0.0,0.1,0.1,0.1,,0.0,167010.0,0.0,0.0,0.0,0.0,0.1,0.1,0.1,,,1,,1.0033034335331371e-16,0.10000000000000006
2010-08-23,0.1,0.1,0.1,0.1,4300.0,0.1,0.1,0.1,100.0,0.0,0.1,0.1,0.1,,0.0,171310.0,0.0,0.0,0.0,0.0,0.1,0.1,0.1,,,0,,1.6272577723156094e-16,0.10000000000000006
2010-08-24,0.1,0.1,0.1,0.1,6710.0,0.1,0.1,0.1,100.0,0.0,0.1,0.1,0.1,,0.0,178020.0,0.0,0.0,0.0,0.0,0.1,0.1,0.1,,,0,,4.046376183998132e-16,0.10000000000000016
2010-08-25,0.1,0.1,0.1,0.1,4230.0,0.1,0.1,0.1,100.0,0.0,0.1,0.1,0.1,,0.0,182250.0,0.0,0.0,0.0,0.0,0.1,0.1,0.1,,,0,,-9.278227037433703e-17,0.09999999999999998
2010-08-26,0.1,0.1,0.1,0.1,3870.0,0.1,0.1,0.1,100.0,0.0,0.1,0.1,0.1,,0.0,186120.0,0.0,0.0,0.0,0.0,0.1,0.1,0.1,,,0,,-2.579022942446749e-16,0.09999999999999994
2010-08-27,0.1,0.1,0.1,0.1,9010.0,0.1,0.1,0.1,100.0,0.0,0.1,0.1,0.1,,0.0,195130.0,0.0,0.0,0.0,0.0,0.1,0.1,0.1,,,0,,1.7230790010633568e-16,0.10000000000000006
2010-08-28,0.1,0.1,0.1,0.1,6170.0,0.1,0.1,0.1,100.0,0.0,0.1,0.1,0.1,,0.0,201300.0,0.0,0.0,0.0,0.0,0.1,0.1,0.1,,,0,,2.0211614677645668e-16,0.10000000000000012
2010-08-29,0.1,0.1,0.1,0.1,3170.0,0.1,0.1,0.1,100.0,0.0,0.1,0.1,0.1,,0.0,204470.0,0.0,0.0,0.0,0.0,0.1,0.1,0.1,,,0,,5.772411028405225e-17,0.10000000000000002
2010-08-30,0.1,0.1,0.1,0.0,34190.0,0.1,0.1,0.1,100.0,0.0,0.1,0.1,0.1,100.0,0.0071428571428571435,238660.0,0.0,0.0,7.142857142857142,7.142857142857142,0.05,0.05,0.1,,,1,,-2.0154766674306895e-16,0.09999999999999994
2010-08-31,0.1,0.1,0.1,0.1,14890.0,0.1,0.1,0.1,100.0,0.0,0.1,0.1,0.1,100.0,0.00663265306122449,253550.0,0.0,0.0,6.63265306122449,6.63265306122449,0.05,0.05,0.0,,,0,,-4.1610398098061844e-18,0.10000000000000002
2010-09-01,0.1,0.1,0.1,0.1,7170.0,0.1,0.1,0.1,100.0,0.0,0.1,0.1,0.1,100.0,0.006158892128279884,260720.0,0.0,0.0,6.158892128279883,6.158892128279883,0.05,0.05,0.0,,,0,,-2.5275570564844526e-16,0.09999999999999994
2010-09-02,0.1,0.1,0.1,0.1,8150.0,0.1,0.1,0.1,100.0,0.0,0.1,0.1,0.1,100.0,0.005718971261974177,268870.0,0.0,0.0,5.718971261974177,5.718971261974177,0.05,0.05,0.002,,,0,,1.6172876752242694e-17,0.10000000000000002
2010-09-03,0.1,0.1,0.1,0.1,890.0,0.1,0.1,0.1,100.0,0.0,0.1,0.1,0.1,100.0,0.005310473314690307,269760.0,0.0,0.0,5.310473314690307,5.310473314690307,0.05,0.05,0.00396,,,0,,1.8150794914207636e-16,0.10000000000000012
2010-09-04,0.1,0.1,0.1,0.1,3300.0,0.1,0.1,0.1,100.0,0.0,0.1,0.1,0.1,100.0,0.004931153792212428,273060.0,0.0,0.0,4.931153792212428,4.931153792212428,0.05,0.05,0.0058808,,,0,,4.837197789577799e-16,0.1000000000000002
2010-09-05,0.1,0.1,0.1,0.1,8460.0,0.1,0.1,0.1,100.0,0.0,0.1,0.1,0.1,100.0,0.004578928521340112,281520.0,0.0,0.0,4.578928521340112,4.578928521340112,0.05,0.05,0.007763184,,,0,,-2.547739635095987e-16,0.09999999999999994
2010-09-06,0.1,0.1,0.1,0.1,910.0,0.1,0.1,0.1,100.0,0.0,0.1,0.1,0.1,100.0,0.004251862198387247,282430.0,0.0,0.0,4.251862198387247,4.251862198387247,0.05,0.05,0.009607920320000001,,,0,,-2.0330455403633014e-16,0.09999999999999994
2010-09-07,0.1,0.1,0.1,0.1,3460.0,0.1,0.1,0.1,100.0,0.0,0.1,0.1,0.1,100.0,0.003948157755645301,285890.0,0.0,0.0,3.948157755645301,3.948157755645301,0.05,0.05,0.011415761913600001,,,0,,-3.0325731366689204e-16,0.0999999999999999
2010-09-08,0.1,0.1,0.1,0.1,2350.0,0.1,0.1,0.1,100.0,0.0,0.1,0.1,0.1,100.0,0.0036661464873849227,288240.0,0.0,0.0,3.6661464873849225,3.6661464873849225,0.07500000000000001,0.05,0.013187446675328002,,,0,,2.9230148251919414e-16,0.10000000000000016
2010-09-09,0.1,0.1,0.1,0.1,1730.0,0.1,0.1,0.1,100.0,0.0,0.1,0.1,0.1,100.0,0.003404278881143142,289970.0,0.0,0.0,3.404278881143142,3.404278881143142,0.07500000000000001,0.05,0.014923697741821442,,,0,,1.350097996498885e-16,0.10000000000000006
2010-09-10,0.1,0.1,0.1,0.1,4940.0,0.1,0.1,0.1,100.0,0.0,0.1,0.1,0.1,100.0,0.0031611161039186322,294910.0,0.0,0.0,3.1611161039186317,3.1611161039186317,0.07500000000000001,0.05,0.016625223786985013,,,0,,4.957899798815215e-16,0.1000000000000002
2010-09-11,0.1,0.1,0.1,0.1,7750.0,0.1,0.1,0.1,100.0,0.0,0.1,0.1,0.1,100.0,0.002935322096495873,302660.0,0.0,0.0,2.935322096495873,2.935322096495873,0.07500000000000001,0.05,0.018292719311245313,,,0,,-2.3466617115572483e-16,0.09999999999999994
2010-09-12,0.1,0.1,0.1,0.1,790.0,0.1,0.1,0.1,100.0,0.0,0.1,0.1,0.1,100.0,0.0027256562324604536,303450.0,0.0,0.0,2.7256562324604534,2.7256562324604534,0.07500000000000001,0.05,0.019926864925020406,,,0,,-1.130429744426436e-16,0.09999999999999998
2010-09-13,0.1,0.1,0.1,0.1,10080.0,0.1,0.1,0.1,100.0,0.0,0.1,0.1,0.1,,0.002530966501570421,313530.0,0.0,0.0,2.5309665015704206,2.5309665015704206,0.07500000000000001,0.05,0.02152832762652,,,0,,1.4607057847724498e-16,0.10000000000000006
2010-09-14,0.1,0.1,0.2,0.1,14020.0,0.1,0.1,0.1,100.0,0.0,0.1,0.1,0.1,0.0,0.009493040322886821,327550.0,0.0,0.0,9.49304032288682,9.49304032288682,0.125,0.1,0.0230977610739896,,,0,,3.4348329702900346e-16,0.10000000000000016
2010-09-15,0.1,0.1,0.1,0.1,3650.0,0.1,0.1,0.1,100.0,0.0,0.1,0.1,0.1,0.0,0.00881496601410919,331200.0,0.0,0.0,8.814966014109189,8.814966014109189,0.125,0.1,0.03017385063103002,,,0,,-7.290784428461447e-17,0.09999999999999998
2010-09-16,0.1,0.1,0.1,0.1,730.0,0.1,0.1,0.1,100.0,0.0,0.1,0.1,0.1,0.0,0.008185325584529963,331930.0,0.0,0.0,8.185325584529963,8.185325584529963,0.125,0.1,0.03696689660578882,,,0,,6.162429275218481e-16,0.10000000000000028
2010-09-17,0.1,0.1,0.1,0.1,7260.0,0.1,0.1,0.1,100.0,0.0,0.1,0.1,0.1,0.0,0.007600659471349251,339190.0,0.0,0.0,7.6006594713492515,7.6006594713492515,0.125,0.1,0.04348822074155727,,,0,,5.473437387282933e-16,0.10000000000000024
2010-09-18,0.1,0.1,0.1,0.1,7090.0,0.1,0.1,0.1,100.0,0.0,0.1,0.1,0.1,0.0,0.007057755223395733,346280.0,0.0,0.0,7.057755223395732,7.057755223395732,0.125,0.1,0.049748691911894974,,,0,,1.657442894211534e-16,0.10000000000000012
2010-09-19,0.1,0.1,0.1,0.1,12850.0,0.1,0.1,0.1,100.0,0.0,0.1,0.1,0.1,0.0,0.0065536298502960385,359130.0,0.0,0.0,6.553629850296037,6.553629850296037,0.125,0.1,0.055758744235419176,,,1,,-1.0403340094355954e-16,0.09999999999999998
2010-09-20,0.1,0.1,0.1,0.1,14310.0,0.1,0.1,0.1,100.0,0.0,0.1,0.1,0.1,0.0,0.00608551343241775,373440.0,0.0,0.0,6.085513432417749,6.085513432417749,0.125,0.1,0.06152839446600241,,,1,,2.7799571118872835e-16,0.10000000000000016
2010-09-21,0.1,0.1,0.1,0.1,5740.0,0.1,0.1,0.1,100.0,0.0,0.1,0.1,0.1,0.0,0.005650833901530768,379180.0,0.0,0.0,5.650833901530768,5.650833901530768,0.125,0.1,0.06706725868736231,,,0,,1.3966251173847843e-16,0.10000000000000006
2010-09-22,0.1,0.1,0.1,0.1,11560.0,0.1,0.1,0.1,100.0,0.0,0.1,0.1,0.1,0.0,0.005247202908564284,390740.0,0.0,0.0,5.247202908564284,5.247202908564284,0.125,0.1,0.07238456833986782,,,0,,1.0608194502983597e-16,0.10000000000000006
2010-09-23,0.1,0.1,0.1,0.1,15510.0,0.1,0.1,0.1,100.0,0.0,0.1,0.1,0.1,0.0,0.004872402700809692,406250.0,0.0,0.0,4.872402700809691,4.872402700809691,0.1,0.1,0.07748918560627312,,,1,,-5.358862223658167e-16,0.0999999999999998
2010-09-24,0.1,0.1,0.1,0.1,680.0,0.1,0.1,0.1,100.0,0.0,0.1,0.1,0.1,0.0,0.004524373936466143,406930.0,0.0,0.0,4.5243739364661435,4.5243739364661435,0.1,0.1,0.08238961818202219,,,0,,1.5961738590704528e-16,0.10000000000000012
2010-09-25,0.1,0.1,0.1,0.1,2150.0,0.1,0.1,0.1,100.0,0.0,0.1,0.1,0.1,0.0,0.004201204369575704,409080.0,0.0,0.0,4.201204369575704,4.201204369575704,0.125,0.1,0.0870940334547413,,,0,,2.4445876876865075e-16,0.10000000000000012
2010-09-26,0.1,0.1,0.1,0.1,12060.0,0.1,0.1,0.1,100.0,0.0,0.1,0.1,0.1,0.0,0.00390111834317744,421140.0,0.0,0.0,3.9011183431774397,3.9011183431774397,0.125,0.1,0.09161027211655165,,,0,,-1.0984159213532108e-16,0.09999999999999998
2010-09-27,0.1,0.1,0.1,0.1,10750.0,0.1,0.1,0.1,100.0,0.0,0.1,0.1,0.1,0.0,0.00362246703295048,431890.0,0.0,0.0,3.62246703295048,3.62246703295048,0.125,0.1,0.09594586123188958,,,0,,1.2387861653533837e-16,0.10000000000000006
2010-09-28,0.1,0.1,0.1,0.1,7090.0,0.1,0.1,0.1,100.0,0.0,0.1,0.1,0.1,,0.003363719387739731,438980.0,0.0,0.0,3.363719387739731,3.363719387739731,0.125,0.1,0.2,,,0,,3.824876190402859e-16,0.1000000000000002
2010-09-29,0.1,0.1,0.1,0.1,23480.0,0.1,0.1,0.1,100.0,0.0,0.1,0.1,0.1,,0.0031234537171868936,462460.0,0.0,0.0,3.1234537171868935,3.1234537171868935,0.125,0.1,0.198,,,1,,9.790818163373128e-17,0.10000000000000006
2010-09-30,0.1,0.1,0.1,0.1,7920.0,0.1,0.1,0.1,100.0,0.0,0.1,0.1,0.1,,0.002900349880244973,470380.0,0.0,0.0,2.9003498802449728,2.9003498802449728,0.125,0.1,0.19604000000000002,,,0,,2.2124405178565397e-16,0.10000000000000012
2010-10-01,0.1,0.1,0.1,0.1,1720.0,0.1,0.1,0.1,100.0,0.0,0.1,0.1,0.1,,0.002693182031656046,472100.0,0.0,0.0,2.6931820316560455,2.6931820316560455,0.125,0.1,0.19411920000000002,,,0,,7.628831267478398e-17,0.10000000000000006
2010-10-02,0.1,0.1,0.1,0.1,13060.0,0.1,0.1,0.1,100.0,0.0,0.1,0.1,0.1,,0.002500811886537757,485160.0,0.0,0.0,2.500811886537757,2.500811886537757,0.125,0.1,0.19223681600000003,,,0,,-1.5036424402597171e-16,0.09999999999999998
2010-10-03,0.1,0.1,0.1,0.1,7170.0,0.1,0.1,0.1,100.0,0.0,0.1,0.1,0.1,,0.0023221824660707747,492330.0,0.0,0.0,2.3221824660707746,2.3221824660707746,0.125,0.1,0.19039207968000002,,,0,,-4.411107870572282e-18,0.10000000000000002
2010-10-04,0.1,0.1,0.1,0.1,34000.0,0.1,0.1,0.1,100.0,0.0,0.1,0.1,0.1,,0.0021563122899228623,526330.0,0.0,0.0,2.1563122899228624,2.1563122899228624,0.125,0.1,0.1885842380864,,,1,,3.654816446016959e-17,0.10000000000000002
2010-10-05,0.1,0.1,0.1,0.1,27530.0,0.1,0.1,0.1,100.0,0.0,0.1,0.1,0.1,,0.0020022899834998007,553860.0,0.0,0.0,2.0022899834998005,2.0022899834998005,0.125,0.1,0.186812553324672,,,1,,1.3555638153427265e-16,0.10000000000000006
2010-10-06,0.1,0.1,0.1,0.1,33430.0,0.1,0.1,0.1,100.0,0.0,0.1,0.1,0.1,,0.001859269270392672,587290.0,0.0,0.0,1.859269270392672,1.859269270392672,0.125,0.1,0.18507630225817856,,,1,,-2.2098635184238142e-16,0.09999999999999994
2010-10-07,0.1,0.1,0.1,0.1,43690.0,0.1,0.1,0.1,100.0,0.0,0.1,0.1,0.1,,0.001726464322507481,630980.0,0.0,0.0,1.726464322507481,1.726464322507481,0.125,0.1,0.18337477621301498,,,1,,2.9468670117364834e-16,0.10000000000000016
2010-10-08,0.1,0.1,0.1,0.0,139290.0,0.1,0.1,0.1,100.0,0.0,0.1,0.1,0.1,100.0,0.008746002585185519,770270.0,0.0,0.0,8.746002585185519,8.746002585185519,0.07500000000000001,0.1,0.1817072806887547,,,1,,-5.40750217203554e-17,0.09999999999999998
2010-10-09,0.1,0.1,0.1,0.1,187850.0,0.1,0.1,0.1,100.0,0.0,0.1,0.1,0.1,100.0,0.008121288114815125,958120.0,0.0,0.0,8.121288114815124,8.121288114815124,0.07500000000000001,0.1,0.1744389894612045,,,1,,-1.8270746564136448e-16,0.09999999999999994
2010-10-10,0.1,0.1,0.1,0.1,50680.0,0.1,0.1,0.1,100.0,0.0,0.1,0.1,0.1,100.0,0.007541196106614045,1008800.0,0.0,0.0,7.541196106614044,7.541196106614044,0.05,0.1,0.16746142988275634,,,0,,-1.8125174473865425e-16,0.09999999999999994
2010-10-11,0.1,0.1,0.1,0.1,14090.0,0.1,0.1,0.1,100.0,0.0,0.1,0.1,0.1,100.0,0.0070025392418558985,1022890.0,0.0,0.0,7.0025392418558985,7.0025392418558985,0.05,0.1,0.16076297268744608,,,0,,-1.3395166052054938e-16,0.09999999999999998
2010-10-12,0.1,0.1,0.1,0.1,25660.0,0.1,0.1,0.1,100.0,0.0,0.1,0.1,0.1,100.0,0.00650235786743762,1048550.0,0.0,0.0,6.5023578674376195,6.5023578674376195,0.05,0.1,0.15433245377994823,,,0,,4.597413555235802e-16,0.10000000000000024
2010-10-13,0.1,0.1,0.1,0.1,47560.0,0.1,0.1,0.1,100.0,0.0,0.1,0.1,0.1,100.0,0.006037903734049219,1096110.0,0.0,0.0,6.037903734049219,6.037903734049219,0.05,0.1,0.1481591556287503,,,0,,-7.610902105485827e-17,0.09999999999999998
2010-10-14,0.1,0.1,0.1,0.1,37220.0,0.1,0.1,0.1,100.0,0.0,0.1,0.1,0.1,100.0,0.005606624895902847,1133330.0,0.0,0.0,5.606624895902847,5.606624895902847,0.05,0.1,0.1422327894036003,,,0,,6.135535773304606e-17,0.10000000000000006
2010-10-15,0.1,0.1,0.1,0.1,24640.0,0.1,0.1,0.1,100.0,0.0,0.1,0.1,0.1,100.0,0.005206151689052643,1157970.0,0.0,0.0,5.206151689052643,5.206151689052643,0.05,0.1,0.13654347782745627,,,0,,2.0431579535397094e-16,0.10000000000000012
2010-10-16,0.1,0.1,0.1,0.1,6290.0,0.1,0.1,0.1,100.0,0.0,0.1,0.1,0.1,100.0,0.004834283711263168,1164260.0,0.0,0.0,4.8342837112631685,4.8342837112631685,0.05,0.1,0.13108173871435802,,,0,,1.2649693875570028e-16,0.10000000000000006
2010-10-17,0.1,0.1,0.1,0.1,18220.0,0.1,0.1,0.1,100.0,0.0,0.1,0.1,0.1,100.0,0.004488977731887228,1182480.0,0.0,0.0,4.4889777318872275,4.4889777318872275,0.07500000000000001,0.1,0.1258384691657837,,,0,,-1.337693495570941e-16,0.09999999999999998
2010-10-18,0.1,0.1,0.1,0.1,25670.0,0.1,0.1,0.1,100.0,0.0,0.1,0.1,0.1,100.0,0.004168336465323855,1208150.0,0.0,0.0,4.168336465323855,4.168336465323855,0.07500000000000001,0.1,0.12080493039915235,,,0,,2.691963082314033e-16,0.10000000000000016
2010-10-19,0.1,0.1,0.1,0.1,6240.0,0.1,0.1,0.1,100.0,0.0,0.1,0.1,0.1,100.0,0.0038705981463721508,1214390.0,0.0,0.0,3.8705981463721506,3.8705981463721506,0.07500000000000001,0.1,0.11597273318318627,,,0,,-1.8617595629265412e-16,0.09999999999999994
2010-10-20,0.1,0.1,0.1,0.1,31860.0,0.1,0.1,0.1,100.0,0.0,0.1,0.1,0.1,100.0,0.003594126850202711,1246250.0,0.0,0.0,3.594126850202711,3.594126850202711,0.07500000000000001,0.1,0.11133382385585881,,,0,,5.529654225345566e-17,0.10000000000000006
2010-10-21,0.1,0.1,0.1,0.1,44870.0,0.1,0.1,0.1,100.0,0.0,0.1,0.1,0.1,100.0,0.0033374035037596604,1291120.0,0.0,0.0,3.3374035037596603,3.3374035037596603,0.07500000000000001,0.1,0.10688047090162446,,,0,,-4.02402753544217e-17,0.10000000000000002
2010-10-22,0.1,0.1,0.1,0.1,34600.0,0.1,0.1,0.1,100.0,0.0,0.1,0.1,0.1,,0.003099017539205399,1325720.0,0.0,0.0,3.099017539205399,3.099017539205399,0.07500000000000001,0.1,0.10260525206555948,,,0,,-1.9978730317906807e-17,0.10000000000000002
2010-10-23,0.1,0.1,0.1,0.1,4420.0,0.1,0.1,0.1,100.0,0.0,0.1,0.1,0.1,,0.0028776591435478705,1330140.0,0.0,0.0,2.8776591435478704,2.8776591435478704,0.07500000000000001,0.1,0.0,,,0,,3.534430139563746e-16,0.1000000000000002
2010-10-24,0.1,0.1,0.2,0.1,13800.0,0.1,0.1,0.1,100.0,0.0,0.1,0.1,0.1,0.0,0.009814969204723023,1343940.0,0.0,0.0,9.814969204723024,9.814969204723024,0.125,0.1,0.002,,,0,,1.8023973461231958e-16,0.10000000000000012
2010-10-25,0.1,0.1,0.2,0.1,30300.0,0.1,0.1,0.1,100.0,0.0,0.1,0.1,0.1,0.0,0.01625675711867138,1374240.0,0.0,0.0,16.256757118671377,16.256757118671377,0.125,0.1,0.00992,,,0,,4.2538533047392674e-17,0.10000000000000002
2010-10-26,0.2,0.1,0.2,0.1,19220.0,0.2,0.1,0.13333333333333333,100.0,0.006381766381766374,0.14858898943540674,0.06141101056459327,0.10952380952380954,100.0,0.022238417324480564,1393460.0,100.0,1.0,11.119208662240283,11.119208662240283,0.125,0.1,0.0175232,,,0,,0.007782989538251829,0.10365723313662702
2010-10-27,0.2,0.2,0.2,0.2,65610.0,0.2,0.1,0.16666666666666666,100.0,0.01003264583891363,0.17,0.05000000000000001,0.11814058956916101,100.0,0.020649958944160524,1459070.0,100.0,0.0,10.324979472080262,10.324979472080262,0.125,0.1,0.024822272,,,0,,0.01532273516241425,0.10734386997631822
2010-10-28,0.2,0.2,0.2,0.2,21530.0,0.2,0.1,0.2,100.0,0.011757606714582694,0.18641428428542853,0.04358571571457151,0.1259367238959076,100.0,0.01917496187672049,1480600.0,100.0,0.0,9.587480938360244,9.587480938360244,0.125,0.1,0.03182938112,,,0,,0.022628373957906837,0.11105733136175386
2010-10-29,0.2,0.2,0.2,0.2,28690.0,0.2,0.1,0.2,100.0,0.012158215871137294,0.2,0.04000000000000002,0.1329903692391545,100.0,0.017805321742669026,1509290.0,100.0,0.0,8.902660871334513,8.902660871334513,0.125,0.1,0.0385562058752,,,0,,0.029708623835438944,0.1147950825635123
2010-10-30,0.2,0.2,0.2,0.2,26710.0,0.2,0.1,0.2,100.0,0.01168003539982096,0.2116025403784439,0.03839745962155612,0.1393722388354255,100.0,0.016533513046764096,1536000.0,100.0,0.0,8.266756523382048,8.266756523382048,0.125,0.1,0.045013957640192,,,0,,0.036571806399983336,0.11855463662809605
2010-10-31,0.2,0.2,0.2,0.2,40340.0,0.2,0.1,0.2,100.0,0.0106494924618971,0.2216515138991168,0.03834848610088319,0.14514631132728972,100.0,0.01535254782913809,1576340.0,100.0,0.0,7.676273914569045,7.676273914569045,0.125,0.1,0.05121339933458432,,,0,,0.04322586837259992,0.12233355733166494
2010-11-01,0.2,0.2,0.2,0.2,21260.0,0.2,0.1,0.2,100.0,0.009302489847148796,0.23039392014169457,0.03960607985830543,0.15037047215326216,100.0,0.01425593726991394,1597600.0,100.0,0.0,7.12796863495697,7.12796863495697,0.125,0.1,0.05716486336120095,,,0,,0.0496784016692214,0.12612946176141646
2010-11-02,0.2,0.2,0.2,0.2,5850.0,0.2,0.1,0.2,100.0,0.007806546284629203,0.23797958971132716,0.04202041028867287,0.1550970938529515,100.0,0.013237656036348659,1603450.0,100.0,0.0,6.618828018174329,6.618828018174329,0.125,0.1,0.0628782688267529,,,0,,0.055936662232125976,0.1299400225463908
2010-11-03,0.2,0.2,0.3,0.1,61470.0,0.2,0.1,0.2,100.0,0.006277876556904392,0.24449874371066202,0.045501256289338016,0.15937356110505135,50.00000000000001,0.026577823462323753,1664920.0,100.0,0.0,13.288911731161877,13.288911731161877,0.2,0.15,0.06836313807368279,,,1,,0.06200758770218643,0.13376296975917662
2010-11-04,0.2,0.2,0.2,0.2,29700.0,0.2,0.1,0.2,100.0,0.004794521545417388,0.25,0.049999999999999975,0.16324274576171316,50.00000000000001,0.024679407500729198,1694620.0,100.0,0.0,12.339703750364599,12.339703750364599,0.2,0.15,0.08226134978926182,,,0,,0.06789781401302837,0.13759609250957675
2010-11-05,0.3,0.2,0.3,0.2,36620.0,0.3,0.1,0.2333333333333333,100.0,0.009788167538338787,0.276619037896906,0.04338096210309399,0.17626724616535955,100.00000000000001,0.03005944982210568,1731240.0,199.99999999999997,0.4999999999999998,10.019816607368561,10.019816607368561,0.2,0.15,0.09532566880190611,,,0,,0.07772551605543493,0.14420283015651306
2010-11-06,0.4,0.3,0.5,0.2,32759.999999999996,0.4,0.1,0.3,100.0,0.018557387892141702,0.32829709716755895,0.021702902832441057,0.19757512748294437,75.0,0.04934091769195527,1764000.0,300.00000000000006,0.3333333333333335,12.335229422988817,12.335229422988817,0.3,0.25,0.10760612867379174,,0.4,0,,0.09015764980380604,0.15302157963701998
2010-11-07,0.3,0.4,0.5,0.3,77220.0,0.4,0.1,0.3333333333333333,68.76719190440191,0.016427539284606316,0.34342979517754857,0.0265702048224514,0.20732987724647345,50.0,0.06010228071395846,1686780.0,199.99999999999997,-0.2500000000000001,20.034093571319488,20.034093571319488,0.3,0.25,0.1389976383798884,,0.4,1,,0.09937160573952745,0.15996232271738733
2010-11-08,0.2,0.3,0.4,0.2,118200.0,0.4,0.1,0.3,51.458840248744266,0.007540573900593803,0.3436229149573722,0.03637708504262785,0.20663179369919027,25.0,0.07009497494867571,1568580.0,100.0,-0.33333333333333326,35.04748747433785,35.04748747433785,0.3,0.25,0.16787782730949732,,0.4,1,,0.10432559438973624,0.1639033466287438
2010-11-09,0.2,0.2,0.3,0.2,47980.0,0.4,0.1,0.2333333333333333,51.458840248744266,0.0012488279271807151,0.34298648586948743,0.04701351413051261,0.20600019429926741,25.0,0.07223104816662744,1616560.0,0.0,0.0,36.115524083313716,36.115524083313716,0.3,0.25,0.19444760112473755,0.2,0.4,0,,0.1091343598929248,0.16783902181528515
2010-11-10,0.2,0.2,0.2,0.1,30390.0,0.4,0.1,0.2,51.458840248744266,-0.003089307408337981,0.3414213562373095,0.05857864376269051,0.2054287472231467,25.0,0.07421454472615406,1646950.0,0.0,0.0,37.10727236307703,37.10727236307703,0.3,0.25,0.5,0.2,0.4,0,,0.11380283025522374,0.17176756620133288
2010-11-11,0.2,0.2,0.2,0.2,5030.0,0.4,0.1,0.2,51.458840248744266,-0.005968504064549074,0.3387908816025965,0.07120911839740349,0.20491172367808508,25.0,0.06891350581714305,1651980.0,0.0,0.0,34.45675290857152,34.45675290857152,0.3,0.25,0.492,0.2,0.4,0,,0.11833573093605293,0.17568726646583335
2010-11-12,0.3,0.2,0.3,0.2,40720.0,0.4,0.1,0.2333333333333333,63.735808923056126,-0.00138696416471,0.34576696830622017,0.08423303169377983,0.21396774999445795,50.0,0.07113396968734712,1692700.0,49.999999999999986,0.4999999999999998,23.711323229115706,23.711323229115706,0.3,0.25,0.48416,0.2,0.4,0,,0.1265876884402953,0.1829257119650155
2010-11-13,0.3,0.3,0.3,0.3,21920.0,0.4,0.1,0.26666666666666666,63.735808923056126,0.0012520437679090016,0.34949899597988726,0.10050100402011274,0.22216129761403336,50.0,0.0660529718525366,1714620.0,49.999999999999986,0.0,22.017657284178867,22.017657284178867,0.3,0.25,0.4764768,0.2,0.4,0,,0.1346103701450723,0.19027868646378332
2010-11-14,0.3,0.3,0.3,0.3,16840.0,0.4,0.1,0.3,63.735808923056126,0.002532315478981209,0.34945523142259594,0.12054476857740412,0.22957450736507778,50.0,0.061334902434498274,1731460.0,49.999999999999986,0.0,20.44496747816609,20.44496747816609,0.3,0.25,0.468947264,0.2,0.4,0,,0.14241124368587504,0.19774193840420878
2010-11-15,0.3,0.3,0.3,0.3,8510.0,0.4,0.1,0.3,63.735808923056126,0.0028880720316282957,0.35661903789690597,0.12338096210309411,0.23628169713983227,50.0,0.05695383797489125,1739970.0,49.999999999999986,0.0,18.984612658297085,18.984612658297085,0.3,0.25,0.46156831872,0.2,0.4,0,,0.1499974811122041,0.20531116118011214
2010-11-16,0.2,0.3,0.3,0.2,33930.0,0.4,0.1,0.26666666666666666,47.55734363323863,-0.0037426378346634703,0.35661903789690597,0.12338096210309411,0.2328262974122292,25.0,0.06002856383382759,1706040.0,0.0,-0.33333333333333326,30.01428191691379,30.01428191691379,0.275,0.25,0.4543369523456,0.2,0.4,0,,0.15366121214161602,0.2092148852528162
2010-11-17,0.2,0.2,0.3,0.2,32870.0,0.4,0.1,0.2333333333333333,47.55734363323863,-0.008014440123630527,0.3566190378969059,0.12338096210309406,0.22969998337296926,25.0,0.06288366641712562,1738910.0,0.0,0.0,31.44183320856281,31.44183320856281,0.25,0.25,0.447250213298688,0.2,0.4,0,,0.1572194779721861,0.21309526052567201
2010-11-18,0.3,0.2,0.3,0.2,37450.0,0.4,0.1,0.2333333333333333,59.484658620927924,-0.004183756995995529,0.36289826122551594,0.1271017387744841,0.2363952230517341,50.0,0.06553483310161665,1776360.0,49.999999999999986,0.4999999999999998,21.84494436720555,21.84494436720555,0.25,0.25,0.44030520903271425,0.2,0.4,0,,0.1643262247466216,0.22080254881438005
2010-11-19,0.3,0.3,0.3,0.3,2160.0,0.4,0.1,0.26666666666666666,59.484658620927924,-0.0018476344732016765,0.36832159566199224,0.13167840433800776,0.24245282085633085,50.0,0.06085377359435832,1778520.0,0.0,0.0,20.28459119811944,20.28459119811944,0.275,0.25,0.43349910485205995,0.2,0.4,0,,0.17124171659282736,0.22860118123680356
2010-11-20,0.3,0.3,0.3,0.3,14650.0,0.4,0.1,0.3,59.48465862092793,-0.0005665258532735855,0.3728982612255159,0.13710173877448412,0.24793350458429936,50.0,0.05650707548047558,1793170.0,-25.000000000000007,0.0,18.835691826825194,18.835691826825194,0.275,0.25,0.4268291227550188,0.2,0.4,0,,0.17797191577908486,0.2364868354245735
2010-11-21,0.3,0.3,0.3,0.3,770.0,0.4,0.1,0.3,59.48465862092793,-1.2546112418243549e-05,0.37661903789690593,0.1433809621030941,0.2528922184334137,66.66666666666666,0.05247085580329875,1793940.0,0.0,0.0,17.49028526776625,17.49028526776625,0.275,0.25,0.4202925402999184,0.2,0.4,0,,0.18452255924744163,0.24445518132670904
2010-11-22,0.3,0.3,0.3,0.3,28210.0,0.4,0.1,0.3,59.48465862092793,5.6671395565820876e-05,0.3794552314225959,0.15054476857740412,0.2573786738207076,100.00000000000001,0.04872293753163455,1822150.0,49.999999999999986,0.0,16.240979177211518,16.240979177211518,0.275,0.25,0.41388668949392005,0.2,0.4,0,,0.1908991687226704,0.25250188902828935
2010-11-23,0.3,0.3,0.3,0.3,4860.0,0.4,0.1,0.3,59.48465862092793,-0.00018170833432766195,0.3813552872566004,0.15864471274339967,0.26143784774254497,100.00000000000001,0.045242727707946365,1827010.0,49.999999999999986,0.0,15.080909235982123,15.080909235982123,0.275,0.25,0.40760895570404165,0.2,0.4,0,,0.19710706029515945,0.2606226361536214
2010-11-24,0.3,0.3,0.3,0.3,2520.0,0.4,0.1,0.3,59.48465862092793,-0.0005999736443794805,0.382238052947636,0.16776194705236402,0.2651104336718264,100.0,0.04201110430023591,1829530.0,49.999999999999986,0.0,14.003701433411972,14.003701433411972,0.275,0.25,0.4014567765899608,0.2,0.4,0,,0.20315135350889557,0.2688131148569769
2010-11-25,0.3,0.3,0.3,0.3,1680.0,0.4,0.1,0.3,59.48465862092793,-0.0011076941311103893,0.382238052947636,0.16776194705236402,0.26843324951260483,100.0,0.03901031113593335,1831210.0,49.999999999999986,0.0,13.003437045311117,13.003437045311117,0.275,0.25,0.3954276410581616,0.2,0.4,0,,0.2090369799836067,0.27706903840553015
2010-11-26,0.3,0.3,0.3,0.3,33530.0,0.4,0.1,0.3,59.48465862092793,-0.0016423431836780182,0.36165151389911665,0.17834848610088327,0.27143960670188055,100.0,0.03622386034050954,1864740.0,0.0,0.0,12.07462011350318,12.07462011350318,0.275,0.25,0.3895190882369984,0.2,0.4,0,,0.21476869159824044,0.28538614736056694
2010-11-27,0.3,0.3,0.3,0.3,1830.0,0.4,0.1,0.3,59.48465862092793,-0.0021621001204902637,0.36165151389911665,0.17834848610088327,0.2741596441588443,100.0,0.03363644174475886,1866570.0,0.0,0.0,11.212147248252954,11.212147248252954,0.3,0.25,0.38372870647225843,0.2,0.4,0,,0.2203510682611693,0.2937602153642618
2010-11-28,0.3,0.3,0.3,0.3,20800.0,0.4,0.1,0.3,59.484658620927924,-0.002640348586647509,0.3616025403784437,0.18839745962155624,0.2766206304294306,100.0,0.031233838762990372,1887370.0,0.0,0.0,10.411279587663458,10.411279587663458,0.3,0.25,0.37805413234281326,0.2,0.4,0,,0.2257885252908588,0.3021870545403766
2010-11-29,0.2,0.3,0.3,0.2,35060.0,0.4,0.1,0.26666666666666666,39.29199520261578,-0.009443258265936672,0.36160254037844375,0.1883974596215563,0.26932342753138955,0.0,0.03614570742277677,1852310.0,-33.33333333333333,-0.33333333333333326,18.072853711388383,18.072853711388383,0.275,0.3,0.372493049695957,0.2,0.4,0,,0.2277521717314309,0.30562448333762143
2010-11-30,0.2,0.2,0.2,0.2,21480.0,0.4,0.1,0.2333333333333333,39.29199520261578,-0.013450433820374967,0.36160254037844375,0.1883974596215563,0.2627211963379239,0.0,0.033563871178292716,1873790.0,0.0,0.0,16.781935589146357,16.781935589146357,0.275,0.3,0.36704318870203784,0.2,0.4,0,,0.22965664169679678,0.3090162946064488
2010-12-01,0.2,0.2,0.2,0.2,8160.0,0.4,0.1,0.2,39.29199520261578,-0.015464578364200225,0.36160254037844375,0.1883974596215563,0.2567477490676454,0.0,0.031166451808414663,1881950.0,0.0,0.0,15.583225904207332,15.583225904207332,0.275,0.3,0.3617023249279971,0.2,0.4,0,,0.23150372995776622,0.31236242168770567
2010-12-02,0.3,0.2,0.3,0.2,20310.0,0.4,0.1,0.2333333333333333,57.36729683173632,-0.009706931612775888,0.36160254037844375,0.1883974596215563,0.26086701106120297,100.0,0.03608313382209933,1902260.0,0.0,0.4999999999999998,12.027711274033111,12.027711274033111,0.275,0.3,0.3564682784294371,0.2,0.3,0,,0.23655098617330478,0.3207676099285738
2010-12-03,0.3,0.3,0.3,0.2,2570.0,0.4,0.1,0.26666666666666666,57.367296831736326,-0.005739544319987135,0.36160254037844375,0.1883974596215563,0.26459396238870747,100.0,0.040648624263377946,1904830.0,0.0,0.0,13.549541421125982,13.549541421125982,0.25,0.3,0.3513389128608484,0.2,0.3,0,,0.24147035834305652,0.3292111620617839
2010-12-04,0.2,0.3,0.3,0.2,28560.0,0.4,0.1,0.26666666666666666,42.64244185490794,-0.009470918769737272,0.36165151389911665,0.17834848610088327,0.2584421564469258,0.0,0.044888008244565236,1876270.0,-33.33333333333333,-0.33333333333333326,22.444004122282617,22.444004122282617,0.225,0.3,0.3463121346036314,0.2,0.3,0,,0.24305927895366927,0.33238110927855197
2010-12-05,0.2,0.2,0.2,0.2,5740.0,0.4,0.1,0.2333333333333333,42.64244185490794,-0.011428770594038264,0.36039392014169447,0.16960607985830556,0.25287623678531385,0.0,0.04168172194138201,1882010.0,-33.33333333333333,0.0,20.840860970691004,20.840860970691004,0.225,0.3,0.34138589191155877,0.2,0.3,0,,0.24459917317711266,0.33550362577309545
2010-12-06,0.2,0.2,0.2,0.2,4320.0,0.4,0.1,0.2,42.64244185490794,-0.012146330487737608,0.36039392014169447,0.16960607985830556,0.24784040471052204,0.0,0.038704456088426153,1886330.0,-33.33333333333333,0.0,19.352228044213078,19.352228044213078,0.25,0.3,0.3365581740733276,0.2,0.3,0,,0.24609149591285695,0.3385788755335007
2010-12-07,0.2,0.2,0.2,0.2,24590.0,0.4,0.1,0.2,42.64244185490794,-0.012021199808312686,0.36039392014169447,0.16960607985830556,0.24328417569047234,0.0,0.03593985208211,1910920.0,-33.33333333333333,0.0,17.969926041054997,17.969926041054997,0.25,0.3,0.33182701059186104,0.2,0.3,0,,0.2475376515774869,0.34160704693640564
2010-12-08,0.2,0.2,0.2,0.2,3430.0,0.4,0.1,0.2,42.64244185490794,-0.01134704781426506,0.357979589711327,0.16202041028867292,0.2391618732437607,0.0,0.03337271979053071,1914350.0,-33.33333333333333,0.0,16.686359895265355,16.686359895265355,0.25,0.3,0.3271904703800238,0.2,0.3,0,,0.24893899615735335,0.34458835126273796
2010-12-09,0.2,0.2,0.2,0.2,21340.0,0.4,0.1,0.2,42.64244185490794,-0.010338257840793133,0.3544987437106619,0.15550125628933809,0.2354321710300692,0.0,0.03098895409120709,1935690.0,-33.33333333333333,0.0,15.494477045603544,15.494477045603544,0.25,0.3,0.32264666097242334,0.2,0.3,0,,0.2502968391649858,0.3475230212742298
2010-12-10,0.2,0.2,0.2,0.2,1680.0,0.4,0.1,0.2,42.64244185490794,-0.009149042721355116,0.3499999999999999,0.15000000000000008,0.232057678551015,0.0,0.02877545737040658,1937370.0,-33.33333333333333,0.0,14.38772868520329,14.38772868520329,0.25,0.3,0.3181937277529749,0.2,0.3,0,,0.25161244550436895,0.3504113098490778
2010-12-11,0.2,0.2,0.2,0.2,5790.0,0.4,0.1,0.2,42.64244185490794,-0.007888228718464223,0.34449874371066197,0.14550125628933808,0.2290045663080612,0.0,0.026720067558234684,1943160.0,-33.33333333333333,0.0,13.360033779117341,13.360033779117341,0.25,0.3,0.3138298531979154,0.2,0.3,0,,0.25288703724992734,0.35325348867516454
2010-12-12,0.2,0.2,0.2,0.2,1960.0,0.4,0.1,0.2,42.64244185490794,-0.006630653007079806,0.33797958971132713,0.14202041028867296,0.22624222665967442,0.0,0.024811491304075065,1945120.0,-33.33333333333333,0.0,12.405745652037533,12.405745652037533,0.25,0.3,0.30955325613395707,0.2,0.3,0,,0.2541217953437135,0.35604984699912956
2010-12-13,0.2,0.2,0.2,0.2,6420.0,0.4,0.1,0.2,42.64244185490794,-0.005425918591465314,0.3303939201416945,0.13960607985830542,0.22374296697780066,0.0,0.02303924192521256,1951540.0,0.0,0.0,11.51962096260628,11.51962096260628,0.225,0.3,0.30536219101127793,0.2,0.3,0,,0.2553178612150853,0.3588006904296632
2010-12-14,0.2,0.2,0.2,0.2,10390.0,0.4,0.1,0.2,42.64244185490795,-0.004305091479108706,0.3216515138991167,0.1383484861008832,0.22148173202753396,0.0,0.021393581787697378,1961930.0,0.0,0.0,10.69679089384869,10.69679089384869,0.225,0.3,0.3012549471910524,0.2,0.3,0,,0.2564763383268872,0.36150633979335345
2010-12-15,0.2,0.2,0.2,0.2,3690.0,0.4,0.1,0.2,42.64244185490795,-0.003285799273876908,0.31160254037844387,0.13839745962155614,0.21943585278681643,0.0,0.01986546880286185,1965620.0,0.0,0.0,9.932734401430924,9.932734401430924,0.225,0.3,0.29722984824723137,0.2,0.3,0,,0.2575982936519059,0.36416713004140217
2010-12-16,0.3,0.2,0.3,0.2,14360.0,0.4,0.1,0.2333333333333333,64.69437741429797,0.004005675219888698,0.31160254037844387,0.13839745962155614,0.22710862871188153,100.0,0.025589363888371717,1979980.0,0.0,0.4999999999999998,8.529787962790571,8.529787962790571,0.25,0.3,0.1,0.2,0.3,0,,0.26162200954291037,0.3722359411242358
2010-12-17,0.2,0.3,0.2,0.2,530.0,0.4,0.1,0.2333333333333333,45.75149591132444,0.002073538410566716,0.30000000000000004,0.14000000000000004,0.2245268545488452,0.0,0.03090440932491659,1979450.0,-33.33333333333333,-0.33333333333333326,15.452204662458294,15.452204662458294,0.25,0.3,0.10400000000000001,0.2,0.3,0,,0.2626340019954368,0.3747781418174356
2010-12-18,0.2,0.2,0.2,0.2,170.0,0.4,0.1,0.2333333333333333,45.75149591132444,0.0008385469000589656,0.28641428428542853,0.14358571571457152,0.22219096363943136,0.0,0.028696951515993975,1979620.0,0.0,0.0,14.348475757996987,14.348475757996987,0.25,0.3,0.10792000000000002,0.2,0.3,0,,0.26361314833620203,0.37727603940385096
2010-12-19,0.2,0.2,0.2,0.2,2000.0,0.4,0.1,0.2,45.75149591132443,0.00010334163460083874,0.28641428428542853,0.14358571571457152,0.2200775385309141,0.0,0.02664716926485155,1981620.0,0.0,0.0,13.323584632425773,13.323584632425773,0.25,0.3,0.11176160000000002,0.2,0.3,0,,0.26456036750493556,0.37973004349529577
2010-12-20,0.3,0.2,0.3,0.2,10680.0,0.4,0.1,0.2333333333333333,60.278086976982905,0.006101464225232957,0.30000000000000004,0.14000000000000004,0.2276892015279699,100.0,0.031886657174505006,1992300.0,49.999999999999986,0.4999999999999998,10.628885724835001,10.628885724835001,0.25,0.3,0.11552636800000002,0.2,0.3,0,,0.2683337857746299,0.38769430913041586
2010-12-21,0.2,0.3,0.3,0.2,9230.0,0.4,0.1,0.2333333333333333,46.786062411860044,0.0032280355374948106,0.30000000000000004,0.14000000000000004,0.22505213471578228,0.0,0.036751895947754645,1983070.0,0.0,-0.33333333333333326,18.37594797387732,18.37594797387732,0.25,0.3,0.11921584064000001,0.2,0.3,0,,0.26918191411821296,0.39002861573986436
2010-12-22,0.3,0.2,0.3,0.2,3800.0,0.4,0.1,0.26666666666666666,57.12175046485182,0.007700895676488634,0.30000000000000004,0.14000000000000004,0.2321900266476125,100.0,0.04126961766577216,1986870.0,49.999999999999986,0.4999999999999998,13.756539221924054,13.756539221924054,0.25,0.3,0.12283152382720001,0.2,0.3,0,,0.27282014929546095,0.3979586552953558
2010-12-23,0.3,0.3,0.3,0.2,8650.0,0.4,0.1,0.26666666666666666,57.12175046485182,0.010144474330531922,0.30000000000000004,0.14000000000000004,0.23864811934783992,100.0,0.04546464497535986,1995520.0,49.999999999999986,0.0,15.154881658453286,15.154881658453286,0.25,0.3,0.12637489335065602,0.2,0.3,0,,0.27637474947182944,0.40589208142632377
2010-12-24,0.2,0.3,0.3,0.2,5030.0,0.4,0.1,0.26666666666666666,46.62011962615949,0.004783154541874523,0.30000000000000004,0.14000000000000004,0.23496734607661707,0.0,0.04936002747711987,1990490.0,0.0,-0.33333333333333326,24.680013738559936,24.680013738559936,0.25,0.3,0.1298473954836429,0.2,0.3,0,,0.27706639802581495,0.408025761902979
2010-12-25,0.2,0.2,0.3,0.2,700.0,0.4,0.1,0.2333333333333333,46.6201196261595,0.0011817894628571362,0.30000000000000004,0.14000000000000004,0.23163712264074876,0.0,0.05297716837161131,1991190.0,0.0,0.0,26.488584185805653,26.488584185805653,0.25,0.3,0.13325044757397006,0.2,0.3,0,,0.27773281679226275,0.41011718401658814
2010-12-26,0.3,0.2,0.3,0.2,16590.0,0.4,0.1,0.2333333333333333,56.00142401383538,0.005251392252798253,0.31160254037844387,0.13839745962155614,0.23814787286543937,100.0,0.05633594205935336,2007780.0,49.999999999999986,0.4999999999999998,18.77864735311779,18.77864735311779,0.25,0.3,0.13658543862249065,0.2,0.3,1,,0.281119676754808,0.41796329731685633
2010-12-27,0.3,0.3,0.3,0.3,4940.0,0.4,0.1,0.26666666666666666,56.00142401383538,0.007521938421752798,0.32165151389911684,0.13834848610088327,0.24403855164015942,100.0,0.05231194619797098,2012720.0,49.999999999999986,0.0,17.437315399323662,17.437315399323662,0.25,0.3,0.13985372985004083,0.2,0.3,0,,0.28442979134268775,0.42580627646427543
2010-12-28,0.3,0.3,0.3,0.3,15440.0,0.4,0.1,0.3,56.00142401383538,0.008528700952920437,0.33039392014169455,0.13960607985830548,0.24936821338871568,100.0,0.048575378612401625,2028160.0,49.999999999999986,0.0,16.19179287080054,16.19179287080054,0.25,0.3,0.14305665525304,0.2,0.3,1,,0.2876650446827742,0.43364381302682603
2010-12-29,0.3,0.3,0.3,0.3,18610.0,0.4,0.1,0.3,56.00142401383538,0.008671133593350321,0.3379795897113271,0.1420204102886729,0.2541902883040761,100.0,0.0451057087115158,2046770.0,49.999999999999986,0.0,15.035236237171933,15.035236237171933,0.25,0.25,0.1461955221479792,0.2,0.3,1,,0.2908272655456995,0.44147365477865463
2010-12-30,0.3,0.3,0.3,0.3,2540.0,0.4,0.1,0.3,56.00142401383538,0.008244591181299084,0.34449874371066197,0.14550125628933808,0.25855311798940217,100.0,0.04188387237497896,2049310.0,0.0,0.0,13.961290791659653,13.961290791659653,0.25,0.2,0.14927161170501962,0.2,0.3,0,,0.29391822926950106,0.44929360592826945
2010-12-31,0.3,0.3,0.3,0.3,1450.0,0.4,0.1,0.3,56.00142401383538,0.007464995196287318,0.35,0.15000000000000002,0.2625004400856496,100.0,0.038892167205337606,2050760.0,49.999999999999986,0.0,12.964055735112536,12.964055735112536,0.25,0.2,0.15228617947091924,0.2,0.3,0,,0.2969396596057979,0.45710152725318864
2011-01-01,0.3,0.3,0.3,0.3,2820.0,0.4,0.1,0.3,56.00142401383538,0.006487965547218153,0.354498743710662,0.15550125628933803,0.26607182674415913,100.0,0.036114155262099205,2053580.0,49.999999999999986,0.0,12.038051754033068,12.038051754033068,0.25,0.25,0.15524045588150084,0.2,0.3,0,,0.2998932304920357,0.46489533614641837
2011-01-02,0.3,0.3,0.3,0.3,5350.0,0.4,0.1,0.3,56.00142401383538,0.005423618425250038,0.3579795897113271,0.16202041028867292,0.2693030813399535,100.0,0.03353457274337783,2058930.0,49.999999999999986,0.0,11.178190914459277,11.178190914459277,0.25,0.25,0.15813564676387082,0.2,0.3,0,,0.3027805677531732,0.4726730065800054
2011-01-03,0.3,0.3,0.3,0.3,1430.0,0.4,0.1,0.3,56.00142401383538,0.0043479757142968496,0.3603939201416945,0.1696060798583055,0.2722265974028151,100.0,0.031139246118850845,2060360.0,0.0,0.0,10.379748706283614,10.379748706283614,0.25,0.25,0.1609729338285934,0.2,0.3,0,,0.30560325073600864,0.48043256899074777
2011-01-04,0.3,0.3,0.3,0.3,1880.0,0.4,0.1,0.3,56.00142401383538,0.0033117301991653306,0.36165151389911676,0.17834848610088327,0.2748716833644517,100.0,0.02891501425321864,2062240.0,49.999999999999986,0.0,9.638338084406213,9.638338084406213,0.275,0.25,0.16375347515202154,0.2,0.3,0,,0.3083628138791884,0.48817211009298883
2011-01-05,0.3,0.3,0.3,0.3,360.0,0.4,0.1,0.3,56.00142401383538,0.002346951682323989,0.36165151389911676,0.17834848610088327,0.2772648563773611,100.0,0.026849656092274448,2062600.0,0.0,0.0,8.949885364091482,8.949885364091482,0.275,0.25,0.16647840564898111,0.2,0.3,0,,0.3110607482217553,0.4958897726231763
2011-01-06,0.3,0.3,0.3,0.3,3460.0,0.4,0.1,0.3,56.00142401383538,0.0014721934019153102,0.36160254037844386,0.1883974596215562,0.27943010815094577,100.0,0.024931823514254846,2066060.0,0.0,0.0,8.310607838084948,8.310607838084948,0.275,0.25,0.1691488375360015,0.2,0.3,0,,0.3136985028530062,0.5035837550208321
2011-01-07,0.3,0.3,0.3,0.3,42600.0,0.4,0.1,0.3,56.00142401383538,0.0006963589096922775,0.35999999999999993,0.2,0.28138914546990335,100.0,0.023150978977522357,2108660.0,49.999999999999986,0.0,7.7169929925074525,7.7169929925074525,0.275,0.25,0.17176586078528147,0.2,0.3,1,,0.3162774863062301,0.5112523110502587
2011-01-08,0.3,0.3,0.3,0.3,1630.0,0.4,0.1,0.3,56.00142401383538,2.1611314705662077e-05,0.35641428428542843,0.21358571571457155,0.28316160780610306,100.0,0.02149733762198505,2110290.0,49.999999999999986,0.0,7.165779207328351,7.165779207328351,0.275,0.25,0.17433054356957584,0.2,0.3,0,,0.3187990678988141,0.518893749367253
2011-01-09,0.3,0.3,0.3,0.3,1690.0,0.4,0.1,0.3,56.001424013835376,-0.000554454844132718,0.35641428428542843,0.21358571571457155,0.28476526420552184,,0.019961813506128974,2111980.0,0.0,0.0,6.653937835376325,6.653937835376325,0.275,0.25,0.17684393269818433,0.2,0.3,0,,0.32126457902106287,0.52650643303487
2011-01-10,0.3,0.3,0.3,0.3,10360.0,0.4,0.1,0.3,56.001424013835376,-0.0010372073358756034,0.34999999999999987,0.23000000000000007,0.2862161914240436,,0.01853596968426262,2122340.0,0.0,0.0,6.178656561420874,6.178656561420874,0.275,0.25,0.17930705404422065,0.2,0.3,0,,0.3236753143759572,0.5340887789921144
2011-01-11,0.3,0.3,0.3,0.3,4860.0,0.4,0.1,0.3,56.00142401383537,-0.0014338019402173746,0.34999999999999987,0.23000000000000007,0.2875289350979442,,0.017211971849672433,2127200.0,0.0,0.0,5.737323949890811,5.737323949890811,0.275,0.25,0.18172091296333623,0.2,0.3,0,,0.3260325331719897,0.5416392574793099
2011-01-12,0.3,0.3,0.4,0.3,31360.0,0.4,0.1,0.3,56.001424013835376,-0.0017523363807406267,0.34999999999999987,0.23000000000000007,0.2887166555648067,0.0,0.02312540243183869,2158560.0,0.0,0.0,7.708467477279564,7.708467477279564,0.325,0.30000000000000004,0.18408649470406951,0.2,0.3,1,,0.3283374602710909,0.5491563914236955
2011-01-13,0.3,0.3,0.4,0.3,20120.0,0.4,0.1,0.3,56.001424013835376,-0.0020012521920607547,0.3385889894354066,0.25141101056459336,0.28979125979672987,0.0,0.028616445115278784,2178680.0,0.0,0.0,9.53881503842626,9.53881503842626,0.325,0.30000000000000004,0.19272303491590673,0.2,0.3,1,,0.3305912872935608,0.5566387557886243
2011-01-14,0.4,0.3,0.4,0.3,27130.0,0.4,0.1,0.3333333333333333,74.39631185314514,0.004192843823133747,0.34858898943540656,0.2614110105645934,0.3002873302922794,100.0,0.033715270464187444,2205810.0,33.33333333333335,0.3333333333333335,8.42881761604686,8.42881761604686,0.325,0.30000000000000004,0.20101411351927045,0.2,0.3,1,,0.33452688752706194,0.56918597022418
2011-01-15,0.4,0.4,0.4,0.4,1520.0,0.4,0.1,0.3666666666666667,74.39631185314514,0.007709267359966722,0.36999999999999983,0.25000000000000006,0.309783775026348,100.0,0.03130703685960263,2207330.0,33.33333333333335,0.0,7.826759214900656,7.826759214900656,0.325,0.30000000000000004,0.20897354897849962,0.2,0.4,0,,0.3383838860669816,0.581797350383292
2011-01-16,0.4,0.4,0.4,0.4,2780.0,0.4,0.1,0.4,74.39631185314514,0.009345469950346113,0.38641428428542834,0.24358571571457163,0.3183757964524101,100.0,0.029070819941059586,2210110.0,33.33333333333335,0.0,7.267704985264896,7.267704985264896,0.325,0.30000000000000004,0.21661460701935964,0.2,0.4,0,,0.34216400124673785,0.5944691440826034
2011-01-17,0.3,0.4,0.4,0.3,18240.0,0.4,0.1,0.3666666666666667,48.87514093006303,0.0033143474357595626,0.38641428428542834,0.24358571571457163,0.3166257205997996,0.0,0.03413718994526962,2191870.0,0.0,-0.2500000000000001,11.379063315089873,11.379063315089873,0.325,0.30000000000000004,0.22395002273858525,0.2,0.4,0,,0.34416702454864556,0.6018324647965663
2011-01-18,0.3,0.3,0.3,0.3,15670.0,0.4,0.1,0.3333333333333333,48.87514093006303,-0.0008321321921396022,0.38641428428542834,0.24358571571457163,0.31504231863791393,0.0,0.03169881923489322,2207540.0,0.0,0.0,10.56627307829774,10.56627307829774,0.325,0.30000000000000004,0.23099202182904183,0.3,0.4,0,,0.34612525624195106,0.6091516086558435
2011-01-19,0.3,0.3,0.3,0.3,7290.0,0.4,0.1,0.3,48.87514093006303,-0.0035780922588471153,0.38641428428542834,0.24358571571457163,0.31360971686287453,0.0,0.029434617860972272,2214830.0,0.0,0.0,9.811539286990758,9.811539286990758,0.325,0.30000000000000004,0.23775234095588016,0.3,0.4,0,,0.34803969406679924,0.6164254924468139
2011-01-20,0.4,0.3,0.4,0.3,19880.0,0.4,0.1,0.3333333333333333,64.20963291357438,0.0010876355448062834,0.3999999999999998,0.24000000000000007,0.3218373628759341,100.0,0.034475002299474256,2234710.0,33.33333333333335,0.3333333333333335,8.618750574868564,8.618750574868564,0.325,0.30000000000000004,0.24424224731764496,0.3,0.4,0,,0.35158435860413356,0.6291351848215692
2011-01-21,0.4,0.4,0.4,0.4,8480.0,0.4,0.1,0.3666666666666667,64.20963291357438,0.0037700352329506047,0.41160254037844374,0.23839745962155628,0.3292814235544166,100.0,0.03201250213522609,2243190.0,33.33333333333335,0.0,8.003125533806523,8.003125533806523,0.35,0.30000000000000004,0.2504725574249392,0.3,0.4,0,,0.35505930916547285,0.6418904508314636
2011-01-22,0.4,0.4,0.4,0.4,10530.0,0.4,0.1,0.4,64.20963291357438,0.005060114784741016,0.42165151389911665,0.23834848610088327,0.33601652607304355,100.0,0.0297258948398528,2253720.0,33.33333333333335,0.0,7.431473709963201,7.431473709963201,0.35,0.30000000000000004,0.2564536551279416,0.3,0.4,0,,0.35846602807215217,0.6546877593119654
2011-01-23,0.4,0.4,0.4,0.4,1150.0,0.4,0.1,0.4,64.20963291357438,0.0053983539217776905,0.4303939201416944,0.2396060798583056,0.3421101902565632,100.0,0.02760261663700617,2254870.0,33.33333333333335,0.0,6.900654159251542,6.900654159251542,0.35,0.30000000000000004,0.26219550892282395,0.3,0.4,0,,0.3618059599084329,0.6675236144346135
2011-01-24,0.4,0.4,0.4,0.4,11060.0,0.4,0.1,0.4,64.20963291357438,0.005109962932020252,0.437979589711327,0.24202041028867305,0.3476235054702238,100.0,0.0256310011629343,2265930.0,33.33333333333335,0.0,6.407750290733574,6.407750290733574,0.35,0.30000000000000004,0.267707688565911,0.3,0.4,0,,0.36508051265874103,0.6803945576392884
2011-01-25,0.4,0.4,0.4,0.4,2160.0,0.4,0.1,0.4,64.20963291357438,0.004432283611696421,0.4444987437106618,0.24550125628933814,0.35261174304448817,100.0,0.02380021536558185,2268090.0,33.33333333333335,0.0,5.950053841395462,5.950053841395462,0.35,0.30000000000000004,0.27299938102327453,0.3,0.4,0,,0.36829105880514745,0.6932971694469346
2011-01-26,0.4,0.4,0.4,0.4,15570.0,0.4,0.1,0.4,64.20963291357438,0.0035360289064153526,0.4499999999999998,0.25000000000000017,0.3571249103735845,100.0,0.022100199982326003,2283660.0,33.33333333333335,0.0,5.525049995581501,5.525049995581501,0.35,0.30000000000000004,0.2780794057823436,0.3,0.4,0,,0.371438936386677,0.7062280711556772
2011-01-27,0.4,0.4,0.4,0.4,27710.0,0.4,0.1,0.4,64.20963291357438,0.002541699211850674,0.45449874371066185,0.25550125628933823,0.361208252242767,100.0,0.020521614269302716,2311370.0,33.33333333333335,0.0,5.130403567325679,5.130403567325679,0.35,0.30000000000000004,0.2829562295510498,0.3,0.4,1,,0.37452545002195414,0.7191839264233161
2011-01-28,0.4,0.4,0.4,0.4,5330.0,0.4,0.1,0.4,64.20963291357438,0.0015322293730355985,0.4579795897113269,0.26202041028867307,0.3649027044101225,100.0,0.01905578467863824,2316700.0,0.0,0.0,4.763946169659559,4.763946169659559,0.35,0.30000000000000004,0.28763798036900784,0.3,0.4,0,,0.37755187189663664,0.7321614427392843
2011-01-29,0.4,0.4,0.4,0.4,1450.0,0.4,0.1,0.4,64.20963291357438,0.0005626958014589359,0.46039392014169433,0.26960607985830576,0.3682453039901109,100.0,0.01769465720159265,2318150.0,0.0,0.0,4.423664300398163,4.423664300398163,0.375,0.30000000000000004,0.2921324611542475,0.3,0.4,0,,0.3805194427170062,0.7451573727891319
2011-01-30,0.5,0.4,0.5,0.4,10380.0,0.5,0.1,0.43333333333333335,78.03380120895474,0.006049501944606763,0.48223805294763583,0.26776194705236417,0.380793370276767,100.0,0.023573610258621747,2328530.0,24.999999999999993,0.25,4.714722051724349,4.714722051724349,0.42500000000000004,0.35,0.29644716270807764,0.3,0.4,0,,0.3846576696805237,0.7631045301079962
2011-01-31,0.5,0.5,0.9,0.5,63520.0,0.5,0.1,0.46666666666666673,78.03380120895474,0.008899834875930573,0.49945523142259574,0.2705447685774043,0.39214638263136065,33.33333333333333,0.05046120952586305,2392050.0,66.66666666666667,0.0,10.09224190517261,10.09224190517261,0.625,0.55,0.308660332945593,0.3,0.4,1,,0.3887200567564175,0.7811956622429896
2011-02-01,0.7,0.5,0.9,0.5,31560.0,0.7,0.1,0.5666666666666667,88.41400094917834,0.0226915065524442,0.5779161646579055,0.2320838353420944,0.4214657747617072,66.66666666666666,0.07542826598830141,2423610.0,133.33333333333331,0.3999999999999999,10.775466569757345,10.775466569757345,0.625,0.55,0.35596750630994556,0.3,0.4,1,,0.394540622881601,0.8072181618795622
2011-02-02,0.7,0.7,0.8,0.7,5630.0,0.7,0.1,0.6333333333333333,88.41400094917834,0.029802763869561683,0.6335665361461418,0.21643346385385814,0.4479928438320208,66.66666666666666,0.0771833898462799,2429240.0,133.33333333333331,0.0,11.026198549468557,11.026198549468557,0.625,0.55,0.39949010580514993,0.3,0.4,0,,0.4002597406450246,0.8336997461893033
2011-02-03,0.7,0.7,0.8,0.7,8530.0,0.7,0.1,0.7,88.41400094917834,0.03228615650064565,0.6799999999999998,0.20000000000000032,0.47199352537182837,59.999999999999986,0.07881314771440276,2437770.0,74.99999999999997,0.0,11.259021102057538,11.259021102057538,0.625,0.55,0.4395308973407379,0.3,0.4,0,,0.4058794010193774,0.8606366495085814
2011-02-04,0.8,0.7,0.9,0.7,42220.0,0.8,0.1,0.7333333333333334,91.05399989883519,0.038046889358111846,0.7456571371417138,0.1743428628582862,0.503232237241178,80.0,0.0874693514490883,2479990.0,100.0,0.14285714285714302,10.933668931136037,10.933668931136037,0.625,0.55,0.4763684255534789,0.3,0.4,1,,0.4121174092073413,0.8914057551712089
2011-02-05,0.9,0.8,0.9,0.8,15790.0,0.9,0.1,0.7999999999999999,92.81670170747265,0.0454730918843535,0.8271987726453733,0.1428012273546267,0.5410196432182087,100.0,0.0883643977741534,2495780.0,125.0,0.125,9.818266419350378,9.818266419350378,0.625,0.55,0.5102589515092006,0.3,0.4,0,,0.4188769501585312,0.9258846899989659
2011-02-06,0.9,0.9,0.9,0.8,8740.0,0.9,0.1,0.8666666666666667,92.81670170747265,0.047068475969399476,0.8906327994198588,0.13936720058014124,0.5752082486259984,100.0,0.08919551221885673,2504520.0,125.0,0.0,9.910612468761858,9.910612468761858,0.625,0.55,0.5414382353884646,0.3,0.4,0,,0.4255223123712748,0.9611677036211486
2011-02-07,0.9,0.9,0.9,0.8,2260.0,0.9,0.1,0.9,92.81670170747265,0.044818304769535466,0.9423663297261105,0.14763367027388968,0.6061407963759033,100.0,0.08996726134608125,2506780.0,125.0,0.0,9.996362371786805,9.996362371786805,0.625,0.55,0.5701231765573874,0.3,0.4,0,,0.4320556843954666,0.9972553999070852
2011-02-08,0.9,0.9,0.9,0.9,7020.0,0.9,0.1,0.9,92.81670170747265,0.04017362172802373,0.9842676385936223,0.1657323614063776,0.6341273871972459,100.0,0.08354102839278973,2513800.0,125.0,0.0,9.282336488087749,9.282336488087749,0.6499999999999999,0.55,0.5965133224327964,0.3,0.4,0,,0.4384792040028985,1.0341479061168632
2011-02-09,1.1,0.9,1.1,0.8,49630.0,1.1,0.1,0.9666666666666668,95.30519411797536,0.04694355596690769,1.07,0.1500000000000002,0.6784962074641748,99.99999999999999,0.09900238350759047,2563430.0,175.0,0.22222222222222232,9.000216682508224,9.000216682508224,0.75,0.65,0.6207922566381727,0.3,1.1,1,,0.4458434037413724,1.0778544070721472
2011-02-10,1.0,1.1,1.1,0.8,26560.0,1.1,0.1,1.0,80.32208098783659,0.04126076703461817,1.1191659420284377,0.16083405797156247,0.7091156162771105,85.71428571428571,0.11335935611419115,2536870.0,149.99999999999997,-0.09090909090909094,11.335935611419115,11.335935611419115,0.8,0.65,0.6687130309743554,0.3,1.1,0,,0.4525907057068702,1.1197831306789297
2011-02-11,1.1,1.0,1.1,0.9,13300.0,1.1,0.1,1.0666666666666667,83.1712714229641,0.040740244783434715,1.1804700782440045,0.16952992175599557,0.7463427004411952,99.99999999999999,0.11954797353460608,2550170.0,175.0,0.10000000000000009,10.867997594055097,10.867997594055097,0.8,0.65,0.7118417278769199,0.3,1.1,0,,0.45971918402760925,1.1657777375043037
2011-02-12,1.1,1.1,1.1,1.0,4120.0,1.1,0.1,1.0666666666666667,83.1712714229641,0.03700799627424095,1.2311525688318152,0.1888474311681846,0.7800243480182242,99.99999999999999,0.11815168971070565,2554290.0,175.0,0.0,10.74106270097324,10.74106270097324,0.8,0.65,0.7506575550892279,0.3,1.1,0,,0.4667306581962206,1.212972458300729
2011-02-13,1.0,1.1,1.1,1.0,3240.0,1.1,0.1,1.0666666666666667,71.21293986256109,0.024992235510880367,1.2553639490690052,0.22463605093099492,0.8009744101117267,83.33333333333331,0.11685514044565526,2551050.0,100.0,-0.09090909090909094,11.685514044565526,11.685514044565526,0.8250000000000001,0.65,0.7855917995803051,0.3,1.1,0,,0.47313927037151465,1.258083032164673
2011-02-14,1.1,1.0,1.1,1.0,7100.0,1.1,0.1,1.0666666666666667,75.07267581537948,0.02112098618262087,1.288322510708424,0.2616774892915761,0.8294530377201336,100.0,0.11565120184239418,2558150.0,120.00000000000001,0.10000000000000009,10.513745622035833,10.513745622035833,0.8250000000000001,0.65,0.8170326196222746,0.3,1.1,0,,0.479927979440477,1.3075962584909733
2011-02-15,1.0,1.1,1.1,1.0,8620.0,1.1,0.1,1.0333333333333334,65.60045497111656,0.009745824359820382,1.2968333050943177,0.31316669490568244,0.8456956055563113,74.99999999999999,0.11453325885365175,2549530.0,42.85714285714287,-0.09090909090909094,11.453325885365174,11.453325885365174,0.8500000000000001,0.65,0.8453293576600471,0.3,1.1,0,,0.48612279898906724,1.3548100510780563
2011-02-16,1.0,1.0,1.0,1.0,7190.0,1.1,0.1,1.0333333333333334,65.60045497111656,0.0006232140163721922,1.2966275555033517,0.3733724444966482,0.860391262169996,74.99999999999999,0.10635231179267661,2556720.0,42.85714285714287,0.0,10.635231179267661,10.635231179267661,0.8500000000000001,0.7000000000000001,0.8707964218940424,0.3,1.1,0,,0.4922160214128872,1.4030301241317173
2011-02-17,1.0,1.0,1.0,1.0,4010.0,1.1,0.1,1.0,65.60045497111656,-0.006610738821196033,1.2858325082500164,0.4441674917499836,0.8736873324395201,74.99999999999999,0.0987557180931997,2560730.0,42.85714285714287,0.0,9.87557180931997,9.87557180931997,0.8500000000000001,0.7000000000000001,0.8937167797046381,0.3,1.1,0,,0.4982095129759085,1.4522554974720303
2011-02-18,0.9,1.0,1.0,0.8,36950.0,1.1,0.1,0.9666666666666667,56.669936102112715,-0.01864840113294719,1.2527671429443412,0.5272328570556588,0.8761933007786135,33.33333333333332,0.105987452515114,2523780.0,12.499999999999996,-0.09999999999999998,11.776383612790445,11.776383612790445,0.8500000000000001,0.7000000000000001,1.1,0.3,1.1,1,,0.5035787274627679,1.4982395226986962
2011-02-19,0.9,0.9,1.0,0.8,3800.0,1.1,0.1,0.9333333333333332,56.669936102112715,-0.02664163146999085,1.22559467676119,0.5944053232388098,0.8784606054663646,33.33333333333332,0.11270263447832014,2527580.0,0.0,0.0,12.52251494203557,12.52251494203557,0.8500000000000001,0.7000000000000001,1.094,0.3,1.1,0,,0.5088593810136794,1.545003451373138
2011-02-20,0.9,0.9,0.9,0.8,9970.0,1.1,0.1,0.9,56.669936102112715,-0.03162015018933298,1.1837715508089905,0.6762284491910093,0.8805119763743299,33.33333333333332,0.11179530344415443,2537550.0,0.0,0.0,12.421700382683825,12.421700382683825,0.8500000000000001,0.7000000000000001,1.08812,0.3,1.1,0,,0.5140530873451558,1.592541579703787
2011-02-21,0.8,0.9,0.9,0.8,1700.0,1.1,0.1,0.8666666666666667,48.43462787317105,-0.04075782155687535,1.1739560629069707,0.6960439370930293,0.8728441691005842,0.0,0.11095278176957198,2535850.0,-11.111111111111107,-0.11111111111111105,13.869097721196496,13.869097721196496,0.8500000000000001,0.7000000000000001,1.0823576,0.8,1.1,0,,0.5185814627454886,1.6357274149088556
2011-02-22,0.9,0.8,0.9,0.8,12100.0,1.1,0.1,0.8666666666666667,55.41252687897656,-0.03916692931243998,1.159242852856286,0.7307571471437143,0.8754304387100523,33.33333333333332,0.11017044021460255,2547950.0,0.0,0.125,12.241160023844728,12.241160023844728,0.8500000000000001,0.7000000000000001,1.0767104479999998,0.8,1.1,0,,0.5236114188444166,1.6846871506059462
2011-02-23,0.9,0.9,0.9,0.9,6720.0,1.1,0.1,0.8666666666666667,55.41252687897656,-0.037227475470319474,1.13911952639522,0.7708804736047801,0.8777703969281426,33.33333333333332,0.10230112305641666,2554670.0,-18.181818181818183,0.0,11.366791450712961,11.366791450712961,0.8500000000000001,0.7000000000000001,1.07117623904,0.8,1.1,0,,0.528558996251733,1.7344014462483082
2011-02-24,1.0,0.9,1.0,0.9,13420.0,1.1,0.1,0.9333333333333332,61.46088656131804,-0.028704604018022398,1.1355872210923201,0.79441277890768,0.8894113115064147,66.66666666666664,0.10213675712381545,2568090.0,0.0,0.11111111111111116,10.213675712381546,10.213675712381546,0.825,0.7000000000000001,1.0657527142591998,0.8,1.1,0,,0.5339371028602554,1.7898016720406187
2011-02-25,0.9,1.0,1.0,0.9,4460.0,1.1,0.1,0.9333333333333332,53.62675357853934,-0.02920026611919828,1.1355872210923201,0.79441277890768,0.8904197580296134,33.33333333333332,0.10198413161497151,2563630.0,-18.181818181818183,-0.09999999999999998,11.331570179441279,11.331570179441279,0.8500000000000001,0.7000000000000001,1.0604376599740157,0.8,1.1,0,,0.5387195921794223,1.8411019506280915
2011-02-26,1.0,0.9,1.0,0.9,4740.0,1.1,0.1,0.9666666666666667,59.224079275625684,-0.02249250083065077,1.1385229954635276,0.8014770045364726,0.9008559715506026,66.66666666666664,0.10184240792818781,2568370.0,-9.090909090909099,0.11111111111111116,10.184240792818782,10.184240792818782,0.8500000000000001,0.7000000000000001,1.0552289067745355,0.8,1.1,0,,0.5439307321596488,1.8983318107743714
2011-02-27,0.9,1.0,1.0,0.9,23270.0,1.1,0.1,0.9333333333333332,52.41132256236938,-0.02433366675266048,1.1385229954635276,0.8014770045364726,0.9007744504505453,33.33333333333332,0.10171080736188867,2545100.0,-9.999999999999998,-0.09999999999999998,11.301200817987631,11.301200817987631,0.9,0.7000000000000001,1.0501243286390447,0.8,1.1,0,,0.5485539923241288,1.9511879758527764
2011-02-28,0.9,0.9,0.9,0.8,4650.0,1.1,0.1,0.9333333333333332,52.41132256236937,-0.024999392446623164,1.1385229954635274,0.8014770045364725,0.9007006932647791,33.33333333333332,0.1015886068360395,2549750.0,-18.181818181818183,0.0,11.287622981782167,11.287622981782167,0.9,0.7000000000000001,1.0451218420662638,0.8,1.1,0,,0.553102062217241,2.0047592794462643
2011-03-01,0.9,0.9,1.0,0.9,22570.0,1.1,0.1,0.9,52.41132256236937,-0.0248364978645271,1.1200000000000006,0.7999999999999998,0.9006339605728954,50.0,0.10147513491917952,2572320.0,-9.999999999999998,0.0,11.275014991019946,11.275014991019946,0.9,0.7000000000000001,1.0402194052249385,0.8,1.1,1,,0.5575762672167371,2.0590367731314387
2011-03-02,0.9,0.9,0.9,0.9,2740.0,1.1,0.1,0.9,52.41132256236937,-0.024106171947063687,1.1159347693943111,0.794065230605689,0.9005735833754768,50.0,0.09422691099638099,2575060.0,-9.999999999999998,0.0,10.469656777375665,10.469656777375665,0.925,0.7000000000000001,1.0354150171204397,0.8,1.1,0,,0.5619779046856589,2.114011204085867
2011-03-03,0.9,0.9,0.9,0.9,2750.0,1.1,0.1,0.9,52.41132256236937,-0.023003533110919003,1.0929864858694878,0.7970135141305124,0.9005189563873361,50.0,0.08749641735378234,2577810.0,-9.999999999999998,0.0,9.721824150420261,9.721824150420261,0.925,0.7000000000000001,1.0307067167780308,0.8,1.1,0,,0.5663082446742004,2.1696730258913006
2011-03-04,0.9,0.9,0.9,0.9,2710.0,1.1,0.1,0.9,52.41132256236937,-0.021672908194963675,1.0657669683062205,0.8042330316937794,0.9004695319694946,50.0,0.0812466732570836,2580520.0,0.0,0.0,9.027408139675956,9.027408139675956,0.925,0.7000000000000001,1.0260925824424703,0.8,1.1,0,,0.5705685306011428,2.226012409400013
2011-03-05,0.9,0.9,0.9,0.8,12570.0,1.1,0.1,0.9,52.41132256236938,-0.020219742636100227,1.0580624847486573,0.8019375152513426,0.9004248146390667,50.0,0.08258619659586335,2593090.0,0.0,0.0,9.176244066207039,9.176244066207039,0.925,0.7000000000000001,1.0215707307936208,0.8,1.1,0,,0.5747599799155558,2.2830192536472342
2011-03-06,0.9,0.9,0.9,0.8,12630.0,1.1,0.1,0.9,52.41132256236938,-0.01871986343260558,1.0219803902718563,0.818019609728144,0.9003843561020127,50.0,0.0838300396961588,2605720.0,0.0,0.0,9.314448855128756,9.314448855128756,0.925,0.7000000000000001,1.0171393161777484,0.8,1.1,0,,0.5788837847393882,2.3406831967927095
2011-03-07,0.9,0.9,0.9,0.8,15270.0,1.1,0.1,0.9,52.41132256236938,-0.017226664812527763,1.0103939201416952,0.819606079858305,0.9003477507589639,50.0,0.08498503686071888,2620990.0,12.499999999999996,0.0,9.442781873413209,9.442781873413209,0.925,0.7000000000000001,1.0127965298541934,0.8,1.1,0,,0.5829411124916213,2.398993627075983
2011-03-08,0.9,0.9,0.9,0.9,4530.0,1.1,0.1,0.9,52.41132256236938,-0.015776666338065758,0.9971779788708142,0.8228220211291861,0.9003146316390626,50.0,0.07891467708495326,2625520.0,0.0,0.0,8.768297453883694,8.768297453883694,0.925,0.7000000000000001,1.0085405992571095,0.8,1.1,0,,0.5869331064945352,2.457939693769391
2011-03-09,0.9,0.9,0.9,0.9,4550.0,1.1,0.1,0.9,52.41132256236938,-0.014393797980113837,0.9818114574786867,0.8281885425213134,0.9002846667210567,50.0,0.07327791443602802,2630070.0,0.0,0.0,8.141990492892003,8.141990492892003,0.925,0.7000000000000001,1.0043697872719672,0.8,1.1,0,,0.5908608865627184,2.517510318114644
2011-03-10,0.9,0.9,0.9,0.8,8870.0,1.1,0.1,0.9,52.41132256236938,-0.01309269134590696,0.9818114574786866,0.8281885425213132,0.9002575556047656,50.0,0.07518663483345459,2638940.0,-9.999999999999998,0.0,8.354070537050509,8.354070537050509,0.9000000000000001,0.7000000000000001,1.000282391526528,0.8,1.1,0,,0.5947255495753498,2.577694204228585
2011-03-11,0.9,0.9,0.9,0.9,3730.0,1.1,0.1,0.9,52.41132256236938,-0.01188119664394112,0.9818114574786867,0.8281885425213134,0.9002330264995498,50.0,0.06981616091677925,2642670.0,0.0,0.0,7.757351212975472,7.757351212975472,0.9000000000000001,0.7000000000000001,0.9962767436959974,0.8,1.1,0,,0.5985281700323241,2.63847984996503
2011-03-12,0.9,0.9,0.9,0.9,4820.0,1.1,0.1,0.9,52.41132256236938,-0.01076229786873887,0.9818114574786867,0.8281885425213134,0.9002108334995927,50.0,0.06482929227986645,2647490.0,-9.999999999999998,0.0,7.203254697762938,7.203254697762938,0.9000000000000001,0.7000000000000001,0.9923512088220774,0.8,1.1,0,,0.6022698005946951,2.6998555577193306
2011-03-13,0.9,0.9,0.9,0.9,660.0,1.1,0.1,0.9,52.41132256236938,-0.00973556149540758,0.970000000000001,0.8499999999999993,0.9001907541186792,50.0,0.06019862854559027,2648150.0,0.0,0.0,6.688736505065586,6.688736505065586,0.875,0.75,0.9885041846456358,0.8,1.1,0,,0.6059514726100038,2.7618094451643307
2011-03-14,0.9,0.9,0.9,0.9,5270.0,1.1,0.1,0.9,52.41132256236938,-0.008798224633428497,0.9700000000000008,0.8499999999999991,0.9001725870597574,50.0,0.055898726506619534,2653420.0,0.0,0.0,6.210969611846615,6.210969611846615,0.875,0.75,0.9847341009527231,0.8,1.1,0,,0.609574196622912,2.8243294559053336
2011-03-15,0.9,0.9,0.9,0.9,2730.0,1.1,0.1,0.9,52.411322562369385,-0.007946005466751772,0.9700000000000008,0.8499999999999991,0.9001561501969234,100.0,0.05190596032757528,2656150.0,0.0,0.0,5.767328925286142,5.767328925286142,0.875,0.75,0.9810394189336686,0.8,1.1,0,,0.6131389628716493,2.8874033700436956
2011-03-16,0.9,0.9,0.9,0.8,7930.0,1.1,0.1,0.9,52.411322562369385,-0.007173700605659,0.9485889894354079,0.8614110105645921,0.9001412787495974,100.0,0.05534124887560561,2664080.0,0.0,0.0,6.149027652845067,6.149027652845067,0.875,0.75,0.9774186305549952,0.8,1.1,0,,0.6166467417707109,2.9510188146385627
2011-03-17,0.8,0.9,0.9,0.8,7160.0,1.1,0.1,0.8666666666666667,36.48122906545806,-0.012857386047096388,0.9632455532033684,0.8367544467966317,0.8906040141067786,0.0,0.05853115967020521,2656920.0,-11.111111111111107,-0.11111111111111105,7.31639495877565,7.31639495877565,0.875,0.75,0.9738702579438954,0.8,1.1,0,,0.619578481309007,3.006563023846979
2011-03-18,0.8,0.8,0.9,0.7,14230.0,1.1,0.1,0.8333333333333334,36.48122906545806,-0.015878541988808587,0.9500000000000007,0.8299999999999991,0.8819750603823235,50.00000000000003,0.06863607683661913,2671150.0,-11.111111111111107,0.0,8.57950960457739,8.57950960457739,0.825,0.75,0.9703928527850174,0.8,1.1,0,,0.6224617410215763,3.062378223148762
2011-03-19,0.8,0.8,0.8,0.7,9880.0,1.1,0.1,0.8,36.48122906545806,-0.017036311626081903,0.9564142842854292,0.8135857157145708,0.8741679117744832,50.00000000000003,0.0708763570625749,2681030.0,-11.111111111111107,0.0,8.859544632821862,8.859544632821862,0.825,0.75,0.9595771386736167,0.8,1.1,0,,0.6252973322433352,3.118452826985908
2011-03-20,0.7,0.8,0.8,0.7,5820.0,1.1,0.1,0.7666666666666666,26.442985270463637,-0.02330839181149413,0.9822380529476366,0.7677619470523634,0.8575804916054848,0.0,0.072956617272391,2675210.0,-22.22222222222223,-0.1250000000000001,10.422373896055857,10.422373896055857,0.825,0.75,0.949194053126672,0.7,1.1,0,,0.6275040491202772,3.1646192163017104
2011-03-21,0.8,0.7,0.8,0.7,3700.0,1.1,0.1,0.7666666666666666,43.2574130670635,-0.01964057265710499,0.9813552872566008,0.758644712743399,0.8520966352621053,50.00000000000003,0.07488828746722022,2678910.0,-11.111111111111107,0.14285714285714302,9.361035933402526,9.361035933402526,0.825,0.75,0.9392262910016052,0.7,1.1,0,,0.6302515277322033,3.2210755419895527
2011-03-22,0.8,0.8,0.8,0.7,12150.0,1.1,0.1,0.7666666666666666,43.2574130670635,-0.01627189184903729,0.9794552314225964,0.7505447685774036,0.8471350509514286,50.00000000000003,0.07668198121956163,2691060.0,-11.111111111111107,0.0,9.585247652445203,9.585247652445203,0.825,0.75,0.929657239361541,0.7,1.1,0,,0.6329536262518128,3.277757911103993
2011-03-23,0.8,0.8,0.9,0.8,13260.0,1.1,0.1,0.8,43.2574130670635,-0.013230210042621742,0.9766190378969064,0.7433809621030936,0.842645998479864,50.00000000000003,0.07834755398959294,2704320.0,-11.111111111111107,0.0,9.793444248699117,9.793444248699117,0.825,0.8,0.9204709497870793,0.7,1.1,0,,0.6356110946471145,3.3346548547797683
2011-03-24,0.9,0.8,0.9,0.8,14010.0,1.1,0.1,0.8333333333333334,55.85965405042523,-0.004141014155201657,0.9766190378969064,0.7433809621030936,0.8481082843389246,100.0,0.07989415727605056,2718330.0,0.0,0.125,8.87712858622784,8.87712858622784,0.825,0.8,0.9116521117955961,0.7,1.1,0,,0.6387294312032442,3.4012210465327297
2011-03-25,0.9,0.9,0.9,0.9,4820.0,1.1,0.1,0.8666666666666667,55.85965405042523,0.0018898475579066654,0.9766190378969065,0.7433809621030937,0.8530503524971222,100.0,0.07418743175633268,2723150.0,0.0,0.0,8.243047972925853,8.243047972925853,0.825,0.9,0.9031860273237723,0.7,0.9,0,,0.6417983471176557,3.468219918050537
2011-03-26,0.9,0.9,0.9,0.8,11760.0,1.1,0.1,0.9,55.85965405042523,0.005683349578946385,0.9766190378969064,0.7433809621030936,0.8575217474973964,100.0,0.07603118663088033,2734910.0,0.0,0.0,8.44790962565337,8.44790962565337,0.825,0.9,0.7,0.7,0.9,0,,0.6448186432370198,3.5356383716709976
2011-03-27,0.8,0.9,0.9,0.8,5340.0,1.1,0.1,0.8666666666666667,43.729480456537665,0.0014809363603696495,0.9728982612255165,0.7371017387744837,0.8520434858309778,50.00000000000003,0.07774324472867458,2729570.0,-11.111111111111107,-0.11111111111111105,9.717905591084323,9.717905591084323,0.8,0.9,0.704,0.7,0.9,0,,0.6472926058214179,3.593537193862122
2011-03-28,0.8,0.8,0.9,0.8,12570.0,1.1,0.1,0.8333333333333334,43.72948045653767,-0.0011344731504637252,0.9683215956619927,0.7316784043380072,0.8470869633708846,50.00000000000003,0.0793330129623407,2742140.0,-11.111111111111107,0.0,9.916626620292588,9.916626620292588,0.8,0.9,0.70792,0.7,0.9,0,,0.6497255993381871,3.651590157752317
2011-03-29,0.8,0.8,0.8,0.8,4220.0,1.1,0.1,0.8,43.729480456537665,-0.002615489700547126,0.9628982612255165,0.7271017387744837,0.8426024906688956,50.00000000000003,0.07366636917931636,2746360.0,-11.111111111111107,0.0,9.208296147414545,9.208296147414545,0.8,0.9,0.7117616,0.7,0.9,0,,0.652118289065306,3.709786060542385
2011-03-30,0.8,0.8,0.8,0.8,3220.0,1.1,0.1,0.8,43.729480456537665,-0.0033018921547703084,0.9566190378969066,0.7233809621030935,0.8385451106051913,50.00000000000003,0.06840448566650806,2749580.0,-11.111111111111107,0.0,8.550560708313506,8.550560708313506,0.8,0.9,0.715526368,0.7,0.9,0,,0.6544713275604679,3.768113772478783
2011-03-31,0.8,0.8,0.8,0.8,6880.0,1.1,0.1,0.8,43.729480456537665,-0.0034467378569400294,0.9494552314225965,0.7205447685774035,0.8348741476904111,50.00000000000003,0.0635184509760432,2756460.0,0.0,0.0,7.9398063720054,7.9398063720054,0.8250000000000001,0.9,0.71921584064,0.7,0.9,0,,0.6567853549475311,3.826562241539696
2011-04-01,0.8,0.8,0.8,0.8,3190.0,1.1,0.1,0.8,43.729480456537665,-0.0032366974147870296,0.941355287256601,0.7186447127433991,0.8315528002913244,50.00000000000003,0.05898141876346868,2759650.0,0.0,0.0,7.372677345433584,7.372677345433584,0.8250000000000001,0.9,0.7228315238272,0.7,0.9,0,,0.6590609991955015,3.8851204979292877
2011-04-02,0.8,0.8,0.8,0.8,2490.0,1.1,0.1,0.8,43.729480456537665,-0.0028078547915878563,0.9322380529476366,0.7177619470523633,0.8285477716921505,50.00000000000003,0.05476846028036377,2762140.0,0.0,0.0,6.846057535045472,6.846057535045472,0.8250000000000001,0.9,0.726374893350656,0.7,0.9,0,,0.6612988763902682,3.9437776583823396
2011-04-03,0.8,0.8,0.8,0.8,3930.0,1.1,0.1,0.8,43.729480456537665,-0.0022579521701080064,0.9219803902718564,0.7180196097281437,0.8258289362928981,50.00000000000003,0.050856427403194925,2766070.0,14.285714285714299,0.0,6.357053425399366,6.357053425399366,0.8250000000000001,0.9,0.7298473954836429,0.7,0.9,0,,0.6634995909993046,4.002522930281597
2011-04-04,0.7,0.8,0.8,0.6,31160.0,1.1,0.1,0.7666666666666667,31.395288162666475,-0.008037618343150543,0.9177032961426906,0.7022967038573092,0.8138452280745269,33.33333333333332,0.06150953973153815,2734910.0,-12.50000000000001,-0.1250000000000001,8.78707710450545,8.78707710450545,0.75,0.8500000000000001,0.9,0.7,0.9,1,,0.665116694102219,4.049001569144635
2011-04-05,0.7,0.7,0.7,0.6,9730.0,1.1,0.1,0.7333333333333333,31.395288162666475,-0.01108147022142508,0.909544511501034,0.6904554884989661,0.8030028254007624,33.33333333333332,0.06425885832214256,2744640.0,-12.50000000000001,0.0,9.179836903163224,9.179836903163224,0.75,0.8500000000000001,0.894,0.7,0.9,0,,0.6667042894590134,4.095357736577451
2011-04-06,0.7,0.7,0.8,0.7,8700.0,1.1,0.1,0.7,31.39528816266649,-0.01222574604389792,0.9128982612255166,0.6771017387744834,0.7931930325054517,33.33333333333332,0.0668117970134181,2753340.0,-12.50000000000001,0.0,9.5445424304883,9.5445424304883,0.725,0.8500000000000001,0.88812,0.7,0.9,0,,0.6682628550457588,4.141584604451686
2011-04-07,0.8,0.7,0.8,0.7,10830.0,1.1,0.1,0.7333333333333333,49.26745155430005,-0.005709788236043331,0.9128982612255166,0.6771017387744834,0.79384131512398,66.66666666666669,0.0691823829410311,2764170.0,-11.111111111111107,0.14285714285714302,8.647797867628887,8.647797867628887,0.725,0.8500000000000001,0.8823576,0.7,0.9,0,,0.6703334039034186,4.200316372802932
2011-04-08,0.8,0.8,0.8,0.7,18210.0,1.1,0.1,0.7666666666666667,49.26745155430005,-0.0011028742868885444,0.9128982612255166,0.6771017387744834,0.7944278565407439,66.66666666666669,0.07138364130238603,2782380.0,-11.111111111111107,0.0,8.922955162798253,8.922955162798253,0.725,0.8,0.876710448,0.7,0.9,0,,0.6723695234930955,4.259088589754447
2011-04-09,0.7,0.8,0.8,0.7,12120.0,1.1,0.1,0.7666666666666666,37.836073073407796,-0.00431326679399846,0.9128982612255166,0.6771017387744834,0.7854347273463873,33.33333333333332,0.07342766692364419,2770260.0,-22.22222222222223,-0.1250000000000001,10.489666703377743,10.489666703377743,0.725,0.8,0.87117623904,0.7,0.9,0,,0.6738354589768423,4.304980916191177
2011-04-10,0.7,0.7,0.8,0.7,5350.0,1.1,0.1,0.7333333333333334,37.836073073407796,-0.005863504272083285,0.9148999599679686,0.6651000400320313,0.7772980866467314,33.33333333333332,0.07532569071481247,2775610.0,-12.50000000000001,0.0,10.760812959258924,10.760812959258924,0.725,0.8,0.8657527142592,0.7,0.9,0,,0.6752742693149039,4.350714838493131
2011-04-11,0.8,0.7,0.8,0.7,14650.0,1.1,0.1,0.7333333333333333,51.017174591132104,0.00010320776379185367,0.9148999599679687,0.6651000400320314,0.7794601736327569,100.0,0.07708814137804017,2790260.0,0.0,0.14285714285714302,9.63601767225502,9.63601767225502,0.725,0.8,0.860437659974016,0.7,0.9,0,,0.6772185029355766,4.409382865541745
2011-04-12,0.9,0.8,0.9,0.8,48420.0,1.1,0.1,0.8000000000000002,60.12301888238539,0.010468377991690002,0.9287908816025972,0.6612091183974029,0.7909401570963038,100.0,0.07872470270818017,2838680.0,12.499999999999996,0.125,8.747189189797796,8.747189189797796,0.75,0.8,0.6,0.7,0.9,1,,0.6795978710718025,4.47975720589047
2011-04-13,0.9,0.9,1.0,0.9,43400.0,1.1,0.1,0.8666666666666667,60.12301888238539,0.016641431318329868,0.9287908816025972,0.6612091183974029,0.8013268088014178,75.0,0.08024436680045301,2882080.0,12.499999999999996,0.0,8.91604075560589,8.91604075560589,0.8,0.8,0.606,0.7,0.9,1,,0.6819399721491444,4.550343032159542
2011-04-14,1.0,0.9,1.0,0.9,31110.0,1.1,0.1,0.9333333333333335,67.19559887041771,0.02620718252376852,0.9549193338482972,0.6450806661517029,0.8202480651060446,100.0,0.0816554834575635,2913190.0,24.999999999999993,0.11111111111111116,8.165548345756351,8.165548345756351,0.825,0.8,0.62176,0.7,0.9,1,,0.684660376140851,4.6318839505128375
2011-04-15,1.0,1.0,1.1,0.9,50310.0,1.1,0.1,0.9666666666666667,67.19559887041771,0.030956460695408337,0.9779161646579063,0.6320838353420938,0.8373672970007071,79.99999999999999,0.09010866321059467,2963500.0,24.999999999999993,0.0,9.010866321059467,9.010866321059467,0.875,0.8500000000000001,0.6368896,0.7,0.9,1,,0.687339911082769,4.713856679078073
2011-04-16,1.0,1.0,1.1,1.0,28870.0,1.1,0.1,1.0,67.19559887041771,0.03236734583471142,1.0076136028425826,0.6223863971574175,0.8528561258577826,79.99999999999999,0.09081518726698078,2992370.0,24.999999999999993,0.0,9.081518726698077,9.081518726698077,0.875,0.8500000000000001,0.6646762239999999,0.7,0.9,0,,0.6899791918805573,4.7962469330169855
2011-04-17,1.1,1.0,1.1,1.0,24230.0,1.1,0.1,1.0333333333333334,73.14456881744456,0.037919824619754974,1.058910462845192,0.6010895371548076,0.8763936376808509,100.0,0.0914712453193393,3016600.0,37.50000000000001,0.10000000000000009,8.31556775630357,8.31556775630357,0.875,0.8500000000000001,0.6907956505599999,0.7,0.9,0,,0.6929499436320885,4.889214770326258
2011-04-18,1.2,1.1,1.2,1.1,27480.0,1.2,0.1,1.0999999999999999,77.53240944775845,0.04569067700229815,1.129284800875379,0.570715199124621,0.9072132912350555,100.0,0.09208044208224363,3044080.0,71.42857142857143,0.09090909090909083,7.673370173520302,7.673370173520302,0.9249999999999999,0.8999999999999999,0.7153479115263999,0.7,0.9,0,,0.6962149752187786,4.992291673660134
2011-04-19,1.2,1.2,1.2,1.1,12560.0,1.2,0.1,1.1666666666666667,77.53240944775845,0.04795869737916966,1.1868595903550971,0.5531404096449026,0.9350977396888598,100.0,0.09264612479065479,3056640.0,71.42857142857143,0.0,7.720510399221232,7.720510399221232,0.9249999999999999,0.8999999999999999,0.7541200786042879,0.7,0.9,0,,0.6994336152261507,5.096286837781844
2011-04-20,1.1,1.2,1.2,1.1,21350.0,1.2,0.1,1.1666666666666667,65.18117734325686,0.04016768193243567,1.215302891298275,0.554697108701725,0.9508027168613493,80.00000000000003,0.0931714015913223,3035290.0,57.14285714285716,-0.08333333333333326,8.470127417392934,8.470127417392934,0.95,0.8999999999999999,0.7897904723159448,0.7,0.9,0,,0.7022715677919447,5.191395265680207
2011-04-21,1.2,1.1,1.2,1.1,39300.0,1.2,0.1,1.1666666666666667,70.2799056408089,0.03915225810245608,1.2598238999842035,0.5501761000157964,0.9745357914459827,100.0,0.09365915862051355,3074590.0,49.999999999999986,0.09090909090909083,7.804929885042797,7.804929885042797,0.975,0.8999999999999999,0.8226072345306692,0.7,0.9,0,,0.7054019311233536,5.297048127020559
2011-04-22,1.4,1.2,1.4,1.2,39420.0,1.4,0.1,1.2333333333333334,77.40605017705474,0.048729404493774386,1.346217703899042,0.5237822961009584,1.015056192260651,100.0,0.10125493300476258,3114010.0,74.99999999999997,0.16666666666666674,7.2324952146258985,7.2324952146258985,1.075,1.0,0.8527986557682157,0.7,0.9,0,,0.7090768949471996,5.421524625158616
2011-04-23,1.7,1.4,2.0,1.3,66620.0,1.7,0.1,1.4333333333333333,83.7140689481214,0.07071442106027853,1.5038320341483518,0.4561679658516484,1.0802889358548746,76.92307692307692,0.14402243779013668,3180630.0,142.85714285714286,0.2142857142857144,8.471908105302157,8.471908105302157,1.375,1.3,0.9075187901913941,0.7,1.7,1,,0.7134406808791806,5.570601504262448
2011-04-24,1.6,1.7,2.0,1.6,21540.0,1.7,0.1,1.5666666666666664,76.08832419121961,0.07363572137854651,1.5972761571129797,0.45272384288702017,1.1297852276782199,69.23076923076924,0.16230654937655548,3159090.0,128.5714285714286,-0.05882352941176461,10.144159336034717,10.144159336034717,1.4,1.3,1.038616535368427,0.7,1.7,0,,0.7175168314014597,5.714628459451759
2011-04-25,1.6,1.6,1.7,1.5,13470.0,1.7,0.1,1.6333333333333335,76.08832419121961,0.07066904996584297,1.6736555309114625,0.4663444690885371,1.174567586946961,66.66666666666667,0.16499893870680152,3172560.0,100.0,0.0,10.312433669175094,10.312433669175094,1.4,1.3,1.1539825511242157,0.7,1.7,0,,0.7215386177305773,5.860698159478089
2011-04-26,1.8,1.6,1.8,1.5,24050.0,1.8,0.1,1.6666666666666667,80.25936385346937,0.07676989346256213,1.7818865959965997,0.4681134040034004,1.234132578666298,81.81818181818181,0.1746418716563157,3196610.0,100.0,0.125,9.70232620312865,9.70232620312865,1.425,1.3,1.2555046449893097,0.7,1.7,0,,0.725950222881002,6.023860546708931
2011-04-27,1.9,1.8,2.0,1.7,33060.0,1.9,0.1,1.7666666666666666,81.95433348207993,0.08167752284236751,1.9,0.4600000000000003,1.297548523555222,90.90909090909089,0.1835960236808646,3229670.0,111.1111111111111,0.05555555555555558,9.66294861478235,9.66294861478235,1.425,1.3,1.3448440875905925,0.7,1.7,0,,0.730506952903168,6.196780387005615
2011-04-28,2.2,1.9,2.7,1.7,100240.0,2.2,0.1,1.9666666666666668,85.87312964792758,0.09815737585583856,2.073407554009556,0.426592445990444,1.3834962832166293,72.22222222222223,0.24191059341794574,3329910.0,120.00000000000001,0.1578947368421053,10.995936064452078,10.995936064452078,1.7750000000000001,1.6500000000000001,1.4234627970797213,0.7,1.7,1,,0.7355524867832155,6.392448552629177
2011-04-29,2.9,2.2,3.0,2.2,57580.0,2.9,0.1,2.3333333333333335,90.86044081375597,0.14632991833732664,2.4152724766618334,0.30472752333816633,1.5279252086245694,95.0,0.28177412245952105,3387490.0,190.0,0.3181818181818181,9.716349050328313,9.716349050328313,1.9249999999999998,1.8,1.6021780054885604,0.7,1.7,0,,0.7415624631903894,6.630539185619417
2011-04-30,3.5,2.9,4.2,2.8,65430.00000000001,3.5,0.1,2.8666666666666667,93.10680030839029,0.2051262584445539,2.865283853270081,0.13471614672991894,1.7157418554222295,78.125,0.36164739942669816,3452920.0,250.0,0.2068965517241379,10.332782840762803,10.332782840762803,2.55,2.4,1.7,0.7,1.7,0,,0.7481957124025624,6.902027681078984
2011-05-01,3.0,3.5,3.9,2.5,45770.0,3.5,0.1,3.133333333333333,76.2810604779128,0.196832233346465,3.0822771478223796,0.1377228521776208,1.8380521549058266,61.29032258064516,0.43581544232479114,3407150.0,172.72727272727272,-0.1428571428571429,14.52718141082637,14.52718141082637,2.6,2.4,2.15,3.0,1.7,0,,0.7541782759733305,7.158472919458191
2011-05-02,3.2,3.0,3.5,3.0,18330.0,3.5,0.1,3.233333333333333,77.99413364708957,0.19114579779241658,3.3122932936291267,0.13770670637087368,1.967761473486224,67.74193548387096,0.44040005358730605,3425480.0,166.66666666666669,0.06666666666666665,13.762501674603314,13.762501674603314,2.6500000000000004,2.4,2.5,3.0,1.7,0,,0.7603248826620089,7.431592085409945
2011-05-03,3.4,3.2,3.5,3.1,16920.0,3.5,0.1,3.1999999999999997,79.58221910090128,0.18695618125731195,3.5476454282328804,0.15235457176711953,2.1041651426780126,74.19354838709677,0.43751433547392704,3442400.0,183.33333333333334,0.0625,12.86806869040962,12.86806869040962,2.6500000000000004,2.4,2.5,3.0,1.7,0,,0.7666187793588002,7.721835534340497
2011-05-04,3.4,3.4,3.6,3.3,17280.0,3.5,0.1,3.3333333333333335,79.58221910090128,0.17073472478889595,3.747751388693031,0.1922486113069688,2.227577986232488,74.19354838709677,0.4276918829400751,3459680.0,209.09090909090904,0.0,12.579173027649269,12.579173027649269,2.6500000000000004,2.4,2.806,3.0,1.7,0,,0.77283613190432,8.020206068295783
2011-05-05,3.3,3.4,3.5,3.3,15350.0,3.5,0.1,3.3666666666666667,76.3856326961676,0.14105139434287145,3.894171080909708,0.27582891909029206,2.3297134161151076,69.99999999999999,0.41142817701578405,3444330.0,174.99999999999997,-0.02941176470588236,12.46752051562982,12.46752051562982,2.7,2.4,3.05692,3.0,1.7,0,,0.7788691989600925,8.321675307788697
2011-05-06,3.5,3.3,3.6,3.3,23020.0,3.5,0.1,3.4,78.26592848672972,0.12331028580470593,4.047280599146466,0.37271940085353306,2.4411692812470025,75.86206896551724,0.40346902151465663,3467350.0,150.00000000000003,0.06060606060606055,11.52768632899019,11.52768632899019,2.7,2.4,3.2626744,3.0,1.7,0,,0.7850425566152109,8.641637877494047
2011-05-07,3.6,3.5,3.7,3.4,17830.0,3.6,0.1,3.4666666666666663,79.15946718375359,0.10732153335824268,4.193251866674698,0.47674813332530164,2.5515341116044308,77.77777777777777,0.39607837712075256,3485180.0,111.76470588235294,0.028571428571428692,11.002177142243125,11.002177142243125,2.85,2.4,4.2,3.0,1.7,0,,0.7912432250860074,8.975591990546869
2011-05-08,3.9,3.6,3.9,3.6,21130.0,3.9,0.1,3.6666666666666665,81.6030349875859,0.10578820586477922,4.370631474010677,0.5693685259893224,2.679959434308771,88.88888888888889,0.38921563589784164,3506310.0,143.74999999999997,0.08333333333333326,9.979888099944658,9.979888099944658,2.95,2.4,4.184,3.0,1.7,0,,0.7976577754812888,9.334106141561556
2011-05-09,3.8,3.9,3.9,3.7,11520.0,3.9,0.1,3.766666666666667,78.30708901084814,0.08762745999766297,4.49103146457165,0.7089685354283501,2.7866299643746024,85.18518518518516,0.3757002333337101,3494790.0,137.49999999999997,-0.02564102564102566,9.886848245623952,9.886848245623952,2.875,2.4,4.1683200000000005,3.0,1.7,0,,0.8039023118349966,9.697887007573142
2011-05-10,5.8,3.8,6.0,3.8,56220.0,5.8,0.1,4.5,88.3991300825442,0.19381436003867514,5.060556110278957,0.6094438897210432,3.073617586815116,95.34883720930232,0.5060073595241594,3551010.0,222.22222222222223,0.5263157894736843,8.724264819382059,8.724264819382059,3.975,3.3,3.4,3.0,1.7,0,,0.8115858743967646,10.159075901704792
2011-05-11,5.5,5.8,6.1,4.6,52570.0,5.8,0.1,5.033333333333332,82.22016869924678,0.22515109384322796,5.427814122255985,0.6721858777440155,3.3047016261660573,86.36363636363637,0.5770068338438623,3498440.0,189.47368421052633,-0.051724137931034475,10.491033342615678,10.491033342615678,4.074999999999999,3.3499999999999996,3.452,3.0,1.7,0,,0.8189905391369801,10.625752895286164
2011-05-12,6.3,5.5,6.5,5.2,31720.0,6.3,0.1,5.866666666666667,85.19253096081013,0.27761673548510424,5.937328518560854,0.6526714814391452,3.589968137959766,95.34883720930232,0.6286492028550149,3530160.0,186.36363636363632,0.1454545454545455,9.978558775476428,9.978558775476428,4.325,3.55,3.5579199999999997,3.0,1.7,0,,0.826791647973326,11.139463162181716
2011-05-13,8.2,6.3,8.4,6.3,64000.0,8.2,0.1,6.666666666666667,89.62760909779601,0.41014191709738634,6.915815528818322,0.3241844711816775,4.029018791487408,96.6101694915254,0.733745688365371,3594160.0,182.75862068965515,0.3015873015873014,8.948118150797209,8.948118150797209,5.3,4.5,3.7344448,3.0,8.2,0,,0.8354363433099485,11.734838660878706
2011-05-14,7.2,8.2,8.9,5.8,55390.0,8.2,0.1,7.233333333333333,76.62009741606505,0.3998936568810233,7.406565271030898,0.39343472896910203,4.33101700182194,73.4375,0.9027638534821304,3538770.0,105.71428571428572,-0.12195121951219501,12.538386853918476,12.538386853918476,5.55,4.75,4.107689216,3.0,8.2,0,,0.8435233373972421,12.323347137206481
2011-05-15,7.0,7.2,7.8,6.2,18300.0,8.2,0.1,7.466666666666666,74.29766928977259,0.35083769256259334,7.757255218129872,0.5827447818701277,4.585205858791279,67.79661016949152,0.952566435376264,3520470.0,133.33333333333331,-0.02777777777777779,13.608091933946628,13.608091933946628,5.575,4.75,4.5869202944,3.0,8.2,0,,0.8514186197050703,12.92778403034718
2011-05-16,8.0,7.0,8.5,6.8,44140.0,8.2,0.1,7.3999999999999995,77.90401700038825,0.35581097236653947,8.260793567493469,0.6992064325065299,4.910424348430205,84.48275862068965,1.0059545471351024,3564610.0,149.99999999999997,0.1428571428571428,12.57443183918878,12.57443183918878,5.625,4.75,5.018228264959999,3.0,8.2,0,,0.8596916605201991,13.59175488372079
2011-05-17,7.2,8.0,8.4,7.0,35350.0,8.2,0.1,7.3999999999999995,69.50228466829927,0.2787052680697366,8.508229995628755,0.9817700043712456,5.128479172389233,69.64285714285715,1.0341006509111665,3529260.0,111.76470588235294,-0.09999999999999998,14.362509040432869,14.362509040432869,5.675000000000001,4.75,5.406405438464,3.0,8.2,0,,0.8675025814400752,14.252768893289597
2011-05-18,6.9,7.2,7.5,6.6,25400.0,8.2,0.1,7.366666666666667,66.601541861614,0.18546966132974418,8.664345260694224,1.2956547393057751,5.297195441685497,64.28571428571429,1.0245220329889404,3503860.0,102.94117647058825,-0.04166666666666663,14.848145405636817,14.848145405636817,5.725,4.75,5.7557648946176,3.0,8.2,0,,0.8750762528530196,14.926287222607892
2011-05-19,6.8,6.9,7.3,6.6,24440.0,8.2,0.1,6.966666666666666,65.61843787106922,0.09935251868505124,8.810863033723903,1.539136966276096,5.440319685334497,62.49999999999999,1.0013418877754445,3479420.0,106.06060606060606,-0.01449275362318847,14.725615996697714,14.725615996697714,5.975,4.75,6.0701884051558395,3.0,8.2,0,,0.8825128469694902,15.62000227724887
2011-05-20,5.6,6.8,7.1,5.6,44460.0,8.2,0.1,6.433333333333334,55.106476665861436,-0.04821438033946923,8.83674008046694,1.7232599195330578,5.4555273343502595,39.99999999999999,1.0369603243629129,3434960.0,59.999999999999986,-0.17647058823529416,18.51714864933773,18.51714864933773,6.125,4.75,8.9,3.0,8.2,0,,0.8891931711291114,16.27595420130766
2011-05-21,6.1,5.6,6.5,5.6,31110.0,8.2,0.1,6.166666666666665,58.11717518609674,-0.11796117667806194,8.848077789913377,2.0219222100866223,5.5169056834597585,47.1698113207547,1.0271774440512762,3466070.0,69.44444444444443,0.08928571428571419,16.838974492643874,16.838974492643874,6.225,4.75,8.834,3.0,8.2,0,,0.896091288148008,16.98120939032051
2011-05-22,6.7,6.1,6.8,6.0,23870.0,8.2,0.1,6.133333333333333,61.457504875367405,-0.12862497419934238,8.903569492207502,2.3164305077924983,5.629581332654068,57.69230769230769,1.0109504837618992,3489940.0,71.79487179487181,0.09836065573770503,15.088813190476108,15.088813190476108,6.275,4.75,8.76932,3.0,8.2,0,,0.9032327368190989,17.74238553000348
2011-05-23,7.2,6.7,7.4,6.7,35280.0,8.2,0.1,6.666666666666667,64.03189501247077,-0.1077862828500824,8.998749755763958,2.601250244236042,5.779145015258442,66.66666666666667,0.9887397349217635,3525220.0,89.47368421052633,0.07462686567164178,13.732496318357827,13.732496318357827,6.175,4.75,8.7059336,3.0,8.2,0,,0.9105394348779949,18.55594466608905
2011-05-24,7.4,7.2,7.5,7.0,29280.0,8.2,0.1,7.1000000000000005,65.03784728695047,-0.08719447281998827,9.071156134096732,2.9288438659032687,5.933512156662401,65.11627906976744,0.9538297538559233,3554500.0,27.586206896551737,0.0277777777777779,12.889591268323286,12.889591268323286,6.300000000000001,4.75,8.643814928,3.0,8.2,0,,0.9178570418920433,19.40875495191923
2011-05-25,8.4,7.4,9.3,7.2,64050.0,8.4,0.1,7.666666666666667,69.61388582009255,-0.016583995030676535,9.232566120172645,3.277433879827355,6.168415760789791,78.04878048780486,1.035699057151929,3618550.0,52.727272727272734,0.1351351351351351,12.329750680380105,12.329750680380105,6.675000000000001,4.95,5.6,3.0,8.2,0,,0.9255232308441208,20.342204599483036
2011-05-26,8.8,8.4,9.0,8.0,28650.0,8.8,0.1,8.200000000000001,71.23566075596048,0.04342289675216593,9.411781457856035,3.628218542143965,6.419042831190763,86.4864864864865,1.0331491244982198,3647200.0,39.6825396825397,0.04761904761904767,11.740330960207041,11.740330960207041,6.675000000000001,4.95,5.6739999999999995,3.0,8.2,0,,0.9332614086433163,21.33021454839166
2011-05-27,8.5,8.8,8.8,8.5,14430.0,8.8,0.1,8.566666666666668,68.2917177216222,0.048866671590195976,9.448486538069453,4.081513461930548,6.617229228220213,78.37837837837837,0.9807813298912043,3632770.0,3.6585365853658622,-0.03409090909090917,11.53860388107299,11.53860388107299,6.800000000000001,5.0,5.746519999999999,3.0,8.2,0,,0.9407962451623276,22.340970615224723
2011-05-28,8.3,8.5,8.7,8.1,12250.0,8.8,0.1,8.533333333333333,66.32385353967507,0.02609635947053146,9.401009105943098,4.568990894056901,6.7774931112468595,72.97297297297298,0.9535826634704039,3620520.0,15.277777777777784,-0.0235294117647058,11.488947752655468,11.488947752655468,6.825,5.0,5.8175896,8.3,8.2,0,,0.9481669675179886,23.37844073094744
2011-05-29,8.4,8.3,8.5,8.1,7490.0,8.8,0.1,8.4,66.8383914292498,0.0059214818942647796,9.214274868546084,5.2157251314539135,6.932017576842396,75.67567567567566,0.9140410446510893,3628010.0,20.000000000000004,0.012048192771084265,10.881441007751063,10.881441007751063,6.875,5.0,5.887237808,8.3,8.2,0,,0.9554957662233186,24.45909727882658
2011-05-30,8.8,8.4,9.0,8.3,17680.0,8.8,0.1,8.5,68.88621480012435,0.007562775718098713,9.367273707563472,5.362726292436529,7.109920664762168,86.4864864864865,0.8987523986045829,3645690.0,10.000000000000009,0.04761904761904767,10.213095438688441,10.213095438688441,6.9750000000000005,5.0,5.95549305184,8.3,8.2,0,,0.9628986826944606,25.601574124647655
2011-05-31,8.7,8.8,9.5,8.1,45790.0,8.8,0.1,8.633333333333333,67.75965873906256,-0.00913408521279857,9.413782676752401,5.636217323247599,7.261356791927676,79.48717948717946,0.9345557987042555,3599900.0,20.83333333333332,-0.011363636363636576,10.742020674761559,10.742020674761559,7.25,5.1,6.0223831908032,8.3,8.2,0,,0.9701815044494667,26.779872688282516
2011-06-01,9.6,8.7,9.7,8.3,43480.0,9.6,0.1,9.033333333333333,72.17077752058972,0.02738881301088547,9.694894012161232,5.685105987838767,7.484084716505992,97.5609756097561,0.9678018130825229,3643380.0,39.13043478260868,0.10344827586206895,10.08126888627628,10.08126888627628,7.449999999999999,5.199999999999999,6.1614878631710726,8.3,8.2,0,,0.9777108410682821,28.05325727265291
2011-06-02,10.6,9.6,10.9,9.5,41050.0,10.6,0.1,9.633333333333331,76.0858998788434,0.1016735762952059,10.177192429862846,5.442807570137155,7.7808385530292306,94.33962264150942,0.998673112148057,3684430.0,55.88235294117647,0.10416666666666674,9.421444454226952,9.421444454226952,8.15,5.8500000000000005,6.373798591380808,8.3,8.2,0,,0.9854856173115977,29.429932963005236
2011-06-03,14.3,10.6,14.5,10.6,72980.0,14.3,0.1,11.5,84.67605819837961,0.3678085726503857,11.832301460202032,4.497698539797966,8.401711071788352,97.75280898876406,1.2059107469946244,3757410.0,155.3571428571429,0.34905660377358494,8.432942286675695,8.432942286675695,10.175,7.7,6.735894704070343,8.3,8.2,1,,0.9941639757679787,31.03680504877567
2011-06-04,18.9,14.3,18.9,14.0,44480.0,18.9,0.1,14.6,89.65253421154664,0.7968379293603629,14.65996610159753,2.8600338984024702,9.401548112570413,100.0,1.469774265066437,3801890.0,209.8360655737705,0.32167832167832144,7.776583413049931,7.776583413049931,12.425,9.899999999999999,7.512305233663309,8.3,8.2,0,,1.0036667990998154,32.88907622359822
2011-06-05,16.7,18.9,19.0,16.2,24280.0,18.9,0.1,16.63333333333333,76.8057434431988,0.869699618751548,16.01745556966111,2.372544430338886,10.096638768516089,81.30081300813008,1.5647903889902628,3777610.0,149.25373134328356,-0.1164021164021164,9.370002329283011,9.370002329283011,12.675,9.95,8.878828605623712,8.3,8.2,0,,1.0126626491867887,34.75166952427686
2011-06-06,18.5,16.7,19.2,16.5,55090.0,18.9,0.1,18.03333333333333,79.40595266893082,0.9687912181429219,17.620636106575596,1.8993638934244048,10.89695888580027,94.26229508196722,1.6458767897766724,3832700.0,156.94444444444443,0.10778443113772451,8.89663129609012,8.89663129609012,12.924999999999999,10.1,10.295792600836393,8.3,8.2,0,,1.0218972639914374,36.772154576165704
2011-06-07,23.9,18.5,24.3,18.3,53720.0,23.9,0.1,19.7,84.88163831067362,1.3066641901745397,20.47162258454459,0.7483774154554101,12.135343753819292,97.66081871345028,1.9568855905069102,3886420.0,222.97297297297297,0.2918918918918918,8.187805818020545,8.187805818020545,15.575,12.65,11.72046578470257,8.3,8.2,0,,1.0318686511402428,39.078122999573736
2011-06-08,29.6,23.9,31.9,22.2,104930.0,29.6,0.1,24.0,88.39056108894236,1.7926559882555373,24.4493700631173,-0.9493700631173017,13.798644348693646,90.3765690376569,2.509965191184988,3991350.0,252.3809523809524,0.2384937238493725,8.479612132381716,8.479612132381716,19.375,16.5,13.984781943456108,8.3,29.6,1,,1.042430268836805,41.672935944968216
2011-06-09,28.9,29.6,31.5,26.1,62930.0,29.6,0.1,27.466666666666665,85.7581580013122,1.9334904297996953,27.306146583924434,-1.4761465839244323,15.236868696437107,87.39495798319327,2.7163962489574884,3928420.0,228.40909090909088,-0.023648648648648796,9.399294979091657,9.399294979091657,19.425,16.5,17.567825554764887,8.3,29.6,0,,1.0528043603010893,44.3942617355763
2011-06-10,24.0,28.9,29.4,20.0,92210.0,29.6,0.1,27.5,70.03486463052785,1.5781631491035197,28.614985646734006,-0.9949856467340066,16.071452630109764,66.80672268907564,3.1937965168890963,3836210.0,182.35294117647058,-0.16955017301038056,13.307485487037901,13.307485487037901,19.725,16.5,31.9,8.3,29.6,1,,1.0624706857093194,47.10231016125765
2011-06-11,14.6,24.0,24.0,13.0,121870.0,29.6,0.1,22.5,50.7948880870755,0.6397017161356975,28.647226282675394,-0.23722628267539037,15.931314284385024,27.3109243697479,3.7513824799684463,3714340.0,75.90361445783131,-0.3916666666666667,25.694400547729085,25.694400547729085,20.0,16.5,31.662,8.3,29.6,1,,1.070436424976369,49.48780347112566
2011-06-12,18.5,14.6,25.0,10.3,151190.0,29.6,0.1,19.033333333333335,56.17436335499562,0.2322557119255353,28.953666662749797,0.586333337250208,16.1759510192055,43.69747899159665,4.533426588542128,3865530.0,120.23809523809523,0.26712328767123283,24.505008586714208,24.505008586714208,19.925,16.55,30.91552,8.3,29.6,1,,1.0790767494644327,52.199919796624826
2011-06-13,19.8,18.5,24.5,16.0,73420.0,29.6,0.1,17.63333333333333,57.82938271389202,0.012543600121674991,29.312485410299402,1.4675145897005901,16.52109854118593,49.15966386554622,4.8167532607891195,3938950.0,125.0,0.07027027027027022,24.32703667065212,24.32703667065212,19.925,16.599999999999998,29.6785888,8.3,29.6,0,,1.0878432653878043,55.10333863680407
2011-06-14,19.3,19.8,20.5,18.0,36160.0,29.6,0.1,19.2,56.93875915631846,-0.1928832572477699,29.57072880340467,2.299271196595326,16.785755822977745,46.610169491525426,4.6512708850184685,3902790.0,121.83908045977014,-0.025252525252525304,24.099849145173412,24.099849145173412,19.925,16.7,28.515873472,8.3,29.6,0,,1.096436315497269,58.11220457263066
2011-06-15,19.5,19.3,20.0,19.0,27710.0,29.6,0.1,19.533333333333335,57.22255442050991,-0.3334755939420959,29.779710740658484,3.160289259341514,17.044255268408435,44.642857142857146,4.390465821802864,3930500.0,103.125,0.010362694300518172,22.51520934257879,22.51520934257879,19.925,16.7,27.42292106368,8.3,29.6,0,,1.1049720372366845,61.267525966311496
2011-06-16,17.0,19.5,19.9,17.0,49200.0,29.6,0.1,18.599999999999998,52.55955876534799,-0.5976084604972294,29.692573988846473,4.097426011153527,17.040040480940966,31.018518518518515,4.284003977388374,3881300.0,60.377358490566046,-0.1282051282051282,25.200023396402198,25.200023396402198,20.025,16.7,26.3955457998592,8.3,29.6,0,,1.1129837594068948,64.40043938353153
2011-06-17,15.7,17.0,18.3,13.0,108620.0,29.6,0.1,17.400000000000002,50.265746181883074,-0.8473845893212122,29.460946047765205,5.069053952234789,16.91241757799421,24.999999999999996,4.356575121860634,3772680.0,9.79020979020978,-0.07647058823529418,27.748886126500853,27.748886126500853,20.1,16.8,25.429813051867647,8.3,29.6,0,,1.1206599513086521,67.56419248234586
2011-06-18,16.9,15.7,17.0,15.1,35540.0,29.6,0.1,16.53333333333333,52.333697277827945,-0.913592995231602,29.193373418263,6.186626581737,16.91123495151857,30.555555555555546,4.18110547029916,3808220.0,-10.582010582010582,0.07643312101910826,24.74026905502462,24.74026905502462,19.65,16.8,24.522024268755587,8.3,29.6,0,,1.1284870503465907,70.9481636848677
2011-06-19,17.5,16.9,18.9,16.9,30180.0,29.6,0.1,16.7,53.37753873708912,-0.8974822897290942,28.884716539017177,7.365283460982823,16.967307813278705,33.33333333333333,4.025312222420649,3838400.0,4.790419161676651,0.03550295857988184,23.00178412811799,23.00178412811799,18.6,17.05,23.66870281263025,8.3,29.6,0,,1.136341487099585,74.51620355548663
2011-06-20,17.5,17.5,17.5,17.5,,29.6,0.1,17.299999999999997,53.37753873708912,-0.8668651643936092,28.429537495493634,8.70046250450637,17.018040402490257,33.33333333333333,3.737789920819174,,-5.405405405405405,0.0,21.358799547538137,21.358799547538137,18.799999999999997,17.2,22.866580643872435,8.3,29.6,0,,1.1441137151045386,78.22909050442374
2011-06-21,17.5,17.5,17.5,17.5,,29.6,0.1,17.5,53.37753873708912,-0.8267849353869083,27.950973250989,9.969026749010999,17.063941316538806,33.33333333333333,3.470804926474947,,-26.778242677824267,0.0,19.83317100842827,19.83317100842827,19.375,17.2,22.11258580524009,8.3,29.6,0,,1.1518046891309288,82.09106251448239
2011-06-22,17.5,17.5,17.5,17.5,,29.6,0.1,17.5,53.37753873708912,-0.7809900780547006,27.47873231761352,11.131267682386477,17.105470714963683,33.96226415094339,3.2228902888695936,,-40.878378378378386,0.0,18.41651593639768,18.41651593639768,18.375,17.45,21.403830656925685,8.3,29.6,0,,1.1594153505626532,86.10641660261189
2011-06-23,17.5,17.5,17.5,17.5,,29.6,0.1,17.5,53.377538737089125,-0.7322340101266414,27.36114462886792,11.568855371132079,17.14304493258619,37.69633507853403,2.9926838396646227,,-39.44636678200692,0.0,17.101050512369273,17.101050512369273,18.25,17.5,20.737600817510142,8.3,29.6,0,,1.1669466276213019,90.27950748840763
2011-06-24,17.5,17.5,17.5,17.5,,29.6,0.1,17.5,53.377538737089125,-0.6825088769868661,27.33464104982081,11.455358950179189,17.177040653292266,48.97959183673469,2.778920708260007,,-27.083333333333332,0.0,15.879546904342897,15.879546904342897,18.225,17.599999999999998,20.111344768459535,8.3,29.6,0,,1.1743994355850769,94.61474619579305
2011-06-25,17.5,17.5,17.5,17.5,,29.6,0.1,17.5,53.377538737089125,-0.6332274504043713,27.327851195860703,11.542148804139297,17.20779868631205,48.97959183673469,2.5804263719557206,,19.863013698630137,0.0,14.74529355403269,14.74529355403269,17.975,17.599999999999998,19.522664082351962,8.3,29.6,0,,1.181774677003489,99.11659858884585
2011-06-26,16.5,17.5,17.5,14.0,15050.0,29.6,0.1,17.166666666666668,50.2937900802597,-0.6491819546805531,27.32280946192382,11.34719053807618,17.140389287615665,30.434782608695652,2.6461102025303123,3823350.0,-10.81081081081081,-0.05714285714285716,16.037031530486743,16.037031530486743,18.275,17.599999999999998,18.969304237410846,8.3,29.6,0,,1.1888924565285992,103.68004998827882
2011-06-27,16.8,16.5,18.0,15.0,31450.0,29.6,0.1,16.933333333333334,51.20455367345473,-0.6207461351575456,26.75292737647791,11.207072623522091,17.1079712602237,50.66666666666667,2.6713880452067187,3854800.0,-15.151515151515152,0.0181818181818183,15.901119316706659,15.901119316706659,18.575,17.65,18.449145983166193,8.3,29.6,0,,1.195991249125784,108.44497415091422
2011-06-28,17.0,16.8,17.5,16.5,24400.0,29.6,0.1,16.766666666666666,51.838119684609346,-0.5709449336837504,24.43752823402075,12.262471765979253,17.097688283059536,57.142857142857146,2.55200318483481,3879200.0,-11.917098445595858,0.011904761904761862,15.011783440204765,15.011783440204765,18.55,17.75,18.0,8.3,17.0,0,,1.2030523586510953,113.40742496685267
2011-06-29,16.9,17.0,17.2,16.7,21040.0,29.6,0.1,16.9,51.47821233082311,-0.5282069861444247,21.46187284264963,14.038127157350372,17.078860827530058,56.521739130434774,2.405431528775181,3858160.0,-13.333333333333341,-0.005882352941176561,14.233322655474446,14.233322655474446,18.55,17.8,18.0,8.3,17.0,0,,1.2100221986141657,118.53730695421983
2011-06-30,16.1,16.9,17.0,15.7,34960.0,29.6,0.1,16.666666666666668,48.572790438926596,-0.5356050172700286,19.78108738507084,14.92891261492916,16.98563598681291,52.542372881355966,2.3264721338626684,3823200.0,-5.294117647058815,-0.04733727810650867,14.450137477407877,14.450137477407877,18.55,17.849999999999998,17.538,8.3,17.0,0,,1.2167725064353132,123.74388504969926
2011-07-01,15.4,16.1,16.7,15.3,33280.0,29.6,0.1,16.133333333333333,46.11996064882525,-0.5664369729533486,19.65904505255524,15.13095494744476,16.83462303568787,28.571428571428587,2.2602955528724777,3789920.0,-1.9108280254777004,-0.0434782608695653,14.677243849821284,14.677243849821284,18.55,18.25,17.2,8.3,17.0,0,,1.22331807807873,129.0281035856546
2011-07-02,15.4,15.4,15.8,15.3,19450.0,29.6,0.1,15.633333333333335,46.11996064882525,-0.5643772073824246,19.602541004935127,14.877458995064872,16.697992270384262,28.571428571428587,2.1345601562387295,3809370.0,-8.875739644970404,0.0,13.860780235316424,13.860780235316424,18.55,18.55,17.0,8.3,17.0,0,,1.229795440520008,134.48792139581397
2011-07-03,15.4,15.4,15.7,15.3,16790.0,29.6,0.1,15.4,46.11996064882525,-0.5405231946453087,19.200458667344996,14.839541332655012,16.574373958919093,35.00000000000001,2.010663002221677,3826160.0,-11.999999999999998,0.0,13.056253261179721,13.056253261179721,18.55,18.75,16.7,8.3,17.0,0,,1.2362053654925689,140.12715809114053
2011-07-04,13.9,15.4,15.5,13.1,52280.0,29.6,0.1,14.9,40.62889497415954,-0.5987539708030187,19.067326045251278,14.432673954748722,16.319671677117274,16.326530612244913,2.038472787777272,3773880.0,-20.57142857142857,-0.09740259740259738,14.66527185451275,14.66527185451275,18.225,18.75,16.316,8.3,17.0,0,,1.2422411774957474,145.68678412044275
2011-07-05,12.9,13.9,15.0,11.0,84080.0,29.6,0.1,14.066666666666668,37.429450444923496,-0.6721078355616357,18.947132762638315,13.89286723736169,15.993988660248963,27.142857142857146,2.1785818743646095,3689800.0,-26.285714285714285,-0.07194244604316546,16.888231584221778,16.888231584221778,17.175,18.75,15.955039999999999,12.9,17.0,0,,1.247990424298059,151.21624016997794
2011-07-06,14.8,12.9,16.5,12.7,111820.0,29.6,0.1,13.866666666666667,46.11239005766247,-0.5644921336883181,18.916837164074494,13.703162835925504,15.880275454510967,54.28571428571429,2.2943974547671373,3801620.0,-15.428571428571425,0.1472868217054264,15.502685505183358,15.502685505183358,15.95,18.75,10.3,12.9,17.0,0,,1.2540888749736392,157.28113450960157
2011-07-07,14.8,14.8,15.9,14.5,54470.0,29.6,0.1,14.166666666666666,46.11239005766247,-0.4690565758278008,18.94251750694556,13.587482493054441,15.777392077890875,54.28571428571429,2.2305119222837706,3856090.0,-15.428571428571425,0.0,15.071026501917368,15.071026501917368,15.875,18.75,10.424000000000001,12.9,17.0,0,,1.2601238667203765,163.53232573577094
2011-07-08,14.3,14.8,15.6,13.9,34850.0,29.6,0.1,14.633333333333335,44.23875303937483,-0.41709794300086506,18.926612437284223,13.343387562715774,15.636688070472697,47.14285714285715,2.1926182135492156,3821240.0,-18.285714285714285,-0.03378378378378377,15.332994500344164,15.332994500344164,15.875,18.75,10.545520000000002,12.9,17.0,0,,1.2659942086211247,169.8716561868397
2011-07-09,14.4,14.3,14.7,14.0,11910.0,29.6,0.1,14.5,44.722513966743755,-0.3558723130143932,18.79538629676284,13.164613703237162,15.518908254237203,48.57142857142858,2.0860026268671286,3833150.0,-17.71428571428571,0.006993006993006867,14.486129353243948,14.486129353243948,14.8,18.75,10.664609600000002,12.9,17.0,0,,1.2718239855344653,176.41871903258843
2011-07-10,14.9,14.4,15.7,14.4,45280.0,29.6,0.1,14.533333333333333,47.18953574914513,-0.2657096869203488,18.612245463386625,13.087754536613376,15.459964610976519,55.71428571428572,2.029859582090905,3878430.0,-9.696969696969694,0.03472222222222232,13.623218671751038,13.623218671751038,14.625,18.75,10.781317408000001,12.9,17.0,0,,1.2776937189554574,183.26532530206035
2011-07-11,14.2,14.9,15.2,13.8,49160.0,29.6,0.1,14.5,44.21443614252811,-0.23811197657253835,18.427462397189792,12.942537602810205,15.339967981359708,49.23076923076922,1.9848696119415545,3829270.0,-15.476190476190485,-0.046979865771812124,13.977955013672918,13.977955013672918,14.6,18.75,10.89569105984,12.9,17.0,0,,1.283361161801641,190.1555388412902
2011-07-12,14.0,14.2,14.6,13.9,26360.0,29.6,0.1,14.366666666666667,43.373055601375356,-0.21872392364157345,18.213257294450532,12.80674270554947,15.212351983134974,48.38709677419355,1.8930932110885863,3802910.0,-17.647058823529413,-0.014084507042253502,13.522094364918475,13.522094364918475,14.35,18.95,11.0077772386432,12.9,17.0,0,,1.288928065989743,197.19233898972982
2011-07-13,13.9,14.0,14.1,13.9,10340.0,29.6,0.1,14.033333333333333,42.93313363412444,-0.19861759625682873,17.9576224995231,12.702377500476903,15.087366079979263,48.33333333333334,1.7721579817251158,3792570.0,-17.751479289940818,-0.0071428571428571175,12.749337998022417,12.749337998022417,14.35,19.3,11.117621693870337,12.9,17.0,0,,1.2944160637866513,204.39882994040875
2011-07-14,14.0,13.9,14.1,13.7,17660.0,29.6,0.1,13.966666666666667,43.549737550120746,-0.1658988528237667,17.643754708684654,12.666245291315349,14.983807405695524,52.631578947368425,1.674146697316179,3810230.0,-13.043478260869573,0.007194244604316502,11.958190695115563,11.958190695115563,14.774999999999999,19.45,11.22526925999293,12.9,17.0,0,,1.2998678136984518,211.82778035620507
2011-07-15,13.8,14.0,14.1,13.5,24820.0,29.6,0.1,13.9,42.5592903916018,-0.14575724405247503,17.277466142763537,12.662533857236461,14.871063843248331,50.90909090909092,1.5974219332221662,3785410.0,-10.389610389610388,-0.014285714285714235,11.575521255233086,11.575521255233086,14.6,19.55,11.330763874793071,12.9,17.0,0,,1.305221069463899,219.40375843208514
2011-07-16,13.7,13.8,13.8,13.5,17260.0,29.6,0.1,13.833333333333334,42.04440722917914,-0.12784061941719022,17.088406517879378,12.571593482120626,14.759533953415158,49.09090909090908,1.5047489379920116,3768150.0,-11.038961038961045,-0.007246376811594346,10.98356889045264,10.98356889045264,14.55,19.95,11.43414859729721,12.9,17.0,0,,1.3104975468840159,227.1522696796191
2011-07-17,13.2,13.7,13.8,13.0,34380.0,29.6,0.1,13.566666666666668,39.473009597352,-0.13749348169836528,16.82393652161236,12.476063478387639,14.611006910232762,39.99999999999999,1.4544097281354396,3733770.0,-14.285714285714294,-0.03649635036496346,11.018255516177573,11.018255516177573,14.425,20.0,11.535465625351264,12.9,17.0,0,,1.3156116899236625,234.95378488231128
2011-07-18,13.5,13.2,13.9,12.5,75900.0,29.6,0.1,13.466666666666667,41.77399535310097,-0.1125528387666872,16.414974226632935,12.535025773367062,14.505196728305833,45.45454545454545,1.4505233189829083,3809670.0,-2.8776978417266212,0.022727272727272707,10.744617177651172,10.744617177651172,14.3,20.0,11.634756312844239,12.9,17.0,0,,1.3207371703250141,243.04391647074252
2011-07-19,13.9,13.5,14.7,13.4,67580.0,29.6,0.1,13.533333333333333,44.78785412092139,-0.0605987896016813,15.926093376415027,12.723906623584972,14.44755894465766,35.00000000000001,1.4397716533412717,3877250.0,7.751937984496124,0.029629629629629672,10.358069448498357,10.358069448498357,14.175,20.0,11.732061186587353,12.9,17.0,0,,1.32589317069526,251.46249466174262
2011-07-20,13.7,13.9,14.0,13.4,23180.0,29.6,0.1,13.700000000000001,43.57339746966492,-0.03258925924471523,15.602819730866637,12.80718026913336,14.376362854690264,35.2941176470588,1.379787963816895,3854070.0,-7.432432432432441,-0.014388489208633115,10.071444991364197,10.071444991364197,14.05,20.0,11.827419962855606,12.9,17.0,0,,1.3309541650535237,260.03142810660665
2011-07-21,13.6,13.7,13.8,13.4,25020.0,29.6,0.1,13.733333333333334,42.946346741299266,-0.014599951363367558,15.422325514170089,12.807674485829912,14.302423535195953,34.375,1.3098031092585454,3829050.0,-8.108108108108116,-0.007299270072992692,9.630905215136364,9.630905215136364,14.05,20.0,11.920871563598494,12.9,17.0,0,,1.335941674024488,268.78034117472913
2011-07-22,13.7,13.6,13.8,13.4,15170.0,29.6,0.1,13.666666666666666,43.81705060300055,0.008962654955126714,15.206605286406658,12.853394713593344,14.24504986517729,37.499999999999986,1.2448171728829347,3844220.0,-4.195804195804206,0.007352941176470562,9.086256736371787,9.086256736371787,14.05,20.1,12.012454132326525,12.9,17.0,0,,1.3408982426100824,277.7775726155417
2011-07-23,13.7,13.7,13.8,13.5,22460.0,29.6,0.1,13.666666666666666,43.81705060300055,0.02838111191734627,14.945949549178227,12.94405045082177,14.193140354208023,37.499999999999986,1.1773302319627252,3866680.0,-4.861111111111118,0.0,8.593651328195074,8.593651328195074,13.925,20.7,12.102205049679995,12.9,17.0,0,,1.345803389701614,286.9935371952769
2011-07-24,14.0,13.7,14.1,13.6,26620.0,29.6,0.1,13.799999999999999,46.649834250437145,0.06326476159745931,14.950999500499424,12.949000499500574,14.17474603475964,55.55555555555557,1.1289495011082449,3893300.0,-6.040268456375841,0.021897810218978186,8.063925007916035,8.063925007916035,13.85,21.1,12.190160948686396,12.9,17.0,0,,1.350719036929887,296.5386350147314
2011-07-25,14.1,14.0,14.7,13.8,31580.0,29.6,0.1,13.933333333333332,47.598291473315626,0.09310530995149002,14.888407650239964,13.131592349760036,14.16762736478253,72.72727272727273,1.1125959653147988,3924880.0,-0.7042253521126736,0.0071428571428571175,7.89075152705531,7.89075152705531,13.8,21.1,12.276357729712668,12.9,14.1,0,,1.3556039693030608,306.35057533895025
2011-07-26,13.9,14.1,14.1,13.8,16790.0,29.6,0.1,14.0,45.842920426495496,0.09886314426160558,14.7656872048435,13.1643127951565,14.142139044327052,63.63636363636367,1.0545533963637417,3908090.0,-0.7142857142857117,-0.014184397163120477,7.586715081753537,7.586715081753537,13.725,21.1,12.360830575118415,12.9,14.1,0,,1.360398215582275,316.3223923496459
2011-07-27,13.9,13.9,14.1,13.9,11510.0,29.6,0.1,13.966666666666667,45.842920426495496,0.1017627684395952,14.62313583324995,13.216864166750053,14.119078182962571,63.63636363636367,0.9935138680520458,3919600.0,0.0,0.0,7.147581784547091,7.147581784547091,13.9,21.1,12.443613963616047,12.9,14.1,0,,1.3651428951658875,326.5280517396578
2011-07-28,13.5,13.9,13.9,13.3,32740.000000000004,29.6,0.1,13.766666666666666,42.23046273613163,0.07695991532785612,14.583135833249951,13.17686416675005,14.060118356013756,45.45454545454547,0.9654057346197568,3886860.0,-3.571428571428571,-0.02877697841726623,7.1511535897759755,7.1511535897759755,13.875,21.1,12.524741684343725,12.9,14.1,0,,1.369756733895797,336.8068313942904
2011-07-29,13.5,13.5,13.7,13.3,7260.0,29.6,0.1,13.633333333333333,42.23046273613163,0.061445550994617903,14.514043444854678,13.155956555145327,14.006773750679113,45.45454545454547,0.9250196107183454,3894120.0,-2.173913043478266,0.0,6.851997116432187,6.851997116432187,13.875,21.1,12.604246850656851,12.9,14.1,0,,1.3743227319645512,347.3157538689847
2011-07-30,13.5,13.5,13.6,13.4,6100.0,29.6,0.1,13.5,42.23046273613163,0.05242627325455945,14.251929152957706,13.278070847042295,13.95850958394777,45.45454545454547,0.873232495667035,3900220.0,-1.459854014598535,0.0,6.468388856792852,6.468388856792852,13.875,20.9,12.682161913643714,12.9,14.1,0,,1.3788414013252668,358.057195072115
2011-07-31,13.4,13.5,14.9,12.8,45720.0,29.6,0.1,13.466666666666669,41.21633212390633,0.04144953893989256,14.193508271005017,13.256491728994982,13.905318195000362,37.50000000000001,0.9608587459765324,3854500.0,1.5151515151515234,-0.007407407407407418,7.170587656541287,7.170587656541287,14.175,19.85,12.75851867537084,12.9,14.1,0,,1.3832925879088704,368.98822388372537
2011-08-01,13.1,13.4,13.6,12.9,21750.0,29.6,0.1,13.333333333333334,38.24882298171719,0.01696332267031042,14.203832034148462,13.156167965851541,13.828621224047946,14.285714285714237,0.94222597840678,3832750.0,-2.9629629629629655,-0.022388059701492602,7.1925647206624435,7.1925647206624435,14.025,17.65,12.8,12.9,14.1,0,,1.3876348728265573,380.0123255463292
2011-08-02,12.1,13.1,13.1,11.5,57240.0,29.6,0.1,12.866666666666667,30.393459444822085,-0.05941779476410719,14.445336191213794,12.734663808786205,13.663990631281475,17.6470588235294,0.9892098370920099,3775510.0,-12.949640287769789,-0.07633587786259544,8.175287909851322,8.175287909851322,13.399999999999999,17.65,16.5,12.9,14.1,0,,1.3917125523700533,390.7560270858876
2011-08-03,9.3,12.1,12.2,8.7,90290.0,29.6,0.1,11.5,18.769672801195796,-0.27905797618615824,15.394092935596642,11.315907064403355,13.248372475921336,9.677419354838731,1.1685519915854379,3685220.0,-32.116788321167874,-0.23140495867768585,12.565075178338041,12.565075178338041,12.0,16.6,16.4,12.9,14.1,1,,1.3950219458549544,399.9770351562416
2011-08-04,10.8,9.3,11.1,9.3,50090.0,29.6,0.1,10.733333333333334,33.45270670711572,-0.30192427828674273,15.514523760432038,10.895476239567959,13.015194144881209,33.8709677419355,1.2136554207579064,3735310.0,-20.58823529411764,0.16129032258064524,11.237550192202837,11.237550192202837,12.0,14.6,16.092,12.9,14.1,0,,1.3987057289051923,410.3315625785793
2011-08-05,9.8,10.8,11.0,9.5,30770.0,29.6,0.1,9.966666666666667,29.610061147099103,-0.35911384867221874,15.739761894378365,10.280238105621635,12.708985178702045,17.74193548387099,1.2341086049894845,3704540.0,-28.467153284671525,-0.09259259259259256,12.59294494887229,12.59294494887229,11.875,14.35,15.796319999999998,12.9,14.1,0,,1.4020836432697006,420.1927341841691
2011-08-06,6.6,9.8,9.9,5.7,102410.0,29.6,0.1,9.066666666666668,21.212882222690595,-0.5743989741820422,16.582101997641807,8.777898002358194,12.127177066444707,9.782608695652169,1.4459579903473785,3602130.0,-51.82481751824818,-0.3265306122448981,21.908454399202707,21.908454399202707,10.3,12.799999999999999,15.512467199999998,6.6,14.1,1,,1.4043438641223787,427.440738399365
2011-08-07,7.9,6.6,9.5,6.0,89830.0,29.6,0.1,8.1,29.909160381720625,-0.5890010701722914,16.798636152263587,8.001363847736414,11.724588774402353,23.913043478260875,1.5926752767511372,3691960.0,-43.57142857142857,0.19696969696969702,20.160446541153636,20.160446541153636,10.3,12.299999999999999,14.923719167999998,6.6,14.1,1,,1.4070663409974067,436.0134981957851
2011-08-08,7.8,7.9,8.2,7.1,34040.0,29.6,0.1,7.433333333333334,29.638159458274316,-0.5650557418985391,16.865524080224333,7.324475919775667,11.35081841493546,22.82608695652174,1.557484185554627,3657920.0,-44.680851063829785,-0.012658227848101333,19.967745968649066,19.967745968649066,10.3,12.299999999999999,14.370296017919998,6.6,14.1,0,,1.4097226308870126,444.58490149630114
2011-08-09,10.0,7.8,12.1,7.7,114470.0,29.6,0.1,8.566666666666668,42.073347226299106,-0.37013638544426675,16.704121400215087,7.115878599784915,11.222169042084465,46.73913043478261,1.7605210294435822,3772390.0,-28.057553956834536,0.28205128205128216,17.60521029443582,17.60521029443582,9.975000000000001,12.299999999999999,13.850078256844798,6.6,14.1,1,,1.4130218053322583,455.067351647737
2011-08-10,10.0,10.0,10.4,9.5,24250.0,29.6,0.1,9.266666666666667,42.073347226299106,-0.21782705990363915,16.52712413848133,6.93287586151867,11.105771990457374,46.73913043478261,1.6990552416261835,3796640.0,-28.057553956834536,0.0,16.990552416261835,16.990552416261835,9.850000000000001,11.85,13.36107356143411,6.6,14.1,0,,1.4162850463980483,465.7007005962149
2011-08-11,9.5,10.0,10.5,8.4,58120.0,29.6,0.1,9.833333333333334,40.200660900598876,-0.1316215427477032,16.321499765698242,6.718500234301758,10.952841324699529,41.30434782608696,1.727694152938599,3738520.0,-29.629629629629626,-0.050000000000000044,18.186254241458936,18.186254241458936,9.625,11.85,12.901409147748062,6.6,14.1,0,,1.419374367674576,476.09178549046
2011-08-12,9.5,9.5,9.8,8.9,41590.0,29.6,0.1,9.666666666666666,40.20066090059887,-0.059158823671831895,16.07902505759828,6.540974942401719,10.814475484251956,41.30434782608696,1.6685731420144134,3780110.0,-29.629629629629626,0.0,17.563927810678038,17.563927810678038,9.600000000000001,11.85,12.469324598883178,6.6,14.1,0,,1.422429600954426,486.6188752979387
2011-08-13,10.1,9.5,10.3,9.3,29760.0,29.6,0.1,9.700000000000001,43.68887241533865,0.039316993553119906,15.745021598221793,6.484978401778204,10.746430200037484,47.826086956521735,1.6208179175848125,3809870.0,-25.185185185185187,0.06315789473684208,16.047702154305075,16.047702154305075,9.600000000000001,11.85,12.063165122950187,6.6,14.1,0,,1.4256154421779517,497.7699363593249
2011-08-14,10.8,10.1,11.2,9.6,44130.0,29.6,0.1,10.133333333333335,47.53404207467487,0.15522720667840106,15.373347148936006,6.526652851063993,10.751532085748199,64.55696202531647,1.6193309234716118,3854000.0,-19.402985074626862,0.06930693069306937,14.993804846959366,14.993804846959366,9.600000000000001,11.85,11.681375215573176,6.6,14.1,0,,1.428945960911619,509.6203430691109
2011-08-15,11.1,10.8,11.9,10.7,38160.0,29.6,0.1,10.666666666666666,49.137032311739645,0.25010789675873935,15.02326476737462,6.596735232625382,10.784719506153133,72.97297297297298,1.589378714652211,3892160.0,-15.267175572519085,0.02777777777777768,14.318727159028926,14.318727159028926,9.675,11.85,5.7,6.6,14.1,0,,1.4323139162461034,521.8736364250294
2011-08-16,11.0,11.1,11.3,10.8,15330.0,29.6,0.1,10.966666666666667,48.60395729413008,0.30073677463174797,14.635528932019048,6.694471067980954,10.805222410329025,81.53846153846155,1.5115659493199103,3876830.0,-9.090909090909088,-0.009009009009009028,13.741508630181002,13.741508630181002,9.95,11.85,5.824,6.6,14.1,0,,1.4356218844978739,534.2341126090573
2011-08-17,10.9,11.0,11.1,10.7,22900.0,29.6,0.1,11.0,48.042662316552075,0.3202899845327296,14.290143139748512,6.779856860251488,10.814248847440545,81.25,1.4321683815113455,3853930.0,17.204301075268813,-0.009090909090909038,13.139159463406838,13.139159463406838,10.100000000000001,11.85,5.94552,6.6,14.1,0,,1.4388702698906024,546.6966004004769
2011-08-18,10.8,10.9,11.1,10.8,8210.0,29.6,0.1,10.9,47.452510963513625,0.3186105505486678,13.9048537772638,6.8951462227362015,10.81289181435097,79.68750000000001,1.351299211403392,3845720.0,0.0,-0.00917431192660545,12.51202973521659,12.51202973521659,10.225000000000001,11.6,6.0646096,6.6,14.1,0,,1.4420594678153928,559.255746325904
2011-08-19,11.6,10.8,11.8,10.8,33720.0,29.6,0.1,11.100000000000001,52.481427177188934,0.3604206649696169,13.56289809539837,7.047101904601632,10.887854498698497,92.18750000000001,1.3262064105888638,3879440.0,18.367346938775498,0.07407407407407396,11.432813884386757,11.432813884386757,10.225000000000001,11.45,6.181317408,6.6,11.6,0,,1.4454031917683943,572.6368480805344
2011-08-20,11.4,11.6,11.7,11.4,9920.0,29.6,0.1,11.266666666666667,51.163156908162996,0.36265829509364544,13.187934796471477,7.2220652035285235,10.936630260727211,88.52459016393443,1.2529059526896593,3869520.0,72.72727272727273,-0.01724137931034475,10.990403093768942,10.990403093768942,10.350000000000001,11.35,6.29569105984,6.6,11.6,0,,1.4486657647359238,586.0577170455431
2011-08-21,11.3,11.4,11.5,11.3,8720.0,29.6,0.1,11.433333333333332,50.48038418913544,0.3455305532071906,12.840637540099625,7.389362459900376,10.971236902562715,84.00000000000003,1.1776983846403979,3860800.0,43.037974683544306,-0.00877192982456132,10.422109598587591,10.422109598587591,10.450000000000001,11.2,6.407777238643201,6.6,11.6,0,,1.451870571094469,599.5899234945445
2011-08-22,10.9,11.3,11.5,10.5,37000.0,29.6,0.1,11.200000000000001,47.73621142717384,0.29723000267640054,12.65305696627313,7.45694303372687,10.96445243565198,72.72727272727273,1.1650056428803697,3823800.0,39.74358974358975,-0.03539823008849563,10.688125164040088,10.688125164040088,10.525,11.1,6.517621693870336,6.6,11.6,0,,1.4549468365089555,612.9664010950257
2011-08-23,10.9,10.9,11.3,10.8,12780.0,29.6,0.1,11.033333333333337,47.73621142717384,0.2567725525042208,12.733672738149291,7.536327261850711,10.958314108447029,71.42857142857143,1.117505239817486,3836580.0,9.000000000000004,0.0,10.252341649701707,10.252341649701707,10.75,11.1,6.62526925999293,6.6,11.6,0,,1.457990095149865,626.5212286337066
2011-08-24,10.9,10.9,11.1,10.8,7820.0,29.6,0.1,10.9,47.736211427173835,0.22276661549460147,12.744150533283424,7.535849466716578,10.952760383833025,71.42857142857143,1.0591120084019512,3844400.0,9.000000000000004,0.0,9.71662393029313,9.71662393029313,10.725000000000001,11.1,6.730763874793071,6.6,11.6,0,,1.4610006862965423,640.2542358951075
2011-08-25,9.7,10.9,10.9,9.1,55490.0,29.6,0.1,10.5,39.658313761314886,0.1174980825999245,12.742124853166864,7.527875146833139,10.833449871087023,26.66666666666663,1.1120325792303833,3788910.0,2.1052631578947296,-0.11009174311926617,11.464253394127665,11.464253394127665,10.375,11.1,6.83414859729721,6.6,11.6,0,,1.463675588308701,652.9753365995498
2011-08-26,8.2,9.7,9.9,7.6,83000.0,29.6,0.1,9.600000000000001,32.300423426884834,-0.0463312154102255,12.455781113808381,7.974218886191618,10.582645121459688,13.953488372093013,1.1968873949996417,3705910.0,-13.684210526315796,-0.15463917525773196,14.59618774389807,14.59618774389807,9.675,11.1,6.935465625351266,6.6,11.6,1,,1.4658849865911034,664.093411708597
2011-08-27,8.6,8.2,9.1,8.1,22000.0,29.6,0.1,8.833333333333334,35.7250575395841,-0.11691790450210848,12.363291271926407,8.136708728073593,10.393821776558767,23.255813953488367,1.1828240096425244,3727910.0,-14.85148514851485,0.04878048780487809,13.753767553982843,13.753767553982843,9.55,10.8,7.03475631284424,6.6,11.6,0,,1.4681915408898996,675.796373160319
2011-08-28,9.1,8.6,9.5,8.4,24160.0,29.6,0.1,8.633333333333333,39.82289045023092,-0.11871341591618345,12.189326545722578,8.440673454277425,10.270600654981742,34.88372093023255,1.1769080089537727,3752070.0,-15.74074074074075,0.058139534883721034,12.933055043448052,12.933055043448052,9.299999999999999,10.7,7.1320611865873556,6.6,11.6,0,,1.470617208187872,688.1996455362373
2011-08-29,9.0,9.1,9.3,8.6,21650.0,29.6,0.1,8.9,39.28345815866442,-0.11531785259558702,12.22180862630977,8.308191373690232,10.149591068793004,33.33333333333333,1.1428431511713604,3730420.0,-18.918918918918916,-0.01098901098901095,12.698257235237337,12.698257235237337,9.225000000000001,10.7,7.227419962855609,6.6,11.6,0,,1.4729868577359977,700.5967369488792
2011-08-30,8.8,9.0,9.0,8.6,11770.0,29.6,0.1,8.966666666666667,38.16983283389741,-0.1149655589085945,12.261672069144796,8.148327930855205,10.021058586050813,28.57142857142859,1.089782926087692,3718650.0,-19.999999999999993,-0.022222222222222143,12.383896887360134,12.383896887360134,9.225000000000001,10.7,7.320871563598496,6.6,11.6,0,,1.4752717251569012,712.8555746965997
2011-08-31,8.2,8.8,8.8,8.0,19650.0,29.6,0.1,8.666666666666666,34.967274105962005,-0.1418042312503962,12.357566233509235,7.922433766490765,9.847624434998355,14.285714285714274,1.0690841456528568,3699000.0,-24.77064220183487,-0.06818181818181834,13.037611532351914,13.037611532351914,9.175,10.45,7.412454132326526,6.6,11.6,0,,1.4773493447134025,724.426816748395
2011-09-01,8.2,8.2,8.4,8.1,11900.0,29.6,0.1,8.4,34.967274105962005,-0.14566494795186813,12.435402508048222,7.714597491951777,9.69070782214137,14.285714285714274,1.0141495638205098,3710900.0,-24.074074074074087,0.0,12.367677607567193,12.367677607567193,9.2,10.3,7.502205049679995,6.6,11.6,0,,1.479402228708359,736.0772866275876
2011-09-02,8.6,8.2,8.7,8.2,16820.0,29.6,0.1,8.333333333333334,38.929047626163914,-0.1090620766574999,12.446221576227376,7.553778423772624,9.586830886699335,24.390243902439025,0.9774245949761876,3727720.0,-25.862068965517242,0.04878048780487809,11.365402267164972,11.365402267164972,9.425,10.3,7.590160948686395,6.6,11.6,0,,1.4815520195935,748.3525648087915
2011-09-03,8.5,8.6,8.7,8.4,6950.0,29.6,0.1,8.433333333333334,38.300857827058024,-0.08067645268907042,12.385619923139132,7.384380076860869,9.483323183204162,23.076923076923084,0.9290371239064598,3720770.0,-25.438596491228072,-0.011627906976744096,10.929848516546585,10.929848516546585,9.3,10.3,7.6763577297126675,6.6,11.6,0,,1.4836469443012923,760.5824508538658
2011-09-04,8.2,8.5,8.5,7.8,19670.0,29.6,0.1,8.433333333333334,36.40301437436304,-0.07150891627213674,12.27803073267452,7.20196926732548,9.361101927660908,15.384615384615374,0.9126773293417126,3701100.0,-27.43362831858408,-0.03529411764705892,11.13021133343552,11.13021133343552,9.2,10.3,7.760830575118415,6.6,11.6,0,,1.4856260954205902,772.4742270921604
2011-09-05,7.6,8.2,8.2,7.3,30800.0,29.6,0.1,8.100000000000001,32.89255337780895,-0.09384979808421412,12.201425469208727,6.938574530791273,9.193377934550345,7.499999999999994,0.9117718058173045,3670300.0,-30.27522935779817,-0.07317073170731703,11.996997444964535,11.996997444964535,9.0,10.3,11.9,6.6,11.6,0,,1.4873893079329072,783.5320155943954
2011-09-06,6.9,7.6,7.7,6.1,82500.0,29.6,0.1,7.566666666666667,29.33797268345873,-0.14093626378965907,12.169357069042888,6.570642930957114,8.974960988402692,16.000000000000014,0.9609309625446399,3587800.0,-36.69724770642201,-0.09210526315789469,13.926535689052752,13.926535689052752,8.35,10.3,11.808,6.9,11.6,1,,1.4888866410194652,793.4746776254113
2011-09-07,7.2,6.9,7.6,6.5,49640.0,29.6,0.1,7.233333333333334,32.694934776563,-0.136925545667555,12.060470344734535,6.319529655265468,8.805917084745293,22.916666666666675,0.9708644652200228,3637440.0,-33.94495412844037,0.04347826086956519,13.484228683611427,13.484228683611427,8.275,10.3,11.57968,6.9,11.6,0,,1.4904710648994746,803.9646918785941
2011-09-08,6.5,7.2,7.2,6.5,31890.0,29.6,0.1,6.866666666666667,29.208144823898948,-0.16460393391254702,11.809908694202374,6.0600913057976245,8.586305933817169,10.526315789473692,0.9515170034185927,3605550.0,-32.98969072164948,-0.09722222222222221,14.638723129516812,14.638723129516812,8.225,10.3,11.3604928,6.9,11.6,0,,1.4917780712595663,813.2298252964866
2011-09-09,5.0,6.5,6.6,4.2,217430.0,29.6,0.1,6.233333333333334,23.439523919364632,-0.26137245865304815,11.735432662308291,5.494567337691708,8.244752987739343,15.094339622641508,1.054980074602979,3388120.0,-39.02439024390244,-0.23076923076923073,21.099601492059577,21.099601492059577,7.25,9.55,11.150073088,6.9,11.6,1,,1.492409437600381,819.2509530600686
2011-09-10,4.8,5.0,5.5,4.6,44490.0,29.6,0.1,5.4333333333333345,22.793132675795917,-0.31281389281481564,11.573839216526967,5.006160783473036,7.91668127462131,11.320754716981126,1.0439100692741947,3343630.0,-44.18604651162791,-0.040000000000000036,21.74812644321239,21.74812644321239,7.225,9.55,10.733068702719999,6.9,11.6,0,,1.4929253033498744,824.7365517704574
2011-09-11,5.9,4.8,7.4,4.6,143790.0,29.6,0.1,5.233333333333334,33.63347783954518,-0.24947261065136983,11.251479409867116,4.828520590132882,7.724616391324043,33.333333333333336,1.169345064326038,3487420.0,-35.164835164835154,0.22916666666666674,19.819407869932846,19.819407869932846,7.225,9.55,10.3410845805568,6.9,11.6,1,,1.4939428136970538,832.7744229352057
2011-09-12,6.1,5.9,6.6,5.4,63860.0,29.6,0.1,5.600000000000001,35.40921918960045,-0.17437549917664108,10.833150177620695,4.766849822379305,7.5698910207217525,39.58333333333332,1.1715347025884637,3551280.0,-32.22222222222222,0.03389830508474567,19.205486927679736,19.205486927679736,7.175,9.55,9.972619505723392,6.9,11.6,0,,1.495026984593456,841.2265231782915
2011-09-13,5.8,6.1,6.1,5.7,23760.0,29.6,0.1,5.933333333333334,33.94216508119756,-0.1273581711871281,10.341050786377185,4.748949213622816,7.401329971129204,34.782608695652165,1.116425080975002,3527520.0,-34.0909090909091,-0.0491803278688524,19.24870829267245,19.24870829267245,7.1,9.55,9.62626233537999,6.9,11.6,0,,1.4959694274886426,849.0336356633084
2011-09-14,5.6,5.8,5.8,5.3,43770.0,29.6,0.1,5.833333333333333,32.96169851509403,-0.09373339210019394,10.074520067580503,4.605479932419495,7.2297747357835656,31.111111111111104,1.072394718048216,3483750.0,-31.70731707317073,-0.034482758620689724,19.14990567943243,19.14990567943243,6.949999999999999,9.55,9.30068659525719,6.9,11.6,0,,1.4968094814117419,856.3792292080219
2011-09-15,4.8,5.6,5.6,4.4,86220.0,29.6,0.1,5.400000000000001,29.314044300141177,-0.1083424306203451,10.086230443569317,4.253769556430684,6.998367618089893,13.333333333333329,1.081509381044772,3397530.0,-41.46341463414634,-0.1428571428571428,22.53144543843275,22.53144543843275,6.875,9.55,8.994645399541758,6.9,11.6,0,,1.4972543017205913,861.7209114110583
2011-09-16,4.8,4.8,5.0,4.6,31650.0,29.6,0.1,5.066666666666666,29.314044300141177,-0.10111659626383362,9.992374478712849,3.9676255212871534,6.788999273509903,13.333333333333329,1.032830139541574,3429180.0,-44.18604651162791,0.0,21.51729457378279,21.51729457378279,6.825,9.55,8.706966675569253,6.9,11.6,0,,1.4976872501500829,867.0282177892105
2011-09-17,4.8,4.8,4.9,4.7,20300.0,29.6,0.1,4.8,29.314044300141177,-0.08035341160043674,9.755167219404377,3.77483278059562,6.599570771270865,13.953488372093016,0.9733422724314617,3449480.0,-43.529411764705884,0.0,20.277964008988786,20.277964008988786,6.775,9.55,8.436548675035098,6.9,11.6,0,,1.4981084584885012,872.3007563040682
2011-09-18,5.2,4.8,5.6,4.7,44620.0,29.6,0.1,4.933333333333334,33.88323938412293,-0.02648351127040538,9.453801834097048,3.696198165902952,6.466278316864116,25.000000000000007,0.9681035386863572,3494100.0,-36.58536585365853,0.08333333333333348,18.61737574396841,18.61737574396841,6.775,9.55,8.182355754532992,6.9,11.6,0,,1.4987141787317355,878.5815666075124
2011-09-19,5.5,5.2,5.6,4.9,49840.0,29.6,0.1,5.166666666666667,37.16390309164415,0.03899168276220033,9.133894271075977,3.68610572892402,6.374251810496105,37.14285714285713,0.948953285923046,3543940.0,-27.631578947368418,0.05769230769230771,17.253696107691745,17.253696107691745,6.7250000000000005,9.55,7.943414409261012,6.9,11.6,0,,1.4994441123511266,885.5693720254254
2011-09-20,6.1,5.5,6.8,5.4,116750.0,29.6,0.1,5.6000000000000005,43.230938639793706,0.12736496140493792,8.903826658321124,3.7061733416788747,6.348132590448857,55.882352941176464,0.981170908357114,3660690.0,-11.594202898550735,0.10909090909090913,16.084768989460883,16.084768989460883,6.325,9.55,7.718809544705351,6.9,6.1,1,,1.5004127959281202,893.9017107355687
2011-09-21,5.6,6.1,6.3,5.1,68160.0,29.6,0.1,5.733333333333334,39.78366641076962,0.15496792186556485,8.638229587350832,3.711770412649167,6.2768818675489655,43.74999999999998,0.9968015577601772,3592530.0,-22.22222222222223,-0.08196721311475408,17.80002781714602,17.80002781714602,6.225,8.9,7.507680972023031,6.9,6.1,0,,1.501158056283691,901.0871121201177
2011-09-22,5.4,5.6,5.8,5.3,31650.0,29.6,0.1,5.7,38.46248360086753,0.16182632731185254,8.230648889152016,3.799351110847983,6.193369308734778,37.5,0.9613157322058788,3560880.0,-16.92307692307692,-0.03571428571428559,17.802143188997753,17.802143188997753,6.225,8.65,7.309220113701649,6.9,6.1,0,,1.501801318614711,907.7640221695432
2011-09-23,5.6,5.4,5.7,5.4,55670.0,29.6,0.1,5.533333333333334,40.587303178223785,0.18048114921051805,7.773785702226114,3.9662142977738863,6.136857945998132,39.99999999999998,0.9140788941911732,3616550.0,11.999999999999993,0.03703703703703698,16.322837396270952,16.322837396270952,6.175,8.2,7.12266690687955,6.9,6.1,0,,1.502519656687748,914.9026570931492
2011-09-24,5.5,5.6,5.6,5.3,17940.0,29.6,0.1,5.500000000000001,39.84645959736016,0.1859951676254774,7.313955350857201,4.1560446491428,6.076204808284024,36.66666666666666,0.8702161160346608,3598610.0,14.583333333333337,-0.017857142857142794,15.822111200630196,15.822111200630196,6.1499999999999995,8.15,6.947306892466777,6.9,6.1,0,,1.5031810208636003,921.7741062999243
2011-09-25,5.3,5.5,5.5,5.3,9490.0,29.6,0.1,5.466666666666666,38.33917998311602,0.17617804404798476,6.955065541462513,4.284934458537485,6.002280540828403,37.499999999999986,0.8223435363178994,3589120.0,-10.169491525423737,-0.036363636363636376,15.515915779583006,15.515915779583006,6.125,8.15,6.78246847891877,6.9,6.1,0,,1.5037401289158798,928.1158199728745
2011-09-26,4.9,5.3,5.4,4.7,56070.0,29.6,0.1,5.233333333333334,35.450858556352514,0.14410120936008664,6.752233744060193,4.2877662559398075,5.897301441701889,20.83333333333334,0.8136047122951923,3533050.0,-19.672131147540973,-0.07547169811320742,16.604177801942697,16.604177801942697,6.1,8.15,6.627520370183644,6.9,6.1,0,,1.5040983697810433,933.3560041301589
2011-09-27,4.9,4.9,5.1,4.8,24650.0,29.6,0.1,5.033333333333334,35.450858556352514,0.12495256939150479,6.393888264669274,4.416111735330725,5.802320352015995,20.83333333333334,0.7769186614169643,3557700.0,-15.517241379310336,0.0,15.855482886060496,15.855482886060496,6.1,8.15,6.481869147972626,6.9,6.1,0,,1.5044458295053413,938.5583671412033
2011-09-28,4.8,4.9,5.0,4.6,30630.0,29.6,0.1,4.866666666666667,34.693058443812305,0.10824431619830421,6.2045337755001855,4.435466224499813,5.706861270871615,16.666666666666647,0.7499958998871812,3527070.0,-14.285714285714283,-0.020408163265306256,15.624914580982944,15.624914580982944,6.074999999999999,8.15,6.3449569990942685,4.8,6.1,0,,1.5047332954442558,943.4394734175643
2011-09-29,4.8,4.8,4.8,4.7,14090.0,29.6,0.1,4.833333333333334,34.693058443812305,0.10007658008880638,6.213105752390391,4.40689424760961,5.620493530788604,9.090909090909099,0.703567621323811,3541160.0,0.0,0.0,14.657658777579396,14.657658777579396,5.8999999999999995,8.15,6.216259579148613,4.8,6.1,0,,1.5050105599317314,948.280908725285
2011-09-30,5.1,4.8,5.3,4.7,41460.0,29.6,0.1,4.9,39.21393413664797,0.11660724522933252,6.203350727215851,4.44664927278415,5.570922718332547,22.727272727272727,0.6961699340863959,3582620.0,6.2499999999999964,0.0625,13.650390864439139,13.650390864439139,5.699999999999999,8.05,6.095284004399696,4.8,6.1,0,,1.5054220953331048,953.9202477570558
2011-10-01,5.0,5.1,5.3,4.9,23460.0,29.6,0.1,4.966666666666668,38.26309564954203,0.12195898797736837,6.127584804017046,4.432415195982952,5.5165491261104,18.181818181818198,0.6750149387945105,3559160.0,4.1666666666666705,-0.019607843137254832,13.50029877589021,13.50029877589021,5.550000000000001,8.05,5.981566964135714,4.8,6.1,0,,1.505775602385596,959.2484586378519
2011-10-02,5.0,5.0,5.1,4.9,10460.0,29.6,0.1,5.033333333333334,38.26309564954203,0.12612724872171965,5.991485485838199,4.4585145141618,5.467353971242743,18.181818181818198,0.6410853003091883,3569620.0,-3.8461538461538494,0.0,12.821706006183767,12.821706006183767,5.5,8.05,5.874672946287571,4.8,6.1,0,,1.5061185701071784,964.538584952653
2011-10-03,5.0,5.0,5.0,4.9,17290.0,29.6,0.1,5.0,38.26309564954203,0.12904774924531826,5.909637840580123,4.460362159419878,5.422844069219625,18.181818181818198,0.6024363502871034,3586910.0,-9.090909090909092,0.0,12.04872700574207,12.04872700574207,5.425000000000001,8.05,5.774192569510317,4.8,6.1,0,,1.5064511124121258,969.790302998981
2011-10-04,5.0,5.0,5.0,4.9,15790.0,29.6,0.1,5.0,38.26309564954203,0.13073895444813044,5.857780193233008,4.4522198067669905,5.382573205484423,23.529411764705902,0.5665480395523103,3602700.0,-18.032786885245898,0.0,11.330960791046204,11.330960791046204,5.4,8.05,5.679741015339698,4.8,6.1,0,,1.5067733418855531,975.0032989104277
2011-10-05,4.9,5.0,5.0,4.8,17590.0,29.6,0.1,4.966666666666668,37.0545943169282,0.12489125848324123,5.8539740629163495,4.466025937083651,5.336613852581145,25.000000000000057,0.5403660367271452,3585110.0,-12.499999999999988,-0.019999999999999907,11.027878300553983,11.027878300553983,5.425,8.05,5.590956554419316,4.8,6.1,0,,1.5070378208835102,979.8931006912268
2011-10-06,4.7,4.9,4.9,4.5,54770.0,29.6,0.1,4.866666666666667,34.694433938187274,0.10795845238180801,5.860620294493168,4.449379705506831,5.275983961859131,16.66666666666668,0.5303398912466349,3530340.0,-12.962962962962965,-0.04081632653061229,11.283827473332659,11.283827473332659,5.4,8.0,5.507499161154157,4.8,6.1,0,,1.5071946824302955,984.1547910116722
2011-10-07,4.3,4.7,4.8,3.8,97550.0,29.6,0.1,4.633333333333334,30.508986330994134,0.0719557677627709,5.915111457056021,4.3448885429439805,5.183033108348738,27.777777777777782,0.5638870418718753,3432790.0,-23.21428571428571,-0.08510638297872353,13.11365213655524,13.11365213655524,4.925,7.800000000000001,5.429049211484908,4.8,6.1,1,,1.5071341795113762,987.1179614302066
2011-10-08,4.0,4.3,4.3,3.8,39610.0,29.6,0.1,4.333333333333334,27.800193057008272,0.032105537585065735,5.995418824101083,4.144581175898917,5.070363288506002,11.764705882352951,0.5593236817381699,3393180.0,-27.27272727272727,-0.06976744186046513,13.98309204345425,13.98309204345425,4.925,7.800000000000001,5.298725274566115,4.8,6.1,0,,1.5068971827176902,989.016119232546
2011-10-09,4.1,4.0,4.4,4.0,37920.0,29.6,0.1,4.133333333333334,30.03027927225635,0.017386645818455504,5.993981891183454,4.006018108816546,4.977947737219715,18.749999999999982,0.5479434187568721,3431100.0,-22.641509433962266,0.02499999999999991,13.364473628216395,13.364473628216395,4.925,7.800000000000001,5.178827252600826,4.8,6.1,0,,1.5067115532221351,991.2203370994062
2011-10-10,4.1,4.1,4.2,4.0,16860.0,29.6,0.1,4.066666666666667,30.03027927225635,0.012769784656666006,5.8316651759085145,3.968334824091486,4.894333667008313,19.99999999999999,0.5230903174170956,3447960.0,-16.32653061224491,0.0,12.758300424807208,12.758300424807208,4.875,7.75,5.06852107239276,4.8,6.1,0,,1.5065193913869366,993.381577121784
2011-10-11,3.9,4.1,4.1,3.8,41100.0,29.6,0.1,4.033333333333334,28.02260400445047,0.0019340663743987463,5.785103087306007,3.8448969126939914,4.799635222531331,6.666666666666672,0.5071552947444459,3406860.0,-20.408163265306133,-0.04878048780487798,13.003981916524253,13.003981916524253,4.85,7.65,4.967039386601339,4.8,6.1,0,,1.5062046870670514,994.7939781882659
2011-10-12,4.2,3.9,4.4,3.9,69400.0,29.6,0.1,4.066666666666667,35.038251305302424,0.019672938966173392,5.721385016440474,3.7886149835595284,4.742527106099776,26.66666666666669,0.5066442022626998,3476260.0,-12.499999999999993,0.0769230769230771,12.062957196730947,12.062957196730947,4.85,7.65,4.873676235673232,4.8,4.2,1,,1.5060560259680997,997.2114111711517
2011-10-13,4.1,4.2,4.2,4.0,19710.0,29.6,0.1,4.066666666666667,33.853733438582935,0.028820006388226682,5.604337600663663,3.755662399336337,4.681334048375987,19.99999999999999,0.48474104495822123,3456550.0,-14.583333333333337,-0.023809523809523947,11.822952316054177,11.822952316054177,4.85,7.550000000000001,4.787782136819374,4.8,4.2,0,,1.5058449993963847,999.2454868185026
2011-10-14,4.0,4.1,4.1,4.0,20060.0,29.6,0.1,4.1000000000000005,32.66451907949566,0.032036705767501616,5.49376318555657,3.7162368144434295,4.6164450913877975,13.333333333333345,0.45725954174691974,3436490.0,-21.568627450980387,-0.024390243902438935,11.431488543672993,11.431488543672993,4.824999999999999,7.449999999999999,4.708759565873824,4.8,4.2,0,,1.5055708169265885,1000.8886191034161
2011-10-15,3.8,4.0,4.1,3.7,42090.0,29.6,0.1,3.9666666666666672,30.366945821208347,0.024912956136509234,5.424650769854174,3.635349230145825,4.53868841601753,7.14285714285712,0.4531695744792826,3394400.0,-24.000000000000004,-0.050000000000000044,11.925515117875857,11.925515117875857,4.75,7.300000000000001,4.636058800603918,4.8,4.2,0,,1.5051728788272323,1001.7668724680618
2011-10-16,3.6,3.8,3.9,3.4,36200.0,29.6,0.1,3.8000000000000007,28.228649521540305,0.011624670454356445,5.428898334888421,3.5011016651115785,4.449289519253956,12.50000000000001,0.45651460487361956,3358200.0,-27.999999999999996,-0.05263157894736836,12.680961246489431,12.680961246489431,4.375,6.65,4.542452920543526,4.8,4.2,0,,1.5046459507287087,1001.845342778512
2011-10-17,2.6,3.6,3.7,2.3,207430.0,29.6,0.1,3.333333333333334,20.46801561194863,-0.055911459133972,5.588547536431556,3.111452463568443,4.273166707896436,11.111111111111121,0.5239064188112181,3150770.0,-48.0,-0.2777777777777778,20.150246877354544,20.150246877354544,3.7,5.9,4.4053585700783024,4.8,4.2,1,,1.50336985323785,997.327575821031
2011-10-18,2.4,2.6,2.9,2.3,87860.0,29.6,0.1,2.866666666666667,19.323783983137417,-0.10272716623690514,5.712025640804061,2.74797435919594,4.094769878572966,3.703703703703707,0.5293416746104168,3062910.0,-52.0,-0.07692307692307698,22.055903108767367,22.055903108767367,3.675,5.9,4.11060837026734,4.8,4.2,0,,1.5019119284018392,991.712075203731
2011-10-19,2.3,2.4,2.5,2.0,101870.0,29.6,0.1,2.433333333333334,18.75910072507483,-0.1274856548484683,5.782468330550742,2.4275316694492575,3.9238394139469692,10.34482758620689,0.5272458407096727,2961040.0,-53.06122448979592,-0.04166666666666674,22.92373220476838,22.92373220476838,3.5,5.65,3.8571231984299126,2.3,4.2,1,,1.5003592684978695,985.5424465630047
2011-10-20,2.3,2.3,2.4,2.2,48860.0,29.6,0.1,2.333333333333334,18.75910072507483,-0.13044889336763088,5.750805140546051,2.1791948594539488,3.769188041190115,10.714285714285708,0.5038711378018389,3009900.0,-51.06382978723405,0.0,21.907440773993,21.907440773993,3.475,5.5,3.5599834866811264,2.3,4.2,0,,1.4988095406696231,979.4152064601021
2011-10-21,2.6,2.3,2.7,2.3,72970.0,29.6,0.1,2.4000000000000004,26.256758023926025,-0.1001533349529623,5.65880814862011,2.031191851379891,3.657836799172009,25.0,0.4964517708159933,3082870.0,-39.53488372093023,0.1304347826086958,19.0942988775382,19.0942988775382,3.4000000000000004,5.4,3.310386128812146,2.3,4.2,0,,1.4975409678476346,974.9924706033672
2011-10-22,3.2,2.6,3.3,2.5,120160.0,29.6,0.1,2.7000000000000006,38.48459007965373,-0.031226381328676722,5.508254117348855,2.0017458826511443,3.614233294488961,50.0,0.5181337871862794,3203030.0,-19.999999999999996,0.23076923076923084,16.191680849571235,16.191680849571235,3.3499999999999996,5.35,2.0,2.3,4.2,1,,1.4967436232929834,973.3877699224819
2011-10-23,3.2,3.2,3.2,3.0,37040.0,29.6,0.1,3.0000000000000004,38.48459007965372,0.02008129054202412,5.336257011952596,1.9937429880474038,3.574782504537631,50.0,0.49540994524440235,3240070.0,-21.95121951219511,0.0,15.481560788887572,15.481560788887572,3.3499999999999996,5.35,2.026,2.3,4.2,0,,1.4959442519323658,971.7634527704909
2011-10-24,2.5,3.2,3.2,2.5,92230.0,29.6,0.1,2.9666666666666672,31.432440741104003,0.012937771014881028,5.166530048908021,1.9134699510919797,3.4724222660102377,20.83333333333333,0.510023520584088,3147840.0,-39.02439024390244,-0.21875,20.400940823363516,20.400940823363516,3.3,5.35,2.0514799999999997,2.3,4.2,0,,1.4945864213849798,966.8109624191961
2011-10-25,2.8,2.5,3.0,2.4,101410.0,29.6,0.1,2.833333333333334,36.77933497491263,0.03332082822552118,4.96506535808139,1.904934641918609,3.408382050199739,33.33333333333332,0.5164504119709389,3249250.0,-28.20512820512821,0.11999999999999988,18.444657570390678,18.444657570390678,3.25,5.25,2.0764503999999997,2.3,4.2,0,,1.493485211583133,963.3886772696748
2011-10-26,2.8,2.8,2.8,2.7,29400.0,29.6,0.1,2.7000000000000006,36.77933497491263,0.05066725286367124,4.777219537857992,1.9027804621420084,3.350440902561669,36.36363636363635,0.48670395397301464,3278650.0,-33.33333333333334,0.0,17.38228407046481,17.38228407046481,3.15,5.1,2.1009213919999996,2.3,4.2,0,,1.4923840522577796,959.967626489427
2011-10-27,3.0,2.8,3.1,2.7,58700.0,29.6,0.1,2.866666666666667,40.37429868629493,0.07784909863691936,4.648863166403679,1.9011368335963212,3.3170655785081764,47.61904761904763,0.48051081440351356,3337350.0,-26.829268292682922,0.0714285714285714,16.017027146783786,16.017027146783786,3.0999999999999996,4.85,2.1249029641599995,2.3,4.2,0,,1.4914374566170958,957.4567809000716
2011-10-28,3.2,3.0,3.3,2.9,52370.0,29.6,0.1,3.0000000000000004,43.81495182066019,0.10959324471952436,4.568079142437067,1.9019208575629338,3.3059164757931123,57.14285714285716,0.4747600419461197,3389720.0,-19.999999999999996,0.06666666666666665,14.83625131081624,14.83625131081624,3.125,4.8,2.1484049048767995,2.3,4.2,0,,1.4906341383594126,955.7837146231301
2011-10-29,3.6,3.2,3.8,3.1,79540.0,29.6,0.1,3.2666666666666675,50.02601634705464,0.155046619247608,4.495145906113677,1.9248540938863221,3.333924430479483,84.21052631578948,0.4908486103785397,3469260.0,-5.263157894736835,0.125,13.634683621626104,13.634683621626104,3.275,4.7,2.1714368067792633,2.3,4.2,0,,1.4900915680807272,955.6351814725892
2011-10-30,3.3,3.6,3.7,3.2,50690.0,29.6,0.1,3.366666666666667,45.9254430002171,0.16168418429218867,4.390000000000306,1.9499999999996933,3.3306935323385796,72.22222222222221,0.49150228106578686,3418570.0,-8.333333333333341,-0.08333333333333337,14.894008517145057,14.894008517145057,3.3,4.7,2.2365793345080927,2.3,4.2,0,,1.4893519211242872,954.3201155242929
2011-10-31,3.3,3.3,3.3,3.1,30980.0,29.6,0.1,3.4000000000000004,45.9254430002171,0.16242158799595818,4.315414820393528,1.9645851796064717,3.3277703387825244,72.22222222222221,0.4706806895610877,3449550.0,26.92307692307691,0.0,14.263051198820841,14.263051198820841,3.275,4.7,2.299116161127769,2.3,4.2,0,,1.4886100655534333,952.9844797185851
2011-11-01,3.2,3.3,3.3,3.1,37890.0,29.6,0.1,3.2666666666666675,44.514850107902184,0.15267027092045526,4.161260939267717,2.0187390607322824,3.3156017350889506,66.66666666666669,0.4513463545924386,3411660.0,33.33333333333335,-0.030303030303030165,14.104573581013705,14.104573581013705,3.25,4.7,2.3591515146826585,2.3,4.2,0,,1.4877978861605345,951.2293749538757
2011-11-02,3.3,3.2,3.4,3.1,32310.000000000004,29.6,0.1,3.266666666666667,46.291397797170745,0.14927157334926255,4.022625313263414,2.0773746867365857,3.314115855556669,68.75,0.44053590069297865,3443970.0,43.47826086956522,0.031249999999999778,13.349572748272081,13.349572748272081,3.15,4.4,2.416785454095352,2.3,3.3,0,,1.4870520197315806,949.8557625591872
2011-11-03,3.2,3.3,3.3,3.1,24520.0,29.6,0.1,3.2333333333333343,44.748410319393855,0.13692898708171386,3.8838420909985722,2.136157909001428,3.3032476788369864,60.00000000000002,0.42335476492919444,3419450.0,39.13043478260872,-0.030303030303030165,13.229836404037327,13.229836404037327,3.225,4.4,2.4721140359315377,2.3,3.3,0,,1.486236198407192,948.0661273402466
2011-11-04,3.1,3.2,3.2,3.0,39510.0,29.6,0.1,3.2000000000000006,43.19778018264607,0.11931547455906255,3.7721825386953474,2.177817461304653,3.2838907570429874,50.000000000000014,0.4074008531485377,3379940.0,19.23076923076923,-0.03125,13.141963004791538,13.141963004791538,3.225,4.4,2.5252294744942763,2.3,3.3,0,,1.4853488944590567,945.8535405788157
2011-11-05,3.0,3.1,3.2,2.8,52960.0,29.6,0.1,3.100000000000001,41.643730430144245,0.09904963290435165,3.689244583454096,2.2007554165459045,3.256853542086512,42.85714285714287,0.40687222078078505,3326980.0,-6.250000000000005,-0.032258064516129115,13.562407359359502,13.562407359359502,3.25,4.4,2.576220295514505,2.3,3.3,0,,1.4843884562043999,943.2109867220765
2011-11-06,3.0,3.0,3.0,2.9,17230.0,29.6,0.1,3.0333333333333337,41.643730430144245,0.08433974387377152,3.6923926037572556,2.237607396242745,3.2323912999830346,42.85714285714287,0.3849527764393005,3344210.0,-6.250000000000005,0.0,12.831759214643348,12.831759214643348,3.25,4.4,2.625171483693925,2.3,3.3,0,,1.4834273688648718,940.5620927066318
2011-11-07,3.0,3.0,3.0,3.0,23990.0,29.6,0.1,3.0,41.64373043014424,0.07369110766476594,3.674632253502405,2.315367746497595,3.2102587952227455,42.85714285714287,0.357456149550779,3368200.0,20.0,0.0,11.915204985025966,11.915204985025966,3.175,4.4,2.6721646243461676,2.3,3.3,0,,1.4824656568803354,937.9071287517359
2011-11-08,3.0,3.0,3.2,3.0,60340.0,29.6,0.1,3.0,41.643730430144245,0.06597824821034753,3.630333240792775,2.4296667592072256,3.1902341480586744,27.272727272727266,0.34620928172572335,3428540.0,7.1428571428571495,0.0,11.540309390857445,11.540309390857445,3.0749999999999997,4.4,2.717278039372321,2.3,3.3,0,,1.4815033443535417,935.2463611277009
2011-11-09,3.0,3.0,3.1,2.9,52200.0,29.6,0.1,3.0,41.643730430144245,0.06035941981405546,3.5640991885394664,2.5659008114605344,3.1721166101483242,27.272727272727266,0.3357657616024574,3480740.0,7.1428571428571495,0.0,11.192192053415246,11.192192053415246,3.0749999999999997,4.4,2.760586917797428,2.3,3.3,0,,1.4805404550547898,932.5800521918454
2011-11-10,2.8,3.0,3.0,2.8,33930.0,29.6,0.1,2.9333333333333336,37.71320719461955,0.04344653369533652,3.543508271005703,2.6064917289942975,3.136676932991341,0.0,0.3260682072022819,3446810.0,-6.666666666666672,-0.06666666666666676,11.645293114367213,11.645293114367213,3.025,4.4,3.8,2.3,3.3,0,,1.4794271545005961,929.0482258070994
2011-11-11,3.1,2.8,3.1,2.8,44850.0,29.6,0.1,2.9666666666666672,45.9535265835663,0.0521511609062314,3.5351881339853297,2.60481186601467,3.1331838917540704,30.00000000000003,0.32420619240211895,3491660.0,-3.1250000000000027,0.1071428571428572,10.458264271036095,10.458264271036095,2.9749999999999996,4.15,3.78,2.3,3.3,0,,1.4785348850728446,926.7842492623702
2011-11-12,3.0,3.1,3.1,3.0,20380.0,29.6,0.1,2.9666666666666672,43.870091172797146,0.05081010966444674,3.5221688003324694,2.5978311996675307,3.120499711587016,22.222222222222232,0.3081914643733961,3471280.0,-16.666666666666668,-0.032258064516129115,10.273048812446538,10.273048812446538,2.95,3.9,3.7603999999999997,2.3,3.3,0,,1.477570735250548,924.1058836802819
2011-11-13,3.0,3.0,3.0,3.0,9630.0,29.6,0.1,3.0333333333333337,43.870091172797146,0.0495088817717442,3.471134691527131,2.698865308472869,3.1090235485787288,33.33333333333336,0.28617778834672497,3480910.0,-9.090909090909086,0.0,9.5392596115575,9.5392596115575,2.95,3.85,3.741192,2.3,3.3,0,,1.4766060987577267,921.4229715254768
2011-11-14,2.2,3.0,3.0,2.1,382190.0,29.6,0.1,2.7333333333333343,30.880302299818112,-0.0028661449112538373,3.5896961754124987,2.5203038245875007,3.0224498772855166,7.6923076923077005,0.3300222320362446,3098720.0,-33.33333333333333,-0.2666666666666666,15.001010547102025,15.001010547102025,2.8000000000000003,3.8,3.72236816,2.3,3.3,1,,1.4749730435010584,914.9485353144563
2011-11-15,2.3,2.2,2.5,2.1,76420.0,29.6,0.1,2.5000000000000004,33.52975124960645,-0.0270652238078381,3.6500000000006096,2.409999999999391,2.9536451270678485,15.384615384615365,0.3350206440336557,3175140.0,-28.12500000000001,0.04545454545454519,14.566114957985032,14.566114957985032,2.8000000000000003,3.75,3.6574734336,2.3,3.3,0,,1.4734392919953452,909.0660573974942
2011-11-16,2.6,2.3,2.6,2.3,44210.0,29.6,0.1,2.3666666666666676,40.85432950493221,-0.019510388904552423,3.65776538962865,2.3622346103713503,2.9199646387756726,41.66666666666668,0.3325191694598231,3219350.0,-21.212121212121204,0.1304347826086958,12.789198825377813,12.789198825377813,2.8000000000000003,3.7,3.595174496256,2.3,3.3,0,,1.4721716231909892,904.6985061491197
2011-11-17,2.3,2.6,2.6,2.0,117280.0,29.6,0.1,2.400000000000001,36.52045632952945,-0.030694983104187973,3.6757038764497905,2.2542961235502093,2.860920387463704,24.999999999999982,0.3516249430698357,3102070.0,-28.12500000000001,-0.11538461538461553,15.288041003036337,15.288041003036337,2.7249999999999996,3.65,3.53536751640576,2.3,3.3,0,,1.470643091676651,898.8889439072838
2011-11-18,2.0,2.3,2.4,2.0,98140.0,29.6,0.1,2.3000000000000007,32.77607756995354,-0.052968813437401674,3.6499182962910246,2.120081703708976,2.7789279696100175,0.0,0.3550803042791331,3003930.0,-35.483870967741936,-0.13043478260869557,17.754015213956656,17.754015213956656,2.7249999999999996,3.65,3.4432454654214144,2.0,3.3,0,,1.4688192593146656,891.4739283756197
2011-11-19,2.2,2.0,2.3,2.0,78300.0,29.6,0.1,2.1666666666666674,37.38515804035262,-0.048995972603966376,3.625235814083324,2.0347641859166763,2.723791972504302,16.66666666666668,0.3511459968306236,3082230.0,-26.66666666666666,0.10000000000000009,15.961181674119251,15.961181674119251,2.7249999999999996,3.65,3.3566507374961296,2.0,3.3,0,,1.4672035479124097,885.2485685965898
2011-11-20,2.2,2.2,2.5,2.2,79730.0,29.6,0.1,2.133333333333334,37.38515804035262,-0.04143235067819262,3.584629544915926,1.965370455084074,2.6739070227419877,16.66666666666668,0.3474927113427219,3161960.0,-26.66666666666666,0.0,15.795123242850995,15.795123242850995,2.7249999999999996,3.65,3.275251693246362,2.0,3.3,0,,1.4655915646222757,879.0758202454726
2011-11-21,2.3,2.2,2.3,2.2,41730.0,29.6,0.1,2.233333333333334,39.77943633505241,-0.02553839519850809,3.5401851640216404,1.9198148359783596,2.6382968300998937,24.999999999999982,0.3298146605325275,3203690.0,-23.33333333333334,0.04545454545454519,14.339767849240328,14.339767849240328,2.7,3.65,3.1987365916515804,2.0,3.3,0,,1.464077627212125,873.4657498619122
2011-11-22,2.3,2.3,2.3,2.3,34210.0,29.6,0.1,2.266666666666667,39.77943633505241,-0.01157989465559578,3.466384130053993,1.8936158699460073,2.6060780843760942,27.272727272727256,0.30625647049448984,3237900.0,-23.33333333333334,0.0,13.315498717151733,13.315498717151733,2.7,3.55,3.1268123961524856,2.0,3.3,0,,1.462566809260385,867.8976782188254
2011-11-23,2.3,2.3,2.4,2.3,40000.0,29.6,0.1,2.3,39.77943633505241,0.0004601654874447636,3.3999182962910335,1.870081703708966,2.57692779062599,27.272727272727256,0.2915238654591691,3277900.0,-23.33333333333334,0.0,12.674950672137788,12.674950672137788,2.5999999999999996,3.5,3.0592036523833364,2.0,3.3,0,,1.46105910440696,862.371277941159
2011-11-24,2.4,2.3,2.6,2.3,87270.0,29.6,0.1,2.333333333333334,42.524389765409055,0.01704734207779718,3.3402702209333963,1.8597297790666039,2.5600775248520864,36.36363636363635,0.29212930364065703,3365170.0,-14.285714285714283,0.04347826086956519,12.17205431836071,12.17205431836071,2.575,3.5,2.995651433240336,2.0,3.3,0,,1.4596442557202718,857.3635186291416
2011-11-25,2.5,2.4,2.5,2.4,44410.0,29.6,0.1,2.4000000000000004,45.213734912038234,0.03557618161824555,3.2929832867140996,1.8570167132859008,2.5543558558185544,45.45454545454545,0.2784057819520387,3409580.0,-19.35483870967742,0.04166666666666674,11.136231278081548,11.136231278081548,2.5,3.5,2.935912347245916,2.0,3.3,0,,1.4583178586202779,852.8429552703948
2011-11-26,2.5,2.5,2.5,2.4,36120.0,29.6,0.1,2.4666666666666672,45.213734912038234,0.047887853797390134,3.2413754406983095,1.8586245593016901,2.549179107645359,50.0,0.26566251181260736,3445700.0,-16.666666666666664,0.0,10.626500472504294,10.626500472504294,2.5,3.45,2.879757606411161,2.0,3.3,0,,1.4569934742638178,848.3472623104382
2011-11-27,2.5,2.5,2.5,2.4,22730.0,29.6,0.1,2.5,45.213734912038234,0.05554818161579095,3.18492423807645,1.8650757619235496,2.544495383107706,50.0,0.25382947525456395,3468430.0,-16.666666666666664,0.0,10.153179010182559,10.153179010182559,2.5,3.4,2.8269721500264913,2.0,3.3,0,,1.455671104312456,843.8763503778047
2011-11-28,2.5,2.5,2.5,2.4,41260.0,29.6,0.1,2.5,45.213734912038234,0.05976496431591635,3.1228964600965274,1.8771035399034726,2.5402577275736387,83.33333333333331,0.2428416555935237,3509690.0,13.636363636363628,0.0,9.713666223740947,9.713666223740947,2.5250000000000004,3.2,2.7773538210249016,2.0,3.3,0,,1.4543507503285893,839.430129090202
2011-11-29,2.8,2.5,3.0,2.5,180530.0,29.6,0.1,2.6,53.91500222000669,0.080611431633832,3.0863220606356814,1.8936779393643182,2.5649950868523397,79.99999999999999,0.2612101087654149,3690220.0,21.73913043478261,0.11999999999999988,9.328932455907674,9.328932455907674,2.6,3.2,2.0,2.0,3.3,1,,1.4532689389279552,836.2367978998376
2011-11-30,3.0,2.8,3.1,2.7,120150.0,29.6,0.1,2.766666666666667,58.632030158772785,0.1042227606952146,3.1228964600965274,1.8771035399034726,2.6064241261997356,90.9090909090909,0.2711236724250281,3810370.0,15.38461538461538,0.0714285714285714,9.037455747500937,9.037455747500937,2.6500000000000004,3.2,2.02,2.0,3.3,0,,1.4523313953617312,833.7946259779494
2011-12-01,3.1,3.0,3.1,2.9,63860.0,29.6,0.1,2.9666666666666672,60.792898479445,0.12170999551237305,3.1228964600965274,1.8771035399034726,2.653431352275951,100.0,0.26604341010895466,3874230.0,34.782608695652186,0.03333333333333344,8.582045487385633,8.582045487385633,2.6500000000000004,3.2,2.0632,2.0,3.3,0,,1.45146171059824,831.702557802044
2011-12-02,3.1,3.1,3.1,3.0,57500.0,29.6,0.1,3.0666666666666678,60.792898479445,0.1277828888743315,3.1452343321009772,1.8647656678990225,2.695961699678241,100.0,0.25418316652974365,3931730.0,55.00000000000001,0.0,8.19945698483044,8.19945698483044,2.6500000000000004,3.2,2.1046720000000003,2.0,3.3,0,,1.4505913335885015,829.6045135698279
2011-12-03,2.8,3.1,3.1,2.8,123020.0,29.6,0.1,3.0000000000000004,51.44347168681218,0.10694660084283372,3.109735715572786,1.8802642844272142,2.7058701092326944,66.66666666666663,0.25745579749190484,3808710.0,27.272727272727256,-0.09677419354838723,9.194849910425173,9.194849910425173,2.675,3.1,2.14448512,2.0,3.3,0,,1.4495095941003535,826.4165197285176
2011-12-04,2.8,2.8,2.9,2.6,95220.0,29.6,0.1,2.9000000000000004,51.44347168681218,0.08923797808924142,3.1377805479947805,1.9122194520052196,2.7148348607343427,66.66666666666663,0.2604946690996259,3903930.0,27.272727272727256,0.0,9.303381039272352,9.303381039272352,2.65,3.05,2.1827057152,2.0,3.3,0,,1.4484284840792825,823.2357706811608
2011-12-05,2.9,2.8,2.9,2.8,30890.0,29.6,0.1,2.833333333333334,54.168341871879704,0.08059640558446335,3.179419730630592,1.9305802693694074,2.7324696359025005,74.99999999999999,0.2490307641639383,3934820.0,26.086956521739136,0.03571428571428581,8.587267729790977,8.587267729790977,2.65,3.05,2.219397486592,2.0,3.3,0,,1.4474203585597787,820.4318479336446
2011-12-06,3.0,2.9,3.0,2.9,55600.0,29.6,0.1,2.9000000000000004,56.78029098081995,0.07790719451660673,3.2288348415316976,1.9211651584683025,2.7579487181975004,87.49999999999999,0.23838570958079983,3990420.0,30.43478260869566,0.034482758620689724,7.946190319359994,7.946190319359994,2.65,2.95,2.25462158712832,2.0,3.3,0,,1.446482196250817,817.9859683529821
2011-12-07,3.0,3.0,3.1,2.9,58120.0,29.6,0.1,2.9666666666666672,56.78029098081994,0.07253044853182133,3.276033032214453,1.9439669677855478,2.78100122122631,87.49999999999999,0.23564387318217128,4048540.0,30.43478260869566,0.0,7.854795772739043,7.854795772739043,2.675,2.9,2.288436723643187,2.0,3.3,0,,1.4455438411937835,815.5387935759978
2011-12-08,3.0,3.0,3.0,2.9,39930.0,29.6,0.1,3.0,56.78029098081994,0.06558575407287774,3.2841794613737103,2.03582053862629,2.801858247776185,85.71428571428571,0.2259550250977305,4088470.0,25.000000000000007,0.0,7.531834169924349,7.531834169924349,2.7,2.9,2.3208992546974594,2.0,3.3,0,,1.4446053103804348,813.0904909901885
2011-12-09,3.0,3.0,3.0,2.9,34390.0,29.6,0.1,3.0,56.78029098081995,0.0578728690454762,3.3033241251605747,2.0966758748394256,2.82072889084512,85.71428571428571,0.21695823759074975,4122860.0,20.0,0.0,7.231941253024991,7.231941253024991,2.7,2.9,2.352063284509561,2.0,3.3,0,,1.4436666205722188,810.6412253018727
2011-12-10,3.0,3.0,3.1,2.9,74310.0,29.6,0.1,3.0,56.78029098081995,0.04995091525513227,3.3106137047081594,2.16938629529184,2.8378023298122512,85.71428571428571,0.2157469349056962,4197170.0,20.0,0.0,7.191564496856541,7.191564496856541,2.7,2.9,2.3819807531291786,2.0,3.3,0,,1.4427277883033063,808.1911585651771
2011-12-11,3.3,3.0,3.4,3.0,108220.0,29.6,0.1,3.1,65.35919467729236,0.06134465402800958,3.372752091373997,2.207247908626003,2.8818211555444178,89.99999999999999,0.2289078681267179,4305390.0,31.999999999999996,0.09999999999999987,6.936602064445998,6.936602064445998,2.85,2.9,2.4107015230040116,2.0,3.3,0,,1.4419829493513756,806.7167770246567
2011-12-12,3.1,3.3,3.3,3.1,39900.0,29.6,0.1,3.133333333333334,57.20670410171013,0.052199167294520864,3.381724568966042,2.278275431033958,2.902600093111616,66.66666666666669,0.2268430204033809,4265490.0,24.000000000000004,-0.06060606060606055,7.317516787205836,7.317516787205836,2.85,2.9,2.470059431623771,3.1,3.3,0,,1.4411097596795341,804.5936203988138
2011-12-13,3.3,3.1,3.3,3.1,32659.999999999996,29.6,0.1,3.233333333333334,62.27433731326932,0.05606760651732833,3.4114132102241737,2.348586789775826,2.9404477032914618,87.49999999999999,0.2249256618031394,4298150.0,17.857142857142858,0.06451612903225801,6.815929145549679,6.815929145549679,2.9,2.9,2.525855865726345,3.1,3.3,0,,1.4403629079880276,803.1020260255399
2011-12-14,3.2,3.3,3.3,3.0,72480.0,29.6,0.1,3.2000000000000006,58.54142802190065,0.048617043869685156,3.420399840128631,2.419600159871369,2.965166969644656,75.00000000000003,0.23028811453148657,4225670.0,6.666666666666672,-0.030303030303030165,7.196503579108955,7.196503579108955,2.925,2.9,2.578304513782764,3.1,3.3,0,,1.4395525346883542,801.2886112757786
2011-12-15,3.2,3.2,3.2,3.1,30090.0,29.6,0.1,3.2333333333333343,58.54142802190066,0.04073347924518009,3.4302893855334418,2.4797106144665575,2.9875320201546893,75.00000000000003,0.22098182063638036,4255760.0,3.2258064516129057,0.0,6.905681894886887,6.905681894886887,2.9749999999999996,2.9,2.6276062429557983,3.1,3.3,0,,1.438741330849844,799.4682885662373
2011-12-16,3.2,3.2,3.2,3.2,29870.0,29.6,0.1,3.2,58.54142802190066,0.03289894701607474,3.4277213725656477,2.552278627434352,3.0077670658542424,75.00000000000003,0.2051974048766389,4285630.0,3.2258064516129057,0.0,6.412418902394965,6.412418902394965,2.9749999999999996,2.9,2.6739498683784504,3.1,3.3,0,,1.4379293172618248,797.6412474532859
2011-12-17,3.2,3.2,3.2,3.2,16480.0,29.6,0.1,3.2,58.54142802190065,0.025430863112868324,3.4090572873944103,2.6409427126055895,3.026074964344315,75.00000000000003,0.1905404473854504,4302110.0,14.285714285714299,0.0,5.954388980795325,5.954388980795325,3.0,2.9,2.7175128762757432,3.1,3.3,0,,1.4371165144567732,795.8076752178112
2011-12-18,3.2,3.2,3.2,3.2,10790.0,29.6,0.1,3.2,58.54142802190065,0.018525989138512222,3.365941170816793,2.754058829183206,3.0426392534543805,66.66666666666671,0.1769304154293468,4312900.0,14.285714285714299,0.0,5.529075482167086,5.529075482167086,3.0,2.9,2.7584621036991988,3.1,3.3,0,,1.436302942713576,793.9677568803494
2011-12-19,3.5,3.2,3.7,3.2,139990.0,29.6,0.1,3.3000000000000007,67.10903614843266,0.03143916380849941,3.432490740614832,2.7575092593851673,3.0861974197920587,74.99999999999999,0.2000068143272506,4452890.0,20.689655172413797,0.09375,5.714480409350017,5.714480409350017,3.175,2.9,2.7969543774772467,3.1,3.3,1,,1.4356682462323385,793.0119962164247
2011-12-20,4.0,3.5,4.5,3.5,186410.0,29.6,0.1,3.566666666666667,76.00808517058917,0.06878885402487106,3.660654923374872,2.629345076625128,3.17322623695472,68.75,0.25714918473244697,4639300.0,33.33333333333333,0.1428571428571428,6.428729618311174,6.428729618311174,3.6,3.25,2.869198027279067,3.1,3.3,1,,1.4352988935931354,793.3670844602647
2011-12-21,3.9,4.0,4.0,3.8,48790.0,29.6,0.1,3.8000000000000007,71.82262738470655,0.08104956428968582,3.7958191221636257,2.5741808778363735,3.2424427858161753,62.5,0.25306710010870076,4590510.0,30.0,-0.025000000000000022,6.488900002787198,6.488900002787198,3.6,3.25,3.03227822455116,3.1,3.3,0,,1.4348756649767564,793.4494623296613
2011-12-22,3.9,3.9,4.0,3.5,57210.0,29.6,0.1,3.9333333333333336,71.82262738470655,0.08313929931334096,3.9087397165594084,2.5412602834405917,3.305067282405111,62.5,0.2707051643866507,4647720.0,30.0,0.0,6.941158061196171,6.941158061196171,3.6,3.25,3.179050402096044,3.1,3.3,0,,1.434449443118478,793.5115156111993
2011-12-23,4.0,3.9,4.0,3.8,20500.0,29.6,0.1,3.9333333333333336,73.5141084386477,0.0849367918385888,4.017871066423512,2.552128933576488,3.3712513507474813,68.75,0.2656547955018899,4668220.0,33.33333333333333,0.025641025641025772,6.641369887547248,6.641369887547248,3.625,3.25,3.3111453618864397,3.1,3.3,0,,1.4340706134174575,793.8036414067551
2011-12-24,3.9,4.0,4.0,3.9,14930.0,29.6,0.1,3.9333333333333336,69.05019045392899,0.07349976400604452,4.084043009510023,2.5959569904899764,3.421608364962007,59.99999999999999,0.2538223101088978,4653290.0,30.0,-0.025000000000000022,6.508264361766609,6.508264361766609,3.675,3.25,3.430030825697796,3.1,3.3,0,,1.4336383159455701,793.8246906877926
2011-12-25,4.2,3.9,4.4,3.8,80800.0,29.6,0.1,4.033333333333334,74.12609483413792,0.07972668780369813,4.208679040413975,2.6013209595860243,3.495740901632292,80.00000000000001,0.2785492879582622,4734090.0,27.272727272727288,0.0769230769230771,6.632125903768148,6.632125903768148,3.7,3.25,3.537027743128016,3.1,3.3,0,,1.4333499344784795,794.5564145177028
2011-12-26,4.0,4.2,4.3,3.8,88830.0,29.6,0.1,4.033333333333334,66.31743352202837,0.0646080634831866,4.275914124620064,2.634085875379936,3.543765577667312,66.66666666666667,0.2943671959612435,4645260.0,29.032258064516125,-0.04761904761904767,7.359179899031087,7.359179899031087,3.7,3.25,3.6333249688152147,3.1,3.3,0,,1.432961385367518,794.7847215015463
2011-12-27,4.1,4.0,4.1,4.0,30160.0,29.6,0.1,4.1000000000000005,68.12545721416163,0.055901050703172306,4.348808679020862,2.671191320979139,3.596740284556139,73.33333333333331,0.28048382482115464,4675420.0,24.24242424242424,0.02499999999999991,6.841068898076943,6.841068898076943,3.7,3.25,3.7199924719336934,3.1,3.3,0,,1.432618453647523,795.2352085729689
2011-12-28,4.2,4.1,4.3,4.0,33840.0,29.6,0.1,4.1000000000000005,69.86734822373644,0.051541738018596905,4.425803715813806,2.714196284186193,3.654193590788888,78.57142857142858,0.2818778373339293,4709260.0,31.25,0.024390243902439046,6.711377079379269,6.711377079379269,3.775,3.25,3.797993224740324,3.1,3.3,0,,1.4323196260421327,795.9009254953195
2011-12-29,4.2,4.2,4.3,4.1,53070.0,29.6,0.1,4.166666666666668,69.86734822373644,0.04363676147071105,4.485803715813804,2.774196284186196,3.7061751535708987,76.92307692307693,0.2760294203815058,4762330.0,31.25,0.0,6.5721290567025195,6.5721290567025195,3.75,3.25,3.8681939022662917,3.1,3.3,0,,1.4320172083506046,796.5442841593147
2011-12-30,4.3,4.2,4.3,4.1,41070.0,29.6,0.1,4.233333333333334,71.66330381782635,0.040206132812785234,4.546997652579342,2.8430023474206565,3.7627299008498607,84.6153846153846,0.27059874749711255,4803400.0,34.374999999999986,0.023809523809523725,6.292994127839827,6.292994127839827,3.8,3.25,3.9313745120396626,3.1,3.3,0,,1.43175740015621,797.396356042616
2011-12-31,4.7,4.3,5.0,4.2,129729.99999999999,29.6,0.1,4.400000000000001,77.45232016247526,0.05881343918861154,4.701536171218552,2.828463828781447,3.851993719816541,83.33333333333334,0.3084131226758902,4933130.0,46.875,0.09302325581395365,6.561981333529579,6.561981333529579,4.175000000000001,3.5,3.9882370608356963,3.1,3.3,1,,1.4316679677345165,799.098594548451
2012-01-01,5.3,4.7,5.5,4.6,108510.0,29.6,0.1,4.7666666666666675,83.04702738994621,0.1028877555893935,4.975681607005722,2.774318392994278,3.989899079834013,91.30434782608695,0.3506693281990409,5041640.0,65.62499999999999,0.12765957446808507,6.6164024188498285,6.6164024188498285,4.425000000000001,3.75,4.1,3.1,3.3,0,,1.4318085773785807,801.9575973882295
2012-01-02,5.2,5.3,5.5,4.8,69150.0,29.6,0.1,5.066666666666667,79.50615957552121,0.11570698532135515,5.1784701072019494,2.76152989279805,4.105146786516488,85.00000000000001,0.37562151904196656,4972490.0,48.57142857142858,-0.01886792452830177,7.2234907508070485,7.2234907508070485,4.425000000000001,3.75,4.2,3.1,3.3,0,,1.4319059945102828,804.6049058178982
2012-01-03,4.9,5.2,5.3,4.7,125170.0,29.6,0.1,5.133333333333334,69.8801675386997,0.09523687464743213,5.273974979234885,2.836025020765116,4.180847092562536,70.00000000000001,0.39164855339611176,4847320.0,22.500000000000007,-0.05769230769230771,7.9928276203288116,7.9928276203288116,4.425000000000001,3.75,4.382000000000001,4.9,3.3,0,,1.4318819622852523,806.6415100845998
2012-01-04,5.6,4.9,5.7,4.8,131170.0,29.6,0.1,5.233333333333334,76.90609380946938,0.11857532707147944,5.501461458166304,2.8485385418336957,4.316004512318485,95.45454545454544,0.4279593710106752,4978490.0,43.589743589743584,0.1428571428571428,7.642131625190629,7.642131625190629,4.574999999999999,3.85,4.53852,4.9,3.3,0,,1.4321123124564936,809.9729177280702
2012-01-05,6.9,5.6,7.2,5.6,182330.0,29.6,0.1,5.800000000000001,84.25270429934808,0.20616903902627848,6.068098357823889,2.6519016421761115,4.562099320669105,91.1764705882353,0.511676558795627,5160820.0,76.92307692307693,0.2321428571428572,7.415602301385898,7.415602301385898,5.35,4.6,4.7,4.9,3.3,1,,1.432740988807,815.3537209921105
2012-01-06,6.7,6.9,7.2,6.1,218080.0,29.6,0.1,6.400000000000001,80.03440247408375,0.23324849903115152,6.437918810669718,2.632081189330282,4.76570890917681,85.29411764705883,0.5536996617387965,4942740.0,67.5,-0.02898550724637683,8.264174055802933,8.264174055802933,5.375,4.6,4.8,4.9,3.3,1,,1.433303997691957,820.4292822469224
2012-01-07,6.8,6.7,7.0,6.4,48390.0,29.6,0.1,6.800000000000001,80.5585307288121,0.2395929268642344,6.754877447299382,2.6751225527006177,4.959450917826638,88.23529411764704,0.5570068287574539,4991130.0,74.35897435897436,0.014925373134328401,8.191276893491969,8.191276893491969,5.375,4.6,5.232,4.9,3.3,0,,1.4338872861181031,825.6393842918953
2012-01-08,7.1,6.8,7.2,6.7,57190.0,29.6,0.1,6.866666666666667,82.07850240922042,0.24482590486422928,7.102691101581159,2.6873088984188405,5.163312735176483,97.05882352941175,0.5529349124176358,5048320.0,69.04761904761904,0.044117647058823595,7.787815667854026,7.787815667854026,5.4,4.6,5.58624,4.9,7.1,0,,1.4345453834677842,831.2714290347614
2012-01-09,6.3,7.1,7.2,5.8,148410.0,29.6,0.1,6.733333333333334,67.02898788198998,0.17833048832755682,7.2584661438413125,2.761533856158687,5.271568665159674,71.87499999999999,0.6134395615306618,4899910.0,57.49999999999999,-0.11267605633802813,9.737135897312092,9.737135897312092,5.525,4.6,7.2,4.9,7.1,0,,1.4349645902920005,835.6824730512756
2012-01-10,6.4,6.3,6.9,6.0,110210.0,29.6,0.1,6.600000000000001,67.82318947935744,0.12739234949899148,7.400634568945446,2.869365431054554,5.379038316096848,75.0,0.6339081642784716,5010120.0,56.09756097560978,0.01587301587301604,9.90481506685112,9.90481506685112,5.575,4.7,7.2,4.9,7.1,0,,1.435406588329686,840.2346522639815
2012-01-11,6.9,6.4,7.1,6.4,99440.0,29.6,0.1,6.533333333333334,71.51748399380082,0.1141121849457245,7.600404932188019,2.969595067811981,5.52389180980191,90.3225806451613,0.6386290096871522,5109560.0,64.28571428571429,0.078125,9.255492894016697,9.255492894016697,5.575,4.7,7.2,4.9,7.1,0,,1.4359852366674377,845.5361507792145
2012-01-12,6.8,6.9,7.0,6.3,140120.0,29.6,0.1,6.7,69.79162034129074,0.08658079423972076,7.751263097760139,3.0987369022398608,5.645425923154109,87.09677419354837,0.6430126518523556,4969440.0,61.9047619047619,-0.01449275362318847,9.456068409593463,9.456068409593463,5.6,4.75,7.172000000000001,4.9,7.1,0,,1.4365276373928564,850.6745190817437
2012-01-13,6.4,6.8,6.8,6.4,60230.0,29.6,0.1,6.700000000000002,63.21971275349155,0.03221761777872201,7.802554105898588,3.2974458941014113,5.717290120948956,73.33333333333334,0.6256546052914729,4909210.0,48.8372093023256,-0.05882352941176461,9.775853207679264,9.775853207679264,5.800000000000001,4.75,7.14456,4.9,7.1,0,,1.4369461640987633,855.17393881375
2012-01-14,6.8,6.4,6.9,6.2,141900.0,29.6,0.1,6.666666666666667,66.60612387443244,0.014867305951797749,7.905848152952169,3.454151847047832,5.820405347525245,84.61538461538461,0.6309649906277962,5051110.0,44.68085106382978,0.0625,9.278896920997003,9.278896920997003,5.925,4.75,7.117668800000001,4.9,7.1,0,,1.4374728926856775,860.2807913829861
2012-01-15,7.0,6.8,7.1,6.7,62230.0,29.6,0.1,6.733333333333334,68.18348751631865,0.008828054274021335,7.986014842249601,3.673985157750399,5.932747695379984,91.99999999999999,0.6144674912972393,5113340.0,32.07547169811321,0.02941176470588247,8.77810701853199,8.77810701853199,5.925,4.8,5.8,4.9,7.1,0,,1.4380468242905322,865.673213933152
2012-01-16,6.7,7.0,7.2,6.5,122670.0,29.6,0.1,6.833333333333335,63.34972126591285,-0.021734009311835,7.9931256724562205,3.9268743275437776,6.005819343439033,80.0,0.6205769562045794,4990670.0,28.846153846153843,-0.042857142857142816,9.262342629919097,9.262342629919097,5.925,4.8,5.826,4.9,7.1,0,,1.4385293728442872,870.5952216418829
2012-01-17,5.6,6.7,6.9,4.6,213410.0,29.6,0.1,6.433333333333334,49.494349867538794,-0.11706897729184707,7.9062729012594515,4.153727098740549,5.967169882159125,38.46153846153845,0.7405357450471095,4777260.0,14.28571428571427,-0.16417910447761197,13.223852590126956,13.223852590126956,5.7,4.8,7.2,4.9,7.1,0,,1.4386642982966573,873.6247406637663
2012-01-18,5.9,5.6,6.9,5.1,226680.0,29.6,0.1,6.066666666666667,52.542864190839,-0.1583931771067526,7.7958033793399375,4.434196620660063,5.960772750524922,50.000000000000014,0.8162117632580302,5003940.0,5.35714285714287,0.0535714285714286,13.834097682339493,13.834097682339493,5.7,4.8,7.2,4.9,7.1,0,,1.4388922581192636,877.1758337953356
2012-01-19,6.4,5.9,6.4,5.9,114820.0,29.6,0.1,5.966666666666668,57.18172049450001,-0.1505736481051272,7.68232691283466,4.757673087165341,6.002603917141595,69.23076923076924,0.7936252087395995,5118760.0,-7.246376811594203,0.0847457627118644,12.400393886556243,12.400393886556243,5.7,4.85,7.148000000000001,4.9,7.1,0,,1.4392676395700437,881.5577979091203
2012-01-20,6.5,6.4,6.6,6.3,66790.0,29.6,0.1,6.266666666666668,58.06460682810529,-0.1375455723100798,7.598254633215243,5.021745366784758,6.049974972651919,73.07692307692307,0.7583662652581994,5185550.0,-2.9850746268656745,0.015625,11.667173311664605,11.667173311664605,5.7,4.9,7.097040000000001,4.9,7.1,0,,1.439665245733775,886.0829830100597
2012-01-21,6.2,6.5,6.6,6.1,64760.00000000001,29.6,0.1,6.366666666666667,54.43813147818995,-0.14714940489744865,7.5591179344235915,5.150882065576409,6.064263070494593,61.53846153846155,0.7399115320254709,5120790.0,-8.823529411764701,-0.0461538461538461,11.934056968152756,11.934056968152756,5.75,4.9,7.047099200000001,4.9,7.1,0,,1.439966841374262,890.0886109236907
2012-01-22,6.3,6.2,6.4,6.1,44890.0,29.6,0.1,6.333333333333335,55.43723119457979,-0.14457258164608722,7.492404730219031,5.327595269780971,6.086714206637964,65.38461538461539,0.7084892797379373,5165680.0,-11.267605633802814,0.016129032258064502,11.245861583141863,11.245861583141863,5.75,4.9,6.998157216000001,4.9,7.1,0,,1.4402919339187514,894.2418377035901
2012-01-23,6.4,6.3,6.4,6.2,17690.0,29.6,0.1,6.300000000000001,56.465312411934235,-0.13416673046876415,7.317526275861924,5.6524737241380745,6.116550948862921,69.23076923076924,0.6721686168995132,5183370.0,1.5873015873015959,0.01587301587301604,10.502634639054893,10.502634639054893,5.775,4.9,6.950194071680001,4.9,7.1,0,,1.4406398855539186,898.5410632768046
2012-01-24,6.3,6.4,6.4,6.2,35660.0,29.6,0.1,6.333333333333335,55.09643843546875,-0.1318570278201492,7.2537574531141225,5.7862425468858785,6.134022287066452,65.38461538461539,0.6384422871209766,5147710.0,-1.5625000000000084,-0.01562500000000011,10.13400455747582,10.13400455747582,5.775,4.9,6.903190190246401,4.9,7.1,0,,1.4409516028878313,902.651110897678
2012-01-25,5.8,6.3,6.3,5.5,133120.0,29.6,0.1,6.166666666666668,48.73471415460223,-0.15996944933903828,7.2403063910484216,5.68969360895158,6.1022106406791705,46.15384615384615,0.6499821237551926,5014590.0,-15.942028985507253,-0.07936507936507942,11.20658834060677,11.20658834060677,5.725,5.0,6.8571263864414735,4.9,7.1,0,,1.441102334416191,905.8542614380525
2012-01-26,5.3,5.8,5.9,5.3,123950.0,29.6,0.1,5.800000000000001,43.344897627986654,-0.20531156658850386,7.312551088496184,5.477448911503815,6.025809627281154,26.923076923076923,0.6464119720583932,4890640.0,-22.058823529411764,-0.08620689655172409,12.196452302988552,12.196452302988552,5.95,5.05,6.811983858712644,5.3,7.1,0,,1.4410793621504085,908.066929260972
2012-01-27,5.3,5.3,5.5,5.1,115570.0,29.6,0.1,5.466666666666668,43.34489762798666,-0.22669923611735832,7.333114011353381,5.30688598864662,5.956684900873425,26.923076923076923,0.628811116911365,5006210.0,-17.187500000000007,0.0,11.86436069644085,11.86436069644085,5.875,5.05,6.767744181538391,5.3,7.1,0,,1.4410517144056338,910.253790131295
2012-01-28,5.6,5.3,5.8,5.3,89710.0,29.6,0.1,5.400000000000001,47.39341741241686,-0.21228955235060365,7.237924971989599,5.252075028010402,5.922714910314051,38.46153846153845,0.6196103228462676,5095920.0,-17.647058823529417,0.05660377358490565,11.064470050826209,11.064470050826209,5.875,5.05,6.724389297907623,5.3,7.1,0,,1.4411216987340578,913.005508748686
2012-01-29,5.4,5.6,5.7,5.3,46430.0,29.6,0.1,5.433333333333334,45.08060506073964,-0.20762314155932984,7.258300524426096,5.141699475573905,5.872932537903189,30.76923076923079,0.6039238712143914,5049490.0,-22.85714285714285,-0.03571428571428559,11.183775392859099,11.183775392859099,5.875,5.05,6.681901511949471,5.3,7.1,0,,1.4411191112259094,915.3409993013915
2012-01-30,5.5,5.4,5.6,5.4,42300.0,29.6,0.1,5.500000000000001,46.48677618426007,-0.18968973219232227,7.251311999387287,5.058688000612712,5.837415153340981,39.130434782608695,0.5750721661276491,5091790.0,-17.910447761194032,0.01851851851851838,10.455857565957256,10.455857565957256,5.825,5.05,6.640263481710481,5.3,7.1,0,,1.4411457442193956,917.8480485802978
2012-01-31,5.5,5.5,5.7,5.4,48300.0,29.6,0.1,5.466666666666668,46.48677618426007,-0.1703303492069032,7.160685827739938,5.00931417226006,5.805280376832316,22.222222222222232,0.5554241542613885,5140090.0,-1.7857142857142794,0.0,10.0986209865707,10.0986209865707,5.825,5.1,6.5994582120762715,5.3,7.1,0,,1.4411674999351127,920.329423599949
2012-02-01,6.1,5.5,6.2,5.5,115520.0,29.6,0.1,5.7,54.57934563460044,-0.11241322881839505,7.074695076596233,5.025304923403767,5.833348912372095,66.66666666666667,0.565751000385575,5255610.0,3.3898305084745637,0.10909090909090913,9.274606563697951,9.274606563697951,5.825,5.1,6.559469047834746,5.3,6.1,0,,1.4413753305553556,923.9018313271823
2012-02-02,6.1,6.1,6.2,5.8,54550.0,29.6,0.1,5.900000000000001,54.57934563460044,-0.0713993625706682,7.047472221841449,5.022527778158551,5.858744254050943,66.66666666666667,0.5539116432151768,5310160.0,-4.687500000000011,0.0,9.080518741232407,9.080518741232407,5.8,5.1,6.520279666878051,5.3,6.1,0,,1.4415773362270565,927.4503524073472
2012-02-03,6.0,6.1,6.1,5.7,59280.0,29.6,0.1,6.066666666666667,53.029248515345635,-0.04934917598070149,6.944684158023373,5.045315841976626,5.872197182236567,60.00000000000002,0.5429179544140927,5250880.0,-7.6923076923076925,-0.016393442622950727,9.048632573568211,9.048632573568211,5.775,5.1,6.48187407354049,5.3,6.1,0,,1.441743200543669,930.7957079362326
2012-02-04,5.9,6.0,6.0,5.8,20620.0,29.6,0.1,6.000000000000001,51.455458729446526,-0.040228486875571484,6.770421579681409,5.10957842031859,5.874845069642608,61.53846153846156,0.5184238148130861,5230260.0,-4.838709677419352,-0.016666666666666607,8.786844318865866,8.786844318865866,5.775,5.15,6.44423659206968,5.3,6.1,0,,1.441872682287825,933.9340102919342
2012-02-05,5.7,5.9,5.9,5.4,120340.0,29.6,0.1,5.866666666666667,48.3639686335031,-0.045979955424852406,6.648683069536005,5.1313169304639965,5.858193158248073,46.153846153846175,0.5171078280407228,5109920.0,-9.523809523809518,-0.03389830508474578,9.07206715860917,9.07206715860917,5.825,5.2,6.407351860228286,5.3,6.1,0,,1.441933690262448,936.6722630188541
2012-02-06,5.4,5.7,5.7,5.4,90260.0,29.6,0.1,5.666666666666668,44.085322497867686,-0.06702847154770618,6.6587168933576395,5.10128310664236,5.814555714605399,23.07692307692312,0.501600126037814,5019660.0,-15.625,-0.05263157894736836,9.288891222922482,9.288891222922482,5.825,5.2,6.371204823023721,5.3,6.1,0,,1.4418909467363876,938.7964402404513
2012-02-07,5.7,5.4,5.8,5.4,72750.0,29.6,0.1,5.600000000000001,48.9490879919791,-0.05811811300470983,6.652559901860921,5.087440098139079,5.803645646547742,50.00000000000004,0.4943429741779701,5092410.0,-9.523809523809518,0.05555555555555558,8.672683757508247,8.672683757508247,5.8500000000000005,5.2,6.335780726563247,5.3,6.1,0,,1.4419424258825406,941.4838504104919
2012-02-08,5.6,5.7,5.8,5.3,237940.0,29.6,0.1,5.566666666666667,47.46690724599395,-0.05629181053094633,6.581265598840102,5.078734401159898,5.784250823067005,45.45454545454543,0.4947470474509722,4854470.0,-3.448275862068969,-0.01754385964912286,8.834768704481647,8.834768704481647,5.825,5.2,6.301065112031981,5.3,6.1,1,,1.4419568042305706,943.9526131669186
2012-02-09,5.8,5.6,5.9,5.5,89950.0,29.6,0.1,5.7,50.68327340719003,-0.03972779538574053,6.480492523664978,5.109507476335022,5.785750744679671,63.63636363636362,0.4879794012044742,4944420.0,9.433962264150944,0.03571428571428581,8.41343795180128,8.41343795180128,5.825,5.35,6.267043809791342,5.3,6.1,0,,1.4420302920775914,946.7789656957272
2012-02-10,5.9,5.8,6.0,5.8,39310.0,29.6,0.1,5.766666666666668,52.25723724257567,-0.021085999199639428,6.442117814290313,5.117882185709686,5.796631626138749,66.6666666666667,0.4674094439755832,4983730.0,11.320754716981142,0.017241379310344973,7.92219396568785,7.92219396568785,5.825,5.35,6.233702933595515,5.3,6.1,0,,1.4421298283764818,949.7669471318566
2012-02-11,5.6,5.9,6.0,5.5,69710.0,29.6,0.1,5.766666666666668,47.3725862366918,-0.027598130140227307,6.366208499620365,5.123791500379635,5.777904804601725,33.3333333333333,0.46973734083447016,4914020.0,0.0,-0.05084745762711873,8.388166800615538,8.388166800615538,5.725,5.35,6.201028874923605,5.3,6.1,0,,1.4421297827238173,952.1579720429313
2012-02-12,5.5,5.6,5.8,5.4,81920.0,29.6,0.1,5.666666666666667,45.83462905611165,-0.036708444141932646,6.251361950084143,5.148638049915857,5.751437680353942,22.222222222222232,0.4647561022034365,4832100.0,1.8518518518518452,-0.017857142857142794,8.450110949153391,8.450110949153391,5.825,5.5,6.169008297425132,5.3,6.1,0,,1.4420926302923442,954.3257908471586
2012-02-13,5.3,5.5,5.7,5.2,170210.0,29.6,0.1,5.466666666666668,42.83910883316416,-0.05326777164934003,6.153984126734755,5.146015873265246,5.708443615558329,9.999999999999964,0.4672735234746196,4661890.0,-3.63636363636364,-0.036363636363636376,8.816481574992823,8.816481574992823,5.725,5.5,6.13762813147663,5.3,6.1,0,,1.4419843187952326,956.0617301980926
2012-02-14,4.5,5.3,5.4,4.2,297570.0,29.6,0.1,5.1000000000000005,33.42812162158906,-0.11179711946386427,6.290053189483317,4.8799468105166826,5.593353747409917,14.999999999999991,0.5196111289407181,4364320.0,-18.181818181818183,-0.15094339622641506,11.546913976460402,11.546913976460402,5.25,5.5,6.106875568847097,5.3,6.1,1,,1.4415773589771697,955.9794054013233
2012-02-15,4.3,4.5,4.9,4.2,161800.0,29.6,0.1,4.7,31.56141562775477,-0.15501885124479348,6.430041898460963,4.639958101539038,5.470177200037544,4.999999999999982,0.5324960483020954,4202520.0,-29.508196721311474,-0.04444444444444451,12.38362903028129,12.38362903028129,5.25,5.5,6.030600546093213,5.3,6.1,0,,1.4410863269897782,955.3806568572395
2012-02-16,4.3,4.3,4.4,3.9,166600.0,29.6,0.1,4.366666666666667,31.56141562775477,-0.1732634591705765,6.526681333230373,4.443318666769628,5.358731752414921,18.18181818181818,0.5301749019948029,4369120.0,-29.508196721311474,0.0,12.329648883600068,12.329648883600068,5.050000000000001,5.55,5.957376524249485,5.3,6.1,0,,1.440593418470225,954.7651453101344
2012-02-17,4.4,4.3,4.8,4.2,135950.0,29.6,0.1,4.333333333333335,33.70807889200226,-0.1681198084031883,6.5667092449483855,4.283290755051614,5.267423966470643,23.809523809523828,0.5351624089951741,4505070.0,-26.66666666666666,0.023255813953488413,12.162782022617593,12.162782022617593,5.050000000000001,5.55,5.833933932794515,5.3,6.1,0,,1.4401398429679504,954.3831359541243
2012-02-18,4.2,4.4,4.5,4.1,70410.0,29.6,0.1,4.300000000000001,31.574935465365684,-0.16734860896030063,6.625595097563297,4.104404902436704,5.165764541092487,14.285714285714299,0.5255079512098045,4434660.0,-28.8135593220339,-0.045454545454545525,12.512094076423915,12.512094076423915,5.050000000000001,5.55,5.717897896826845,4.2,6.1,0,,1.439601022839687,953.4782429507079
2012-02-19,4.4,4.2,4.5,4.2,62370.0,29.6,0.1,4.333333333333335,35.94063053651456,-0.14344991799026602,6.63649915190347,3.983500848096531,5.092834584797965,23.809523809523828,0.5094002404091043,4497030.0,-22.807017543859644,0.04761904761904767,11.577278191116006,11.577278191116006,5.025,5.55,5.608824023017234,4.2,6.1,0,,1.4391436640483133,953.0625289104386
2012-02-20,4.4,4.4,4.5,4.3,37300.0,29.6,0.1,4.333333333333335,35.94063053651456,-0.11874475363984344,6.635543371285607,3.8744566287143947,5.02685033862673,23.809523809523828,0.48730022323702543,4534330.0,-18.51851851851852,0.0,11.075005073568759,11.075005073568759,4.949999999999999,5.55,5.5062945816362,4.2,6.1,0,,1.4386843019604036,952.6292982227536
2012-02-21,4.3,4.4,4.4,4.2,51790.0,29.6,0.1,4.366666666666668,34.65834320435063,-0.100940316005805,6.548148582040496,3.781851417959504,4.957626496852756,19.047619047619044,0.4667787787200951,4482540.0,-24.561403508771935,-0.022727272727272818,10.85532043535105,10.85532043535105,4.925,5.55,5.409916906738028,4.2,6.1,0,,1.4381820623021904,951.9307010723552
2012-02-22,4.4,4.3,4.5,4.3,103840.0,29.6,0.1,4.366666666666667,37.07603225134017,-0.07540086206767982,6.43144367252233,3.72855632747767,4.904519211438208,23.809523809523828,0.4477231516686597,4586380.0,-21.428571428571416,0.023255813953488413,10.17552617428772,10.17552617428772,4.85,5.55,5.319321892333746,4.2,6.1,0,,1.4377189045645862,951.463868027965
2012-02-23,5.0,4.4,5.2,4.4,164310.0,29.6,0.1,4.566666666666667,49.21725454914551,-0.014271384414195287,6.313900307656575,3.7460996923434253,4.913612619872665,52.38095238095239,0.47288578369232687,4750690.0,-13.79310344827586,0.13636363636363624,9.457715673846536,9.457715673846536,4.8,5.55,5.234162578793721,4.2,5.0,0,,1.437480423697073,952.3544991020125
2012-02-24,5.0,5.0,5.1,4.8,89830.0,29.6,0.1,4.800000000000001,49.21725454914551,0.027702651461758376,6.205286851523301,3.7647131484766994,4.921839989408602,52.38095238095239,0.46053679914287493,4840520.0,-15.254237288135597,0.0,9.210735982857498,9.210735982857498,4.8,5.55,5.2,4.2,5.0,0,,1.4372388481776006,953.2223918219745
2012-02-25,4.8,5.0,5.1,4.7,86160.0,29.6,0.1,4.9333333333333345,45.80085973949066,0.04264340650482373,6.11711511756525,3.7628848824347485,4.910236180893497,47.368421052631575,0.456212742061241,4754360.0,-14.285714285714283,-0.040000000000000036,9.504432126275855,9.504432126275855,4.85,5.55,5.2,4.2,5.0,0,,1.4369220945718122,953.6290405964318
2012-02-26,4.9,4.8,5.1,4.8,70040.0,29.6,0.1,4.900000000000001,47.75367475885631,0.05890511197172915,6.073058720445841,3.7569412795541606,4.909261306522688,55.55555555555557,0.4450546890568666,4824400.0,-10.909090909090903,0.02083333333333348,9.082748756262584,9.082748756262584,4.85,5.55,5.122,4.2,5.0,0,,1.4366390409266445,954.2359635468556
2012-02-27,5.0,4.9,5.0,4.9,29370.0,29.6,0.1,4.900000000000001,49.70520997124692,0.07500804143600437,5.9819981851167725,3.7780018148832286,4.917903086853861,73.33333333333331,0.4204079255528047,4853770.0,-5.660377358490563,0.020408163265306145,8.408158511056094,8.408158511056094,4.875,5.55,5.1,4.2,5.0,0,,1.4363887287353538,955.0378822382504
2012-02-28,4.9,5.0,5.0,4.7,62690.0,29.6,0.1,4.9333333333333345,47.78309397655131,0.07723281974395421,5.896617801295064,3.793382198704937,4.9161980309630176,76.92307692307693,0.41180735944189006,4791080.0,8.888888888888896,-0.019999999999999907,8.404231825344695,8.404231825344695,4.85,5.55,5.1,4.2,5.0,0,,1.436099934625651,955.601010016346
2012-02-29,4.9,4.9,4.9,4.8,26540.0,29.6,0.1,4.9333333333333345,47.78309397655131,0.07684815237938822,5.7570788891207805,3.842921110879219,4.914655361347492,76.92307692307693,0.3895354051960408,4817620.0,13.953488372093037,0.0,7.949702146857975,7.949702146857975,4.825,5.55,5.028,4.2,5.0,0,,1.4358083732012175,956.1427134466514
2012-03-01,4.9,4.9,5.0,4.9,44180.0,29.6,0.1,4.9,47.78309397655131,0.07467294743548081,5.566088230524538,3.933911769475462,4.913259612647731,72.72727272727276,0.368854304824895,4861800.0,13.953488372093037,0.0,7.527638873977449,7.527638873977449,4.85,5.55,3.9,4.2,5.0,0,,1.4355140715984782,956.6631237284662
2012-03-02,4.7,4.9,4.9,4.5,130770.00000000001,29.6,0.1,4.833333333333335,43.57399529450634,0.0585557685473127,5.421868188721382,3.9881318112786177,4.892949173347947,54.54545454545457,0.37107899733740257,4731030.0,6.818181818181814,-0.04081632653061229,7.895297815689416,7.895297815689416,4.875,5.55,3.9219999999999997,4.2,5.0,0,,1.4351442043894502,956.7171094313492
2012-03-03,4.6,4.7,4.8,4.5,40080.0,29.6,0.1,4.733333333333334,41.60079505616705,0.040793225582126974,5.27773780845977,4.04226219154023,4.865049252076714,39.99999999999994,0.36600192609901666,4690950.0,9.523809523809511,-0.021276595744680993,7.956563610848189,7.956563610848189,4.875,5.55,3.9435599999999997,4.2,5.0,0,,1.4347344928393493,956.522503155542
2012-03-04,4.8,4.6,4.9,4.6,58830.0,29.6,0.1,4.700000000000001,46.79055407951957,0.04198286527548867,5.18372579673338,4.08627420326662,4.858854085212266,59.999999999999964,0.36128750280622984,4749780.0,9.09090909090908,0.04347826086956519,7.5268229751297895,7.5268229751297895,4.875,5.55,3.9646888,4.2,5.0,0,,1.4343968324479413,956.7631593435636
2012-03-05,5.0,4.8,5.1,4.8,65830.0,29.6,0.1,4.800000000000001,51.43806994033342,0.05489331557369831,5.227097875150912,4.092902124849088,4.872296553287288,79.99999999999999,0.3569098240343563,4815610.0,13.636363636363628,0.04166666666666674,7.138196480687125,7.138196480687125,4.875,5.55,3.985395024,4.2,5.0,0,,1.4341277162683337,957.4183080122756
2012-03-06,5.0,5.0,5.1,4.9,44530.0,29.6,0.1,4.9333333333333345,51.43806994033342,0.06158471001755195,5.255267793113862,4.134732206886139,4.884458786307547,77.77777777777776,0.34570197946047365,4860140.0,16.279069767441865,0.0,6.914039589209472,6.914039589209472,4.875,5.55,4.02997922304,4.2,5.0,0,,1.4338558089302573,958.0520893226461
2012-03-07,4.9,5.0,5.1,4.8,46170.0,29.6,0.1,4.966666666666668,48.958373621083894,0.057505216388073266,5.261190264738808,4.1888097352611915,4.885938901897304,62.500000000000014,0.3424375523561541,4813970.0,11.363636363636363,-0.019999999999999907,6.988521476656205,6.988521476656205,4.875,5.55,4.072780054118399,4.2,5.0,0,,1.433546121488799,958.4499718277482
2012-03-08,4.9,4.9,5.0,4.8,58090.0,29.6,0.1,4.9333333333333345,48.958373621083894,0.05313929293961736,5.269615242271309,4.230384757728691,4.88727805409756,66.66666666666677,0.3322634414735717,4872060.0,-1.9999999999999927,0.0,6.780886560685135,6.780886560685135,4.824999999999999,5.4,4.113868851953663,4.2,5.0,0,,1.433233874793034,958.8274997080382
2012-03-09,4.9,4.9,4.9,4.8,32720.0,29.6,0.1,4.9,48.958373621083894,0.048701594553626465,5.242274534607677,4.327725465392323,4.888489667993031,66.66666666666677,0.3156731956540309,4904780.0,-1.9999999999999927,0.0,6.442310115388385,6.442310115388385,4.8,5.4,4.1533140978755165,4.2,5.0,0,,1.4329190940479872,959.1848064564849
2012-03-10,4.8,4.9,4.9,4.8,28070.0,29.6,0.1,4.866666666666668,46.17800094920305,0.03795877334256821,5.226781934180053,4.383218065819948,4.880062080565124,50.0,0.30026796739302875,4876710.0,0.0,-0.020408163265306256,6.255582654021433,6.255582654021433,4.725,5.25,4.191181533960496,4.2,5.0,0,,1.4325662492877342,959.3037010671263
2012-03-11,4.9,4.8,5.0,4.8,42440.0,29.6,0.1,4.866666666666667,49.27998853442614,0.03650419677565454,5.210000000000873,4.449999999999127,4.881960930035112,66.66666666666677,0.2931059697220982,4919150.0,0.0,0.02083333333333348,5.981754484124453,5.981754484124453,4.675,5.25,4.2275342726020755,4.2,5.0,0,,1.4322465949822336,959.6215743642451
2012-03-12,4.9,4.9,4.9,4.9,22050.0,29.6,0.1,4.866666666666668,49.27998853442614,0.03448259648544172,5.152574776767684,4.567425223232316,4.883678936698435,66.66666666666677,0.27216982902766257,4941200.0,-1.9999999999999927,0.0,5.55448630668699,5.55448630668699,4.699999999999999,5.25,4.262432901697992,4.2,5.0,0,,1.4319244803544435,959.9196305640646
2012-03-13,5.3,4.9,5.4,4.9,127330.0,29.6,0.1,5.033333333333334,59.980047247598144,0.057660045052853534,5.176845544382569,4.633154455617429,4.923328561774775,88.88888888888884,0.2884434126685438,5068530.0,8.163265306122437,0.08163265306122436,5.442328540915921,5.442328540915921,4.925,5.15,4.2959355856300725,4.2,5.0,1,,1.4317345537346617,961.0263374913482
2012-03-14,5.4,5.3,5.4,5.3,62890.0,29.6,0.1,5.200000000000001,62.13092724635009,0.07614005105329816,5.270687720349818,4.579312279650182,4.968725841605749,99.99999999999999,0.274983168906505,5131420.0,10.20408163265306,0.018867924528301883,5.092280905676018,5.092280905676018,4.925,5.15,4.362179450492268,4.2,5.4,0,,1.431573549058847,962.3082514643216
2012-03-15,5.3,5.4,5.4,5.3,41080.0,29.6,0.1,5.333333333333335,58.73157669387764,0.07776996726461649,5.321575680567633,4.558424319432366,5.00027576145282,88.88888888888884,0.262484371127469,5090340.0,8.163265306122437,-0.0185185185185186,4.952535304291867,4.952535304291867,4.95,5.15,4.424448683462732,4.2,5.4,0,,1.4313773602476667,963.3703632157174
2012-03-16,5.3,5.3,5.4,5.3,32720.0,29.6,0.1,5.333333333333333,58.73157669387764,0.07495764363061258,5.371324993079,4.558675006921,5.028820927028742,88.88888888888884,0.2508783446183641,5123060.0,12.765957446808502,0.0,4.733553672044606,4.733553672044606,4.95,5.1,4.482981762454968,4.2,5.4,0,,1.4311781361817608,964.4105128567293
2012-03-17,5.2,5.3,5.4,5.2,39100.0,29.6,0.1,5.266666666666668,55.22720207690079,0.06295582676011499,5.3976122603571985,4.562387739642802,5.045123695883148,75.0,0.24724417714562383,5083960.0,13.043478260869579,-0.01886792452830177,4.7546957143389195,4.7546957143389195,4.95,5.05,4.53800285670767,4.2,5.4,0,,1.430943446064498,965.2278954467447
2012-03-18,5.3,5.2,5.3,5.2,22860.0,29.6,0.1,5.2666666666666675,57.930482389770305,0.05844341233115589,5.435340777126814,4.554659222873185,5.069397629608562,83.33333333333326,0.23672673592093638,5106820.0,10.416666666666668,0.019230769230769162,4.466542187187479,4.466542187187479,4.975,5.05,4.58972268530521,4.2,5.4,0,,1.430738341976604,966.2248216086782
2012-03-19,4.7,5.3,5.3,4.5,188890.0,29.6,0.1,5.066666666666667,41.67261615044594,0.014056189448541173,5.442274534607655,4.527725465392345,5.034216902979176,22.222222222222232,0.27696054049801233,4917930.0,-5.9999999999999964,-0.1132075471698113,5.8927774574045175,5.8927774574045175,4.925000000000001,5.05,5.4,4.2,5.4,1,,1.4303262446518052,965.9349087492488
2012-03-20,4.8,4.7,4.9,4.6,66340.0,29.6,0.1,4.9333333333333345,44.469788102930146,-0.008356611526161985,5.4430334761123085,4.516966523887691,5.0119105312668735,33.3333333333333,0.2786062161767258,4984270.0,-4.0000000000000036,0.02127659574468077,5.804296170348454,5.804296170348454,4.95,5.05,5.382000000000001,4.2,5.4,0,,1.4299479347575001,965.8494587609271
2012-03-21,4.8,4.8,4.9,4.8,46440.0,29.6,0.1,4.766666666666668,44.469788102930146,-0.022184074475521086,5.443508271005591,4.506491728994408,4.991728575908124,33.3333333333333,0.26584862930695974,5030710.0,-2.040816326530623,0.0,5.538513110561662,5.538513110561662,4.95,5.05,5.3643600000000005,4.2,5.4,0,,1.429567559808925,965.7463348785661
2012-03-22,4.7,4.8,4.9,4.6,58070.0,29.6,0.1,4.7666666666666675,42.126777402445825,-0.03623675980828695,5.443508271005591,4.506491728994408,4.963944902012113,22.222222222222232,0.26828801292789123,4972640.0,-4.081632653061227,-0.02083333333333326,5.708255594210451,5.708255594210451,4.95,5.05,5.3470728,4.2,5.4,0,,1.4291495656350695,965.4051617376736
2012-03-23,4.7,4.7,4.8,4.6,54130.0,29.6,0.1,4.733333333333334,42.126777402445825,-0.04322958789427092,5.434312667664734,4.525687332335265,4.938807292296674,22.222222222222232,0.2634102977187561,5026770.0,-4.081632653061227,0.0,5.604474419548002,5.604474419548002,4.95,5.05,5.330131344000001,4.2,5.4,0,,1.428729725633222,965.0476977226573
2012-03-24,4.7,4.7,4.7,4.6,39070.0,29.6,0.1,4.7,42.126777402445825,-0.04533232965151132,5.439219775538104,4.510780224461895,4.9160637406493715,22.222222222222232,0.2517381335959879,5065840.0,-2.083333333333326,0.0,5.356130502042296,5.356130502042296,4.95,5.05,5.3135287171200005,4.2,5.4,0,,1.4283080595961528,964.6740900696216
2012-03-25,4.6,4.7,4.7,4.3,71560.0,29.6,0.1,4.666666666666667,39.52575868817727,-0.05053827566978251,5.446833305094979,4.463166694905021,4.885962432016099,27.272727272727245,0.2623282669105602,4994280.0,-6.122448979591851,-0.021276595744680993,5.702788411099135,5.702788411099135,4.85,5.0,5.297258142777601,4.6,5.4,0,,1.4278484279099088,964.0604906861862
2012-03-26,4.6,4.6,4.7,4.5,69840.0,29.6,0.1,4.633333333333334,39.52575868817726,-0.05091939237225416,5.449878626474875,4.420121373525126,4.858727914681232,27.272727272727245,0.2578762478455202,5064120.0,-6.122448979591851,0.0,5.606005387946092,5.606005387946092,4.824999999999999,4.95,5.257367817066497,4.6,5.4,0,,1.427387188162177,963.432276229739
2012-03-27,4.8,4.6,4.8,4.5,73430.0,29.6,0.1,4.666666666666668,47.10154306408569,-0.03537683240606808,5.448073353880176,4.411926646119825,4.853134779949686,45.45454545454543,0.2608850872851259,5137550.0,-9.433962264150944,0.04347826086956519,5.43510598510679,5.43510598510679,4.824999999999999,4.95,5.2190731043838365,4.6,5.4,0,,1.4269956784252864,963.2310897419621
2012-03-28,4.8,4.8,4.8,4.7,38020.0,29.6,0.1,4.733333333333333,47.10154306408569,-0.02335128887961998,5.446056618805148,4.403943381194852,4.848074324716383,45.45454545454543,0.24939329533618831,5175570.0,-11.11111111111112,0.0,5.195693652837257,5.195693652837257,4.725,4.95,5.182310180208483,4.6,5.4,0,,1.4266022450232665,963.0132292535689
2012-03-29,4.8,4.8,4.9,4.7,37980.0,29.6,0.1,4.8,47.10154306408568,-0.01410731967375748,5.4438320341489765,4.396167965851023,4.843495817600537,45.45454545454543,0.24586520281217486,5213550.0,-9.433962264150944,0.0,5.122191725253643,5.122191725253643,4.725,4.95,5.147017773000144,4.6,5.4,0,,1.4262069079038082,962.7788351610566
2012-03-30,4.9,4.8,4.9,4.7,39070.0,29.6,0.1,4.833333333333335,50.93960739965138,-0.000677451687775249,5.446056618805148,4.403943381194852,4.848877168305248,54.54545454545457,0.24258911689701954,5252620.0,-7.547169811320745,0.02083333333333348,4.950798304020807,4.950798304020807,4.725,4.95,5.113137062080138,4.6,5.4,0,,1.425844068914506,962.7409609997138
2012-03-31,4.9,4.9,4.9,4.8,35530.0,29.6,0.1,4.866666666666667,50.93960739965138,0.008291818355286633,5.446056618805148,4.403943381194852,4.853746009419034,60.00000000000006,0.2324041799758039,5288150.0,-5.769230769230766,0.0,4.742942448485794,4.742942448485794,4.725,4.95,5.080611579596932,4.6,5.4,0,,1.4254791968022296,962.6858230084991
2012-04-01,4.8,4.9,4.9,4.7,35950.0,29.6,0.1,4.866666666666668,46.98588624650484,0.007594422954134344,5.4438320341489765,4.396167965851023,4.848627341855316,50.0,0.23008959569181792,5252200.0,-9.433962264150944,-0.020408163265306256,4.793533243579541,4.793533243579541,4.725,4.95,5.0493871164130555,4.6,5.4,0,,1.4250780429650747,962.4012641424235
2012-04-02,5.0,4.8,5.1,4.8,80660.0,29.6,0.1,4.900000000000001,54.57902856941569,0.020002697465491333,5.400883050729359,4.409116949270642,4.863043785488143,87.50000000000004,0.2350831959995452,5332860.0,6.382978723404251,0.04166666666666674,4.701663919990904,4.701663919990904,4.7749999999999995,4.95,4.3,4.6,5.4,0,,1.424742798629086,962.5203505147903
2012-04-03,4.9,5.0,5.0,4.8,78480.0,29.6,0.1,4.900000000000001,50.67111305157194,0.020784000386451063,5.320908153701718,4.439091846298282,4.866563424965463,75.00000000000009,0.2325772534281491,5254380.0,2.0833333333333446,-0.019999999999999907,4.746474559758145,4.746474559758145,4.824999999999999,4.85,4.316,4.6,5.4,0,,1.4243719510708988,962.4142379071684
2012-04-04,4.9,4.9,5.0,4.9,51040.0,29.6,0.1,4.9333333333333345,50.67111305157194,0.020571181016977615,5.256988664826416,4.463011335173585,4.869747860683038,75.00000000000009,0.22310744961185272,5305420.0,2.0833333333333446,0.0,4.5532132573847495,4.5532132573847495,4.824999999999999,4.8,4.3316799999999995,4.6,5.4,0,,1.4239991509547187,962.291396931738
2012-04-05,4.9,4.9,4.9,4.9,33810.0,29.6,0.1,4.9,50.67111305157194,0.0196995355155649,5.182928563990611,4.49707143600939,4.872629016808463,75.00000000000009,0.2071712032110061,5339230.0,4.255319148936174,0.0,4.227983739000124,4.227983739000124,4.875,4.65,4.3470464,4.6,5.4,0,,1.42362441797363,962.1519609593453
2012-04-06,4.9,4.9,5.0,4.9,58210.0,29.6,0.1,4.9,50.67111305157194,0.01841574442949997,5.12748966924618,4.52251033075382,4.875235777112419,75.00000000000009,0.19951611726736276,5397440.0,4.255319148936174,0.0,4.071757495252301,4.071757495252301,4.875,4.65,4.362105472,4.6,5.4,0,,1.4232477716441034,961.9960631397138
2012-04-07,4.7,4.9,4.9,4.7,80950.0,29.6,0.1,4.833333333333335,42.487433870610076,0.004135420955448121,5.009242852857841,4.580757147142159,4.858546655482665,50.00000000000006,0.199550680319694,5316490.0,0.0,-0.04081632653061229,4.2457591557381695,4.2457591557381695,4.875,4.65,4.37686336256,4.6,5.4,0,,1.4228006483892104,961.3987404736453
2012-04-08,4.8,4.7,4.8,4.6,41970.0,29.6,0.1,4.800000000000001,47.08883566683159,0.0015935946033359544,5.009761769635618,4.590238230364382,4.852970783531935,50.0,0.19958277458257304,5358460.0,4.347826086956526,0.02127659574468077,4.157974470470272,4.157974470470272,4.85,4.75,4.3913260953088,4.6,5.4,0,,1.4223865749592906,961.0017313109175
2012-04-09,4.9,4.8,4.9,4.7,39240.0,29.6,0.1,4.800000000000002,51.28608820889344,0.0065388454478699475,5.01924285285784,4.5907571471421615,4.857449756528894,66.66666666666677,0.19961257639810356,5397700.0,6.521739130434799,0.02083333333333348,4.073726048940888,4.073726048940888,4.85,4.75,4.405499573402624,4.6,5.4,0,,1.4220046327653542,960.7992610570466
2012-04-10,4.8,4.9,4.9,4.8,53100.0,29.6,0.1,4.833333333333335,47.24962642674732,0.003139176894583137,5.01924285285784,4.5907571471421615,4.851978351145189,40.000000000000036,0.19249739236966762,5344600.0,0.0,-0.020408163265306256,4.010362341034742,4.010362341034742,4.85,4.800000000000001,4.419389581934571,4.6,5.4,0,,1.4215870829668702,960.3716434934834
2012-04-11,4.9,4.8,5.0,4.8,67040.0,29.6,0.1,4.866666666666667,51.37134391291015,0.007443668718344065,5.027367605817518,4.602632394182483,4.856551841512315,60.00000000000014,0.19303329291469137,5411640.0,2.0833333333333446,0.02083333333333348,3.9394549574426807,3.9394549574426807,4.824999999999999,4.800000000000001,4.43300179029588,4.6,5.4,0,,1.4212015909676228,960.1381170622273
2012-04-12,4.9,4.9,4.9,4.8,46370.0,29.6,0.1,4.866666666666668,51.37134391291015,0.009952598429337867,5.033566536147733,4.6164334638522675,4.860689761368285,60.00000000000014,0.18638805770649916,5458010.0,2.0833333333333446,0.0,3.803837912377533,3.803837912377533,4.8,4.800000000000001,4.446341754489962,4.6,5.4,0,,1.4208142973629314,959.8889255843467
2012-04-13,4.9,4.9,4.9,4.7,93110.0,29.6,0.1,4.9,51.37134391291015,0.011181898367583577,5.037731349328768,4.632268650671232,4.864433593618925,60.00000000000014,0.1873603392988921,5551120.0,0.0,0.0,3.8236803938549406,3.8236803938549406,4.8,4.85,4.459414919400163,4.6,5.4,0,,1.4204252204901175,959.6242001507616
2012-04-14,5.0,4.9,5.0,4.9,63890.0,29.6,0.1,4.9333333333333345,55.69507555883487,0.01790098979425639,5.039119526397014,4.6708804736029865,4.877344679940932,80.00000000000007,0.18112031506325693,5615010.0,2.0408163265306047,0.020408163265306145,3.622406301265139,3.622406301265139,4.75,4.85,4.47222662101216,4.6,5.4,0,,1.4200672524462379,959.5477229025628
2012-04-15,5.0,5.0,5.0,4.9,33340.0,29.6,0.1,4.966666666666668,55.69507555883487,0.021286183937075997,5.028297097169708,4.721702902830292,4.8890261389941765,80.00000000000007,0.17532600684445285,5648350.0,4.1666666666666705,0.0,3.5065201368890566,3.5065201368890566,4.75,4.85,4.484782088591917,4.6,5.4,0,,1.4197073798074409,959.4550136648609
2012-04-16,4.9,5.0,5.0,4.9,31160.0,29.6,0.1,4.966666666666668,50.488759480255666,0.01597401647925439,5.029666295473158,4.730333704526842,4.890071268613779,75.00000000000011,0.16994557778413477,5617190.0,-1.9999999999999927,-0.019999999999999907,3.4682770976354034,3.4682770976354034,4.75,4.85,4.497086446820078,4.9,5.4,0,,1.4193128529458967,959.1431443311548
2012-04-17,5.0,4.9,5.0,4.9,30650.0,29.6,0.1,4.966666666666668,55.01716432378326,0.01821610861088989,5.043622914959513,4.7363770850404885,4.900540671602943,100.0,0.16494946508526795,5647840.0,2.0408163265306047,0.020408163265306145,3.2989893017053586,3.2989893017053586,4.7749999999999995,4.85,4.509144717883677,4.9,5.4,0,,1.418949331269296,959.01896918599
2012-04-18,5.1,5.0,5.2,5.0,79130.0,29.6,0.1,5.000000000000001,59.05058756466648,0.0250340119321827,5.077916164659803,4.732083835340197,4.919536798116948,83.33333333333326,0.16745307472203455,5726970.0,4.0816326530612095,0.020000000000000018,3.283393622000678,3.283393622000678,4.85,4.85,4.520961823526004,4.9,5.4,0,,1.418615977109368,959.0773754701704
2012-04-19,5.1,5.1,5.2,5.1,46680.0,29.6,0.1,5.066666666666667,59.05058756466648,0.0279237153419854,5.107613602844283,4.722386397155717,4.936723769724858,83.33333333333326,0.16263499795617498,5773650.0,4.0816326530612095,0.0,3.1889215285524504,3.1889215285524504,4.85,4.85,4.548123350584963,4.9,5.4,0,,1.4182806396083893,959.1191787719481
2012-04-20,5.3,5.1,5.5,5.1,104070.0,29.6,0.1,5.166666666666667,66.10098243758156,0.040899705089276005,5.190147016444742,4.679852983555259,4.971321505941538,77.77777777777776,0.17958964095930538,5877720.0,8.163265306122437,0.03921568627450989,3.3884837916850077,3.3884837916850077,5.05,4.9,4.574198416561565,4.9,5.3,0,,1.418005331327913,959.529057616553
2012-04-21,5.3,5.3,5.5,5.1,60920.0,29.6,0.1,5.233333333333334,66.10098243758156,0.046660609420115864,5.252574776767668,4.667425223232332,5.002624219661391,77.77777777777776,0.19533323803364075,5938640.0,12.765957446808502,0.0,3.685532793087561,3.685532793087561,5.05,4.9,4.629746511567871,4.9,5.3,0,,1.4177277833203399,959.9210919034141
2012-04-22,5.2,5.3,5.3,5.1,37110.0,29.6,0.1,5.2666666666666675,60.100537010730804,0.04110912651778556,5.280483493926247,4.659516506073753,5.021421913026973,62.500000000000014,0.195666578174095,5901530.0,8.333333333333341,-0.01886792452830177,3.762818811040288,3.762818811040288,5.125,4.9,4.681961720873798,4.9,5.3,0,,1.4174174148621284,960.1053011405826
2012-04-23,5.0,5.2,5.2,5.0,49370.0,29.6,0.1,5.166666666666668,50.27147863675051,0.022282813965572787,5.2840307428083,4.6659692571916995,5.019381730833929,37.499999999999986,0.1959761083045168,5852160.0,2.0408163265306047,-0.03846153846153855,3.9195221660903363,3.9195221660903363,5.125,4.9,4.73104401762137,4.9,5.3,0,,1.4170420836174715,959.8817679740979
2012-04-24,5.1,5.0,5.2,4.9,70990.0,29.6,0.1,5.1000000000000005,54.296240381274394,0.015217513882915708,5.296608729018699,4.673391270981302,5.027059661230697,49.99999999999994,0.20340638628276558,5923150.0,6.2499999999999964,0.020000000000000018,3.988360515348345,3.988360515348345,5.125,4.9,4.777181376564088,4.9,5.3,0,,1.4166967266615134,959.8401078287912
2012-04-25,5.1,5.1,5.2,5.0,35640.0,29.6,0.1,5.066666666666667,54.296240381274394,0.00947771309859826,5.307889756944276,4.682110243055725,5.034006360161107,49.99999999999994,0.2031630729768538,5958790.0,4.0816326530612095,0.0,3.9835896662128194,3.9835896662128194,5.125,4.9,4.820550493970242,4.9,5.3,0,,1.4163494994726482,959.7825557944726
2012-04-26,5.1,5.1,5.2,5.0,57360.0,29.6,0.1,5.1,54.29624038127441,0.004847997811679425,5.317889756944275,4.692110243055726,5.040291468717192,49.99999999999994,0.20293713919279283,6016150.0,4.0816326530612095,0.0,3.9791595920155456,3.9791595920155456,5.125,4.9,4.861317464332028,4.9,5.3,0,,1.4160004200819485,959.7092308687066
2012-04-27,5.1,5.1,5.1,5.0,25870.0,29.6,0.1,5.1,54.29624038127441,0.0011457103665201626,5.306957443598578,4.743042556401423,5.045977995506031,33.333333333333236,0.1955844863933076,6042020.0,4.0816326530612095,0.0,3.834989929280542,3.834989929280542,5.125,4.9,4.899638416472106,4.9,5.3,0,,1.4156495063645314,959.6202519018105
2012-04-28,5.0,5.1,5.1,4.8,91590.0,29.6,0.1,5.066666666666667,48.965765378042185,-0.008165580936516884,5.297868788563124,4.772131211436876,5.041599138791171,28.57142857142859,0.2030427373652142,5950430.0,0.0,-0.019607843137254832,4.060854747304283,4.060854747304283,5.1,4.9,5.5,4.9,5.3,0,,1.4152652635413505,959.3198685726709
2012-04-29,4.9,5.0,5.0,4.9,22230.0,29.6,0.1,5.000000000000001,44.28382419521157,-0.020485762906244015,5.297868788563124,4.772131211436876,5.0281135065253455,14.285714285714358,0.19568254183912745,5928200.0,-1.9999999999999927,-0.019999999999999907,3.993521262023009,3.993521262023009,5.1,4.9,5.486,4.9,5.3,0,,1.4148472707812534,958.8055298264428
2012-04-30,4.9,4.9,5.0,4.9,55770.0,29.6,0.1,4.9333333333333345,44.28382419521157,-0.02761755737769052,5.288193472921114,4.791806527078886,5.015912220189598,14.285714285714358,0.18884807456490402,5983970.0,0.0,0.0,3.854042338059265,3.854042338059265,5.05,4.9,5.47228,4.9,5.3,0,,1.4144277934833038,958.2778279836774
2012-05-01,5.0,4.9,5.0,4.9,36680.0,29.6,0.1,4.9333333333333345,49.84558079202625,-0.02467879824857177,5.285624188311656,4.8043758116883435,5.014396770647732,28.57142857142859,0.1825017835245537,6020650.0,0.0,0.020408163265306145,3.6500356704910737,3.6500356704910737,5.025,4.9,5.4588344,4.9,5.3,0,,1.4140388451918706,957.9355877252019
2012-05-02,5.1,5.0,5.2,5.0,95960.0,29.6,0.1,5.000000000000001,54.71391251674364,-0.015525817858064436,5.287163735326263,4.822836264673739,5.022549459157472,42.85714285714282,0.18375165612994276,6116610.0,0.0,0.020000000000000018,3.602973649606721,3.602973649606721,5.025,4.9,5.445657712,4.9,5.3,0,,1.4136796093002526,957.7736852518136
2012-05-03,5.1,5.1,5.2,5.0,35420.0,29.6,0.1,5.066666666666667,54.713912516743655,-0.00930407822936083,5.286585198063051,4.843414801936948,5.029925701142474,42.85714285714282,0.18491225212066115,6152030.0,0.0,0.0,3.625730433738454,3.625730433738454,5.025,4.9,5.43274455776,4.9,5.3,0,,1.4133186408620197,957.5968431860007
2012-05-04,5.1,5.1,5.2,5.1,43630.0,29.6,0.1,5.1,54.713912516743655,-0.005224531518554336,5.290000000001457,4.849999999998542,5.03659944389081,42.85714285714282,0.17884709125489967,6195660.0,-3.7735849056603805,0.0,3.506805710880386,3.506805710880386,5.05,4.9,5.420089666604801,4.9,5.3,0,,1.4129559567133305,957.4051788196684
2012-05-05,5.1,5.1,5.1,5.0,18840.0,29.6,0.1,5.1,54.713912516743655,-0.0026896186430794555,5.292944947178504,4.857055052821496,5.042637592091685,59.999999999999964,0.17321515616526395,6214500.0,-3.7735849056603805,0.0,3.3963756110836076,3.3963756110836076,5.05,4.9,5.407687873272705,4.9,5.3,0,,1.4125915735457482,957.1988092184746
2012-05-06,5.1,5.1,5.1,5.0,19300.0,29.6,0.1,5.1,54.713912516743655,-0.001249606467794949,5.287731349328711,4.882268650671289,5.048100678559144,74.99999999999989,0.16798550215345934,6233800.0,-1.9230769230769333,0.0,3.2938333755580267,3.2938333755580267,5.05,4.9,5.3955341158072505,4.9,5.3,0,,1.4122255079076178,956.9778512126303
2012-05-07,5.1,5.1,5.1,5.0,46180.0,29.6,0.1,5.1,54.713912516743655,-0.0005684965514655554,5.288997487422931,4.891002512577069,5.053043471077321,74.99999999999989,0.16312939485678363,6279980.0,1.9999999999999927,0.0,3.19861558542713,3.19861558542713,5.075,4.9,5.383623433491105,4.9,5.3,0,,1.4118577762054012,956.7424213877275
2012-05-08,5.1,5.1,5.1,5.0,68200.0,29.6,0.1,5.1,54.713912516743655,-0.0003974610573283313,5.288997487422931,4.891002512577069,5.0575155214509095,74.99999999999989,0.15862015236701335,6348180.0,0.0,0.0,3.1101990660198697,3.1101990660198697,5.075,4.9,5.371950964821283,4.9,5.3,0,,1.4114883947050214,956.4926360759046
2012-05-09,5.0,5.1,5.1,5.0,38920.0,29.6,0.1,5.066666666666667,47.04282199989941,-0.006935956780081326,5.287731349328711,4.882268650671289,5.052037852741299,50.0,0.15443299862651236,6309260.0,-1.9607843137254832,-0.019607843137254832,3.0886599725302473,3.0886599725302473,5.1000000000000005,4.9,5.360511945524857,4.9,5.3,0,,1.4110864037022242,956.0362410911554
2012-05-10,4.8,5.0,5.1,4.8,69980.0,29.6,0.1,4.966666666666668,36.13183510290632,-0.023703055867486025,5.273541565042131,4.84645843495787,5.028034247718319,0.0,0.16483064158176147,6239280.0,-5.8823529411764675,-0.040000000000000036,3.433971699620031,3.433971699620031,5.075,4.9,5.34930170661436,4.8,5.3,0,,1.410619181564454,955.1709469181823
2012-05-11,5.0,4.8,5.0,4.8,63130.0,29.6,0.1,4.9333333333333345,48.896419538088985,-0.020421196756376523,5.229119526396968,4.860880473603032,5.0253643193641935,50.0,0.16734273861163568,6302410.0,-1.9607843137254832,0.04166666666666674,3.3468547722327138,3.3468547722327138,5.075,4.9,5.338315672482073,4.8,5.3,0,,1.4102144507131467,954.6896358377559
2012-05-12,4.9,5.0,5.0,4.9,20880.0,29.6,0.1,4.900000000000001,44.14564128038723,-0.023843834644031305,5.210000000001792,4.849999999998208,5.013424860377127,25.00000000000011,0.16253254299651881,6281530.0,-1.9999999999999927,-0.019999999999999907,3.316990673398343,3.316990673398343,5.075,4.9,5.327549359032432,4.8,5.3,0,,1.4097768186221689,954.0003162081986
2012-05-13,4.9,4.9,5.0,4.9,14050.0,29.6,0.1,4.9333333333333345,44.14564128038723,-0.02485318972507626,5.2134144368158815,4.836585563184119,5.002622492722163,25.00000000000011,0.15806593278248174,6295580.0,0.0,0.0,3.2258353629077905,3.2258353629077905,5.05,4.9,5.316998371851783,4.8,5.3,0,,1.4093378999241306,953.2992264776873
2012-05-14,5.0,4.9,5.0,4.9,52850.0,29.6,0.1,4.9333333333333345,49.802076532032295,-0.017858622006333334,5.205472369911655,4.834527630088344,5.002372731510529,50.0,0.15391836615516158,6348430.0,2.0408163265306047,0.020408163265306145,3.0783673231032314,3.0783673231032314,5.05,4.9,5.306658404414748,4.8,5.3,0,,1.4089290673516683,952.7807570076875
2012-05-15,5.0,5.0,5.0,4.9,44140.0,29.6,0.1,4.966666666666668,49.802076532032295,-0.012555080306013152,5.196934053988379,4.8330659460116205,5.002146757080955,50.0,0.15006705428693573,6392570.0,0.0,0.0,3.0013410857387144,3.0013410857387144,5.05,4.9,5.296525236326453,4.8,5.3,0,,1.4085188323523836,952.2497001560387
2012-05-16,5.1,5.0,5.1,5.0,69370.0,29.6,0.1,5.033333333333334,55.07817083034181,-0.002179079423625204,5.196934053988379,4.8330659460116205,5.011466113549435,74.99999999999989,0.14649083612358313,6461940.0,0.0,0.020000000000000018,2.8723693357565323,2.8723693357565323,5.05,5.0,5.286594731599924,4.8,5.3,0,,1.4081378530383701,951.8959244573567
2012-05-17,5.1,5.1,5.1,5.1,26620.0,29.6,0.1,5.066666666666667,55.07817083034181,0.0044555136734570795,5.196934053988379,4.8330659460116205,5.019897912259013,74.99999999999989,0.13602720497189863,6488560.0,0.0,0.0,2.6672000974882084,2.6672000974882084,5.0,5.0,5.276862836967926,4.8,5.3,0,,1.407755360287706,951.5288316103974
2012-05-18,5.1,5.1,5.1,5.1,52580.0,29.6,0.1,5.1,55.07817083034181,0.008387113503610068,5.205472369911655,4.834527630088344,5.027526682520059,100.0,0.12631097604533445,6541140.0,0.0,0.0,2.47668580481048,2.47668580481048,4.975,5.05,5.267325580228567,4.8,5.3,0,,1.4073713690514664,951.1485345943537
2012-05-19,5.1,5.1,5.1,5.1,23160.0,29.6,0.1,5.1,55.07817083034181,0.010399312631763344,5.210000000001792,4.849999999998208,5.034428903232435,100.0,0.1172887634706677,6564300.0,0.0,0.0,2.2997796758954454,2.2997796758954454,4.975,5.05,5.257979068623996,4.8,5.3,0,,1.4069858941538265,950.7551460537928
2012-05-20,5.1,5.1,5.2,5.1,18690.0,29.6,0.1,5.1,55.07817083034181,0.011079283644521121,5.212046505342725,4.867953494657275,5.04067376959125,74.99999999999989,0.11605385179419148,6582990.0,0.0,0.0,2.275565721454735,2.275565721454735,5.025,5.05,5.248819487251516,4.8,5.3,0,,1.4065989502932406,950.348778291927
2012-05-21,5.1,5.1,5.1,5.1,33620.0,29.6,0.1,5.1,55.07817083034181,0.010863342751474887,5.217916164659767,4.8720838353402325,5.0463238867730364,74.99999999999989,0.10776429095174923,6616610.0,0.0,0.0,2.113025312779397,2.113025312779397,5.025,5.05,5.239843097506485,4.8,5.3,0,,1.406210552043614,949.9295432640703
2012-05-22,5.1,5.1,5.1,5.1,46680.0,29.6,0.1,5.1,55.07817083034181,0.010072421855449015,5.217916164659767,4.8720838353402325,5.051435897556557,74.99999999999989,0.10006684159805286,6663290.0,0.0,0.0,1.9620949332951543,1.9620949332951543,5.025,5.05,5.231046235556356,4.8,5.3,0,,1.4058207138554435,949.4975525711494
2012-05-23,5.1,5.1,5.2,5.1,52960.0,29.6,0.1,5.1,55.07817083034181,0.0089396189262229,5.217916164659767,4.8720838353402325,5.056061050170218,74.99999999999989,0.10006206719819198,6716250.0,1.9999999999999927,0.0,1.9620013176116076,1.9620013176116076,5.025,5.05,5.222425310845229,4.8,5.3,0,,1.4054294500569697,949.0529174535117
2012-05-24,5.1,5.1,5.2,5.1,28920.0,29.6,0.1,5.1,55.07817083034181,0.00763153916352971,5.217916164659767,4.8720838353402325,5.0602457120587685,74.99999999999989,0.10005763382689259,6745170.0,6.2499999999999964,0.0,1.9619143887625998,1.9619143887625998,5.05,5.05,5.213976804628325,4.8,5.3,0,,1.4050367748552928,948.5957487847553
2012-05-25,5.2,5.1,5.2,5.1,23080.0,29.6,0.1,5.133333333333334,62.71368680981446,0.012646543540265707,5.234390889147601,4.865609110852397,5.073555644243648,100.0,0.10005351712497172,6768250.0,4.0000000000000036,0.019607843137255054,1.9241060985571483,1.9241060985571483,5.075,5.05,5.205697268535758,4.8,5.3,0,,1.4046723423048981,948.3093786367762
2012-05-26,5.1,5.2,5.2,5.1,16590.0,29.6,0.1,5.133333333333334,53.01025165899191,0.008569482946376428,5.234390889147602,4.865609110852398,5.076074154315681,66.66666666666647,0.10004969447318805,6751660.0,4.0816326530612095,-0.019230769230769384,1.9617587151605502,1.9617587151605502,5.075,5.05,4.8,4.8,5.3,0,,1.4042767978257171,947.8268746010544
2012-05-27,5.1,5.1,5.2,5.1,15750.0,29.6,0.1,5.133333333333334,53.01025165899191,0.005369653221526018,5.234390889147602,4.865609110852398,5.078352806285617,66.66666666666647,0.10004614486796037,6767410.0,4.0816326530612095,0.0,1.9616891150580467,1.9616891150580467,5.075,5.05,4.808,4.8,5.3,0,,1.4038798841806075,947.3321672873182
2012-05-28,5.1,5.1,5.2,5.1,27560.0,29.6,0.1,5.1,53.01025165899191,0.002875156646387704,5.234390889147602,4.865609110852398,5.0804144437822245,66.66666666666647,0.10004284880596324,6794970.0,1.9999999999999927,0.0,1.961624486391436,1.961624486391436,5.075,5.05,4.81584,4.8,5.3,0,,1.4034816151014982,946.8253660738314
2012-05-29,5.2,5.1,5.2,5.0,61270.0,29.6,0.1,5.133333333333334,60.62033249542199,0.007328728175527648,5.253907194298309,4.86609280570169,5.091803544374394,100.0,0.10718264531982302,6856240.0,4.0000000000000036,0.019607843137255054,2.0612047176889043,2.0612047176889043,5.05,5.05,4.8235231999999995,4.8,5.2,0,,1.4031114660762898,946.4885150158649
2012-05-30,5.1,5.2,5.2,5.1,39940.0,29.6,0.1,5.133333333333334,51.617700676735886,0.003123514189752888,5.228297097169649,4.921702902830352,5.09258415919588,49.99999999999978,0.10666959922554999,6816300.0,0.0,-0.019230769230769384,2.0915607691284315,2.0915607691284315,5.05,5.1,4.831052735999999,5.1,5.2,0,,1.4027104393036138,945.9572507864216
2012-05-31,5.2,5.1,5.2,5.1,39480.0,29.6,0.1,5.166666666666668,58.28868261725621,0.006467999100573527,5.2434297951795665,4.926570204820433,5.102814239272463,100.0,0.10619319928086789,6855780.0,1.960784313725501,0.019607843137255054,2.0421769092474595,2.0421769092474595,5.05,5.1,4.8384316812799995,5.1,5.2,0,,1.402337471549443,945.595518749899
2012-06-01,5.3,5.2,5.3,5.2,44690.0,29.6,0.1,5.2,63.68150144524998,0.014354423713991274,5.26593476939629,4.944065230603709,5.121593835532228,100.0,0.10575082790366301,6900470.0,3.921568627450984,0.019230769230769162,1.995298639691755,1.995298639691755,5.1,5.1,4.8456630476544,5.1,5.2,0,,1.4019918424961666,945.3988051392441
2012-06-02,5.3,5.3,5.3,5.2,15170.0,29.6,0.1,5.2666666666666675,63.68150144524998,0.01825974571405689,5.278297097169631,4.971702902830369,5.138584898814873,100.0,0.10534005448197277,6915640.0,3.921568627450984,0.0,1.9875481977730713,1.9875481977730713,5.1,5.1,4.863836525748224,5.1,5.2,0,,1.4016446669284908,945.1888079131586
2012-06-03,5.2,5.3,5.3,5.2,12680.0,29.6,0.1,5.266666666666667,55.37787875927086,0.013041682254548909,5.280258390465522,4.9897416095344775,5.1444339560706,66.66666666666677,0.10495862201897468,6902960.0,1.960784313725501,-0.01886792452830177,2.018435038826436,2.018435038826436,5.1,5.1,4.8812830647182945,5.1,5.2,0,,1.4012672741022643,944.7885767851049
2012-06-04,5.3,5.2,5.3,5.2,51240.0,29.6,0.1,5.2666666666666675,60.872315124094705,0.015112605178931003,5.298323969744046,5.001676030255955,5.159249769778162,100.0,0.10460443473190505,6954200.0,3.921568627450984,0.019230769230769162,1.9736685798472648,1.9736685798472648,5.1,5.15,4.898031742129563,5.1,5.2,0,,1.4009171333746844,944.5528452875358
2012-06-05,5.4,5.3,5.5,5.2,83930.0,29.6,0.1,5.300000000000002,65.45334963968764,0.0216091176716999,5.346934053988336,4.983065946011664,5.182178363132623,80.00000000000007,0.11856126082248324,7038130.0,5.882352941176485,0.018867924528301883,2.19557890412006,2.19557890412006,5.2,5.15,4.9141104724443805,5.1,5.2,1,,1.4005935541248344,944.4773501195289
2012-06-06,5.5,5.4,5.5,5.4,40680.0,29.6,0.1,5.400000000000001,69.32145941798683,0.03048969449791998,5.4154343724374225,4.9545656275625785,5.212447090453326,100.0,0.11723545647802013,7078810.0,7.843137254901968,0.01851851851851838,2.1315537541458203,2.1315537541458203,5.225,5.15,4.949263844097717,5.1,5.2,0,,1.4002958703508435,944.5580601319753
2012-06-07,5.6,5.5,5.6,5.4,48070.0,29.6,0.1,5.5,72.62263874303626,0.04032952996846516,5.499136645897101,4.920863354102899,5.249356891362533,100.0,0.12314720958673293,7126880.0,9.803921568627452,0.018181818181818077,2.199057314048803,2.199057314048803,5.3,5.199999999999999,4.9823080134518545,5.1,5.2,0,,1.4000234393961166,944.7911618594142
2012-06-08,5.6,5.6,5.7,5.6,53840.0,29.6,0.1,5.566666666666667,72.62263874303626,0.0437811042000332,5.565302891299217,4.904697108700782,5.282751473137529,85.71428571428564,0.12149383747339491,7180720.0,7.692307692307682,0.0,2.1695328120249093,2.1695328120249093,5.3500000000000005,5.25,5.031723372375706,5.1,5.2,0,,1.3997491837406473,945.0095283789404
2012-06-09,5.6,5.6,5.7,5.5,37120.0,29.6,0.1,5.6,72.62263874303626,0.04294791683104193,5.620000000000861,4.899999999999139,5.312965618553003,85.71428571428564,0.12710142051100956,7217840.0,9.803921568627452,0.0,2.269668223410885,2.269668223410885,5.375,5.25,5.098551035138136,5.1,5.2,0,,1.3994731190947427,945.213248726633
2012-06-10,5.5,5.6,5.6,5.4,24400.0,29.6,0.1,5.566666666666667,64.0187347193247,0.032993147587411814,5.64660605559731,4.91339394440269,5.33077841678605,71.42857142857142,0.13230846190308027,7193440.0,7.843137254901968,-0.017857142857142794,2.405608398237823,2.405608398237823,5.4,5.25,5.158695931624322,5.1,5.2,0,,1.3991684067889827,945.2363258088044
2012-06-11,5.6,5.5,5.6,5.4,40260.0,29.6,0.1,5.566666666666667,68.090046708402,0.03053132769874614,5.686968585096491,4.923031414903509,5.356418567568331,85.71428571428564,0.13714357176714592,7233700.0,9.803921568627452,0.018181818181818077,2.448992352984749,2.448992352984749,5.4,5.25,5.21282633846189,5.1,5.2,0,,1.3988888492098748,945.4114390497804
2012-06-12,5.7,5.6,5.8,5.5,78980.0,29.6,0.1,5.6000000000000005,71.55607541080282,0.03282540889806987,5.741324993078954,4.928675006921046,5.3891406087522995,85.71428571428578,0.14877617378377833,7312680.0,9.615384615384615,0.017857142857143016,2.610108311996111,2.610108311996111,5.45,5.3,5.261543704615701,5.1,5.2,1,,1.3986338300357306,945.7349701180129
2012-06-13,5.9,5.7,6.0,5.7,57240.0,29.6,0.1,5.733333333333334,76.94886000698907,0.04428708786996288,5.834891291503337,4.915108708496663,5.437793884109223,88.88888888888893,0.15957787565636558,7369920.0,15.686274509803935,0.03508771929824572,2.704709756887552,2.704709756887552,5.55,5.4,5.3261584600618175,5.1,5.2,0,,1.3984281185867014,946.3606297295142
2012-06-14,5.9,5.9,6.0,5.8,35040.0,29.6,0.1,5.833333333333335,76.94886000698907,0.048029527373441516,5.915568986391179,4.904431013608821,5.481813514194059,87.50000000000004,0.16246517025233947,7404960.0,13.461538461538463,0.0,2.7536469534294823,2.7536469534294823,5.6,5.4,5.420496275653163,5.1,5.2,0,,1.3982203360880259,946.970575710942
2012-06-15,6.5,5.9,6.6,5.9,65640.0,29.6,0.1,6.100000000000001,86.11085040243765,0.08491864154411533,6.154091981854551,4.805908018145448,5.578783655699386,92.85714285714288,0.2008605152343152,7470600.0,22.641509433962266,0.10169491525423724,3.0901617728356183,3.0901617728356183,5.9,5.699999999999999,5.5016267970617205,5.1,5.2,0,,1.3981537841322726,948.4545562055685
2012-06-16,6.4,6.5,6.6,6.3,78200.0,29.6,0.1,6.266666666666668,80.37679922779873,0.09578374948347246,6.305197342800269,4.784802657199731,5.6569947361089685,85.71428571428575,0.20794190700329265,7392400.0,20.754716981132088,-0.01538461538461533,3.249092296926447,3.249092296926447,5.9,5.699999999999999,5.677366509531845,5.1,5.2,0,,1.3980616653787765,949.7788711094659
2012-06-17,6.2,6.4,6.5,6.1,48800.0,29.6,0.1,6.366666666666667,70.29490343802654,0.08316787065200151,6.382304288624691,4.81769571137531,5.70870952314621,71.42857142857146,0.22166034221734318,7343600.0,19.23076923076923,-0.03125,3.575166809957148,3.575166809957148,5.9,5.699999999999999,5.82498786800675,5.1,5.2,0,,1.3979201701088042,950.7944013282284
2012-06-18,6.3,6.2,6.4,6.0,46830.0,29.6,0.1,6.300000000000001,72.17427508859815,0.07545165217493227,6.471026960339287,4.838973039660713,5.76502290189419,78.57142857142858,0.2343988892018187,7390430.0,18.867924528301888,0.016129032258064502,3.7206172889177576,3.7206172889177576,5.9,5.699999999999999,5.94898980912567,5.1,5.2,0,,1.3977999228443896,951.940481572661
2012-06-19,6.5,6.3,6.5,6.3,43880.0,29.6,0.1,6.333333333333335,75.5113180159718,0.07742073961298124,6.577936105461932,4.872063894538067,5.83502072076141,91.6666666666667,0.2319418256874031,7434310.0,20.370370370370363,0.031746031746031855,3.5683357798062016,3.5683357798062016,5.9,5.699999999999999,6.0,5.1,5.2,0,,1.3977232382837694,953.3571238610157
2012-06-20,6.7,6.5,6.7,6.4,64069.99999999999,29.6,0.1,6.500000000000001,78.31231811308002,0.08518070881962214,6.716515138991475,4.883484861008527,5.917399699736514,99.99999999999999,0.23680312385258856,7498380.0,21.818181818181824,0.030769230769230882,3.534374982874456,3.534374982874456,5.975,5.75,6.0,5.1,6.7,0,,1.397688477411907,955.0354539549955
2012-06-21,6.7,6.7,6.8,6.6,51940.0,29.6,0.1,6.633333333333334,78.31231811308002,0.0832058232930224,6.83560861636615,4.904391383633849,5.991933061666369,92.85714285714288,0.23417432929168938,7550320.0,19.642857142857153,0.0,3.495139243159543,3.495139243159543,6.075,5.8,6.126,5.1,6.7,0,,1.3976509574311375,956.6966347612254
2012-06-22,6.6,6.7,6.8,6.4,56820.0,29.6,0.1,6.666666666666668,73.44121906270593,0.0686614368938917,6.9133148777364815,4.9566851222635195,6.049844198650524,85.7142857142857,0.24601902005656867,7493500.0,17.857142857142858,-0.014925373134328401,3.7275609099480107,3.7275609099480107,6.1,5.8,6.260800000000001,5.1,6.7,0,,1.3975886764858678,958.2022619120021
2012-06-23,6.4,6.6,6.7,6.4,20120.0,29.6,0.1,6.566666666666667,64.7646226036293,0.04046291194282958,6.9319631796397,5.058036820360298,6.083192370207616,71.42857142857146,0.24987480433824233,7473380.0,14.285714285714299,-0.030303030303030165,3.9042938177850357,3.9042938177850357,6.125,5.8,6.36864,5.1,6.7,0,,1.397478773823942,959.4075869041959
2012-06-24,6.3,6.4,6.5,6.3,33950.0,29.6,0.1,6.4333333333333345,60.890999916949546,0.011473993966470253,6.933763185556497,5.156236814443503,6.103840715902129,64.28571428571426,0.24631231831408215,7439430.0,14.545454545454541,-0.01562500000000011,3.9097193383187645,3.9097193383187645,6.175,5.8,6.8,6.3,6.7,0,,1.3973434648855185,960.4512969661652
2012-06-25,6.3,6.3,6.4,6.2,62640.0,29.6,0.1,6.333333333333335,60.89099991694955,-0.010135065234885832,6.9335638683588385,5.246436131641161,6.122522552482878,61.53846153846153,0.243004295577362,7502070.0,12.500000000000004,0.0,3.8572110409105083,3.8572110409105083,6.175,5.8,6.79,6.3,6.7,0,,1.3972058625788395,961.4786210624278
2012-06-26,6.4,6.3,6.5,6.3,48740.0,29.6,0.1,6.333333333333335,63.42787475873199,-0.019580923091529367,6.943146026408917,5.326853973591082,6.148948976055937,63.63636363636367,0.23993256017897902,7550810.0,12.280701754385968,0.01587301587301604,3.748946252796547,3.748946252796547,6.2,5.8,6.7664,6.3,6.7,0,,1.3970889138155647,962.6345156381087
2012-06-27,6.7,6.4,6.7,6.4,41980.0,29.6,0.1,6.466666666666668,69.76434800385054,-0.008099792860219057,6.994735981549549,5.38526401845045,6.201430025955371,90.00000000000003,0.24422309159476624,7592790.0,13.559322033898303,0.046875,3.645120770071138,3.645120770071138,6.25,5.8,6.743744,6.3,6.7,0,,1.3970362101668616,964.1954969785753
2012-06-28,6.6,6.7,6.7,6.5,42820.0,29.6,0.1,6.566666666666667,65.67936918731546,-0.009612496197621723,7.015628777186942,5.4643712228130585,6.239389071102479,77.77777777777774,0.24106429933799722,7549970.0,11.864406779661005,-0.014925373134328401,3.6524893839090486,3.6524893839090486,6.25,5.8,6.721994240000001,6.3,6.7,0,,1.396959049768183,965.6010767914679
2012-06-29,6.7,6.6,6.7,6.5,26300.0,29.6,0.1,6.666666666666668,67.71518840041398,-0.0064047426881589375,7.0365524256588365,5.553447574341163,6.283256778616527,87.50000000000004,0.23813113509956887,7576270.0,3.0769230769230793,0.015151515151515138,3.5541960462622217,3.5541960462622217,6.25,5.8,6.701114470400001,6.3,6.7,0,,1.3969011778458407,967.1283734824041
2012-06-30,6.7,6.7,6.7,6.6,20590.0,29.6,0.1,6.666666666666668,67.71518840041398,-0.006773622694687842,7.019755594185184,5.690244405814815,6.322946609224477,87.50000000000004,0.22826462544959972,7596860.0,4.687499999999997,0.0,3.406934708202981,3.406934708202981,6.25,5.8,6.2,6.3,6.7,0,,1.3968407190293186,968.6388017393267
2012-07-01,6.6,6.7,6.7,6.5,20580.0,29.6,0.1,6.666666666666667,63.35660640241737,-0.01573125792413077,6.979369219231402,5.830630780768597,6.349332646441193,74.99999999999997,0.22624572363177117,7576280.0,6.451612903225798,-0.014925373134328401,3.427965509572291,3.427965509572291,6.275,5.8,6.21,6.3,6.7,0,,1.39675595393117,969.9937997160592
2012-07-02,6.8,6.6,6.8,6.6,32360.0,29.6,0.1,6.7,67.81814705643306,-0.010421430630723538,6.9595998398723555,5.960400160127643,6.392253346780127,100.0,0.2243710290866447,7608640.0,7.936507936507936,0.030303030303030276,3.2995739571565394,3.2995739571565394,6.3,5.85,6.2198,6.3,6.7,0,,1.3967118248154746,971.6073177561905
2012-07-03,6.4,6.8,6.8,6.4,71070.0,29.6,0.1,6.600000000000001,53.728282863847326,-0.03471422989762196,6.91523249528654,6.054767504713462,6.392991123277257,33.333333333333385,0.23691595558045572,7537570.0,-1.538461538461533,-0.05882352941176461,3.7018118059446206,3.7018118059446206,6.3,5.85,6.243008000000001,6.3,6.7,0,,1.3965776870694602,972.6449534506967
2012-07-04,6.5,6.4,6.6,6.4,33480.0,29.6,0.1,6.566666666666667,56.17939910718532,-0.04429996065408803,6.8513034344167165,6.178696565583285,6.4031824448699,50.0,0.23427910161042312,7571050.0,-2.9850746268656745,0.015625,3.604293870929586,3.604293870929586,6.324999999999999,5.85,6.26528768,6.3,6.7,0,,1.396463634077499,973.8093067002685
2012-07-05,6.7,6.5,6.8,6.5,45350.0,29.6,0.1,6.533333333333334,60.667053952288256,-0.03768235099249795,6.870687720349562,6.179312279650438,6.43145078345372,83.33333333333339,0.2389734514953929,7616400.0,0.0,0.030769230769230882,3.566767932767058,3.566767932767058,6.35,5.85,6.2866761728,6.3,6.7,0,,1.3963908303380048,975.2366799075775
2012-07-06,6.7,6.7,6.7,6.6,43190.0,29.6,0.1,6.633333333333334,60.667053952288256,-0.03393335456454627,6.8887119154839365,6.191288084516065,6.45702689931527,83.33333333333339,0.22904677638857915,7659590.0,1.5151515151515234,0.0,3.418608602814614,3.418608602814614,6.35,5.9,6.307209125888,6.3,6.7,0,,1.3963155495190525,976.6473925206038
2012-07-07,6.8,6.7,6.9,6.6,37990.0,29.6,0.1,6.733333333333334,62.87192369413364,-0.02571977056401123,6.899241552663804,6.240758447336197,6.4896910041423865,85.71428571428564,0.23411486378939497,7697580.0,6.249999999999992,0.014925373134328401,3.442865643961691,3.442865643961691,6.425000000000001,5.95,6.32692076085248,6.3,6.7,0,,1.3962590433732065,978.1781526463126
2012-07-08,6.8,6.8,6.9,6.7,18220.0,29.6,0.1,6.766666666666668,62.87192369413364,-0.021461585034103975,6.914217793990982,6.275782206009019,6.519244241843111,85.71428571428564,0.23167808780443822,7715800.0,7.936507936507936,0.0,3.4070307030064444,3.4070307030064444,6.4750000000000005,5.95,6.361305515201331,6.3,6.7,0,,1.39620000627664,979.6922064102458
2012-07-09,7.0,6.8,7.1,6.7,61640.0,29.6,0.1,6.866666666666667,67.14401316309713,-0.0070933397015208455,6.981109401706001,6.258890598293999,6.56503050452472,87.50000000000004,0.24370108153269257,7777440.0,11.111111111111114,0.02941176470588247,3.4814440218956086,3.4814440218956086,6.6,6.05,6.393627184289251,6.3,6.7,0,,1.39617988522745,981.4572325486563
2012-07-10,7.2,7.0,7.3,7.0,70070.0,29.6,0.1,7.0,70.76647456986252,0.012874655244252575,7.085340777126606,6.204659222873395,6.62550378980808,88.88888888888893,0.24772243285178594,7847510.0,12.499999999999996,0.028571428571428692,3.4405893451636937,3.4405893451636937,6.725,6.15,6.450137009546111,6.3,6.7,0,,1.3961972995685226,983.4658037564543
2012-07-11,7.2,7.2,7.3,7.0,41890.0,29.6,0.1,7.133333333333334,70.76647456986252,0.022512832764684187,7.172394267483676,6.167605732516324,6.680217714588263,88.88888888888893,0.2514565447909441,7889400.0,7.462686567164178,0.0,3.492452010985334,3.492452010985334,6.75,6.15,6.5351233085915,6.3,6.7,0,,1.396211894184091,985.4576067313754
2012-07-12,7.8,7.2,7.9,7.1,64620.00000000001,29.6,0.1,7.400000000000001,78.87142118557392,0.06341051864362474,7.431712191714275,6.028287808285724,6.786863646532238,93.3333333333333,0.2906382201630196,7954020.0,18.181818181818183,0.08333333333333326,3.7261310277310207,3.7261310277310207,7.050000000000001,6.45,6.61161097773235,6.3,6.7,0,,1.3963376013217814,988.173898901525
2012-07-13,7.7,7.8,7.8,7.4,65470.0,29.6,0.1,7.566666666666667,75.13263179983684,0.0769402444193869,7.596186619958448,5.9938133800415505,6.873829013529168,86.66666666666664,0.29844977586566096,7888550.0,14.925373134328357,-0.012820512820512775,3.8759711151384537,3.8759711151384537,7.075,6.45,6.766217660404468,6.3,6.7,0,,1.3964417119102885,990.7544037680545
2012-07-14,7.5,7.7,7.7,7.5,16010.000000000002,29.6,0.1,7.666666666666668,68.17224158193562,0.06604988366378595,7.678346828499653,6.031653171500349,6.933464345574009,73.33333333333331,0.2914176490181138,7872540.0,11.940298507462684,-0.025974025974025983,3.885568653574851,3.885568653574851,7.15,6.45,6.902271541155932,7.5,6.7,0,,1.3965053140396704,993.0741579123865
2012-07-15,7.6,7.5,7.7,7.4,26980.0,29.6,0.1,7.6000000000000005,69.6844946888693,0.05941913457220788,7.762852300228473,6.077147699771527,6.996943931709818,79.99999999999996,0.2920306740882485,7899520.0,15.151515151515152,0.013333333333333197,3.8425088695822174,3.8425088695822174,7.15,6.45,7.021998956217221,7.5,6.7,0,,1.396584703934581,995.5004887432041
2012-07-16,8.5,7.6,8.6,7.6,103400.0,29.6,0.1,7.866666666666667,79.24330478475011,0.1067245252006076,8.079277003448532,5.970722996551468,7.140092128689835,95.45454545454547,0.3425999116533736,8002920.0,25.000000000000007,0.11842105263157898,4.030587195922043,4.030587195922043,7.525,6.8,7.1273590814711545,7.5,6.7,1,,1.3968194355100345,998.952921067285
2012-07-17,8.8,8.5,9.5,7.3,210800.0,29.6,0.1,8.3,81.35383674411734,0.14682237147194882,8.424758664771318,5.835241335228683,7.2981785926241365,77.4193548387097,0.4752713465352755,8213720.0,37.50000000000001,0.03529411764705892,5.4008107560826755,5.4008107560826755,7.975,7.25,8.6,7.5,6.7,1,,1.3970995025338055,1002.7150712905918
2012-07-18,9.1,8.8,9.4,8.5,105950.0,29.6,0.1,8.800000000000002,83.19410087194457,0.17996603532983307,8.782710705598541,5.72728929440146,7.469780631421838,86.66666666666664,0.5056091074970416,8319670.0,40.0,0.03409090909090895,5.556144038429029,5.556144038429029,8.05,7.25,7.3,7.5,9.1,0,,1.3974230147878914,1006.7779859987301
2012-07-19,8.9,9.1,9.2,8.8,48250.0,29.6,0.1,8.933333333333335,77.68925623741296,0.17469449584239127,9.027858983798799,5.7021410162012,7.605991999857853,79.31034482758622,0.49806559981868137,8271420.0,32.83582089552239,-0.0219780219780219,5.5962426945919255,5.5962426945919255,8.05,7.25,7.3,7.5,9.1,0,,1.397711174536356,1010.6198905415786
2012-07-20,8.5,8.9,8.9,7.6,154660.0,29.6,0.1,8.833333333333334,67.99832664679298,0.13245969707837763,9.158496404457717,5.7515035955422835,7.691135618919009,65.51724137931035,0.5553466284030614,8116760.0,26.86567164179104,-0.0449438202247191,6.533489745918369,6.533489745918369,8.075,7.3,7.342,7.5,9.1,1,,1.3979307413932855,1014.0155562139565
2012-07-21,8.9,8.5,9.7,8.0,139910.0,29.6,0.1,8.766666666666667,71.78816351133163,0.12002329004869206,9.336465397340223,5.803534602659776,7.806265559974341,73.33333333333337,0.6371075835171284,8256670.0,30.882352941176478,0.04705882352941182,7.158512174349757,7.158512174349757,8.25,7.3999999999999995,7.383159999999999,7.5,9.1,1,,1.398211346070118,1017.8305420348108
2012-07-22,8.4,8.9,9.0,8.3,30070.0,29.6,0.1,8.600000000000001,61.91731200559648,0.06920641988185394,9.414652940382428,5.885347059617573,7.862811697119642,56.66666666666669,0.6415998989801907,8226600.0,23.52941176470589,-0.0561797752808989,7.63809403547846,7.63809403547846,8.275,7.449999999999999,7.4758336,7.5,9.1,0,,1.3984069781281985,1021.0851050216744
2012-07-23,8.4,8.4,9.2,7.8,146400.0,29.6,0.1,8.566666666666668,61.91731200559648,0.02874841975772624,9.445287586222566,6.054712413777434,7.913972487870152,51.851851851851876,0.69577133476732,8373000.0,20.000000000000004,0.0,8.282992080563332,8.282992080563332,8.275,7.449999999999999,7.564800256,7.5,9.1,0,,1.3985991396518418,1024.3245026298425
2012-07-24,8.6,8.4,8.9,8.3,40950.0,29.6,0.1,8.466666666666667,64.2008282835624,0.009602043211586087,9.48653302142504,6.223466978574959,7.979308441406327,59.25925925925927,0.6889305251410828,8413950.0,19.444444444444436,0.023809523809523725,8.010820059780032,8.010820059780032,8.275,7.449999999999999,7.65020824576,7.5,9.1,0,,1.3988207832937511,1027.772153167527
2012-07-25,8.8,8.6,8.9,8.4,64720.0,29.6,0.1,8.6,66.37231966915371,0.004795179147031536,9.55047162816578,6.36952837183422,8.057469542224773,65.38461538461544,0.6754354876310054,8478670.0,22.22222222222223,0.023255813953488413,7.675403268534151,7.675403268534151,8.275,7.449999999999999,7.7321999159296,7.5,9.1,0,,1.3990709936726955,1031.423981519329
2012-07-26,8.9,8.8,8.9,8.6,32380.000000000004,29.6,0.1,8.766666666666667,67.43592040145847,0.002835331895638671,9.599836592581147,6.540163407418853,8.137710538203367,66.6666666666667,0.6486186670859336,8511050.0,14.102564102564111,0.011363636363636243,7.287850191976782,7.287850191976782,8.35,7.449999999999999,7.810911919292416,7.5,9.1,0,,1.3993333021010457,1035.1695698514955
2012-07-27,8.9,8.9,8.9,8.8,26670.0,29.6,0.1,8.866666666666667,67.43592040145847,-0.0036255506184200703,9.628100134195948,6.721899865804053,8.210309534564951,66.6666666666667,0.6094316194369384,8537720.0,15.584415584415586,0.0,6.847546285808296,6.847546285808296,8.35,7.55,7.8864754425207195,7.5,9.1,0,,1.3995918972217876,1038.9013494596456
2012-07-28,8.9,8.9,8.9,8.7,16170.000000000002,29.6,0.1,8.9,67.43592040145847,-0.012560641334852352,9.619552163971328,6.940447836028672,8.27599434079686,66.6666666666667,0.5801865037628714,8553890.0,18.66666666666667,0.0,6.518949480481701,6.518949480481701,8.35,7.55,7.9590164248198905,7.5,9.1,0,,1.39984680246244,1042.6192247592935
2012-07-29,8.7,8.9,8.9,8.7,11460.0,29.6,0.1,8.833333333333334,62.49812857657104,-0.03531303012043585,9.57871331046514,7.151286689534856,8.31637583214954,58.33333333333332,0.5530303249226663,8542430.0,14.473684210526311,-0.022471910112359716,6.356670401409959,6.356670401409959,8.4,7.55,8.028655767827095,7.5,9.1,0,,1.4000664525304387,1046.104628732046
2012-07-30,9.1,8.7,9.1,8.7,51260.0,29.6,0.1,8.9,67.60682080438778,-0.02716203200420153,9.58853887837338,7.331461121626623,8.391006705278155,75.0,0.5420995874281902,8593690.0,7.05882352941176,0.04597701149425282,5.9571383233867055,5.9571383233867055,8.3,7.55,8.095509537114012,7.5,9.1,0,,1.4003449778168269,1050.0083161396965
2012-07-31,9.4,9.1,9.4,9.1,70170.0,29.6,0.1,9.066666666666668,70.81768865938241,-0.006388537082654633,9.611345283755695,7.528654716244305,8.487101304775473,85.71428571428575,0.5248067597547481,8663860.0,6.818181818181814,0.03296703296703307,5.58305063568881,5.58305063568881,8.375,7.55,8.15968915562945,7.5,9.1,0,,1.4006647118527573,1054.2119580619099
2012-08-01,9.6,9.4,9.6,9.1,68700.0,29.6,0.1,9.366666666666667,72.7564567934705,0.014840307754215964,9.730327052820872,7.589672947179127,8.593091656701619,95.23809523809526,0.5230348483436946,8732560.0,5.4945054945054945,0.02127659574468077,5.448279670246819,5.448279670246819,8.549999999999999,7.55,8.221301589404273,7.5,9.1,0,,1.4010096786844937,1058.6073417442349
2012-08-02,10.5,9.6,11.0,9.4,126690.0,29.6,0.1,9.833333333333334,79.39156946748366,0.07988024658017112,10.048999599679759,7.551000400320243,8.77470197511099,85.29411764705883,0.5999609306048593,8859250.0,17.977528089887635,0.09375,5.713913624808184,5.713913624808184,9.274999999999999,8.25,8.280449525828102,7.5,9.1,0,,1.4014745070535006,1063.862679522923
2012-08-03,11.0,10.5,11.1,10.3,61640.0,29.6,0.1,10.366666666666667,82.01256419684039,0.1432615005227592,10.412880384454901,7.537119615545101,8.986635120338514,96.96969696969697,0.614249435561655,8920890.0,29.411764705882355,0.04761904761904767,5.584085777833227,5.584085777833227,9.375,8.4,8.443622554278416,7.5,9.1,0,,1.4019990654353995,1069.5654224743557
2012-08-04,11.0,11.0,11.3,10.5,52320.0,29.6,0.1,10.833333333333334,82.01256419684039,0.17004521900294312,10.692223319369297,7.597776680630702,9.178384156496751,91.4285714285714,0.6275173330215369,8973210.0,23.595505617977523,0.0,5.704703027468517,5.704703027468517,9.575,8.55,8.656132749936143,7.5,9.1,0,,1.402518906114518,1075.2639722787326
2012-08-05,10.9,11.0,11.3,10.1,67280.0,29.6,0.1,10.966666666666667,79.66252734890192,0.1657169306541627,10.958841787180884,7.571158212819114,9.342347570163726,88.57142857142857,0.6684089520914273,8905930.0,29.761904761904763,-0.009090909090909038,6.132192221022268,6.132192221022268,9.575,8.600000000000001,8.920519474942529,7.5,9.1,0,,1.4030214856811445,1080.868163778559
2012-08-06,10.9,10.9,11.2,10.6,51640.0,29.6,0.1,10.933333333333332,79.66252734890192,0.14811919916783822,11.191098569545352,7.548901430454651,9.490695420624323,86.66666666666664,0.663522598370611,8957570.0,29.761904761904763,0.0,6.08736328780377,6.08736328780377,9.6,8.65,9.158467527448275,7.5,9.1,0,,1.4035194545655294,1086.4671405327786
2012-08-07,11.1,10.9,11.1,10.6,41650.0,29.6,0.1,10.966666666666667,80.93001570686738,0.13555287910531677,11.43479006512149,7.505209934878511,9.643962523422006,93.10344827586204,0.6518424127727103,8999220.0,29.069767441860467,0.0183486238532109,5.872454169123516,5.872454169123516,9.65,8.65,9.372620774703448,7.5,9.1,0,,1.4040378013029564,1092.2412468114755
2012-08-08,11.1,11.1,11.1,10.9,31320.0,29.6,0.1,11.033333333333333,80.93001570686738,0.11372641231659308,11.648429355815686,7.511570644184317,9.782632759286576,92.59259259259255,0.6195679547175166,9030540.0,26.136363636363626,0.0,5.581693285743393,5.581693285743393,9.75,8.65,9.565358697233103,7.5,9.1,0,,1.404551490929003,1098.0109544205009
2012-08-09,11.1,11.1,12.0,10.8,101880.0,29.6,0.1,11.1,80.93001570686738,0.08698083891617048,11.81703583263315,7.602964167366851,9.908096306021188,72.72727272727272,0.6610273865234083,9132420.0,24.719101123595497,0.0,5.955201680391066,5.955201680391066,10.100000000000001,9.1,9.738822827509793,7.5,9.1,0,,1.4050605510200285,1103.7760558769899
2012-08-10,11.4,11.1,11.6,11.0,63600.0,29.6,0.1,11.200000000000001,82.92382206973073,0.07750116416207897,12.02978928373547,7.640210716264532,10.050182372114408,81.81818181818184,0.656668287486022,9196020.0,28.089887640449433,0.027027027027027195,5.760248135842298,5.760248135842298,10.175,9.1,10.010164088208619,7.5,9.1,0,,1.405601470934571,1109.8044668727664
2012-08-11,11.5,11.4,11.6,11.4,21790.0,29.6,0.1,11.333333333333334,83.54153322731602,0.06640018680496207,12.1953571139387,7.784642886061301,10.188260241436845,84.84848484848484,0.6240491240941634,9217810.0,29.21348314606741,0.00877192982456143,5.426514122557942,5.426514122557942,10.350000000000001,9.1,10.248944397623584,7.5,9.1,0,,1.4061495936892054,1115.917923600737
2012-08-12,11.6,11.5,11.8,11.4,30340.0,29.6,0.1,11.5,84.15865587701091,0.054713600505571613,12.334948511979174,7.965051488020826,10.322711647014287,87.87878787878788,0.6080456152302947,9248150.0,33.33333333333334,0.008695652173912993,5.241772545088748,5.241772545088748,10.425,9.1,10.459071069908754,7.5,9.1,0,,1.4067047797621757,1122.116465507988
2012-08-13,12.0,11.6,12.1,11.5,54040.0,29.6,0.1,11.700000000000001,86.36154204103515,0.06229319181359727,12.525085032374031,8.11491496762597,10.482453394917687,96.66666666666669,0.6074709284281308,9302190.0,31.868131868131872,0.034482758620689724,5.06225773690109,5.06225773690109,10.475,9.15,10.643982541519703,7.5,9.1,0,,1.407301367780407,1128.6581237242856
2012-08-14,12.2,12.0,12.3,11.9,44020.0,29.6,0.1,11.933333333333335,87.31162335488699,0.06864560374872664,12.724188890850538,8.255811109149462,10.646029262068383,96.87499999999994,0.5926515763975501,9346210.0,29.78723404255318,0.016666666666666607,4.8577998065372965,4.8577998065372965,10.7,9.25,10.847824985706945,7.5,9.1,0,,1.4079155137986517,1135.36912458482
2012-08-15,13.3,12.2,13.3,12.2,57560.0,29.6,0.1,12.5,91.01779689499915,0.13117527971621346,13.133138460757026,8.286861539242976,10.898788379966632,100.0,0.6288907495120108,9403770.0,38.54166666666668,0.09016393442622972,4.7285018760301565,4.7285018760301565,11.25,9.75,11.080172987993834,7.5,9.1,0,,1.4086419156775598,1142.9698576203443
2012-08-16,13.5,13.3,13.8,12.5,96600.0,29.6,0.1,13.0,91.50372312198569,0.167902995072714,13.501562023453639,8.378437976546364,11.14652281996981,91.89189189189189,0.6768271245468672,9500370.0,28.57142857142857,0.015037593984962294,5.01353425590272,5.01353425590272,11.55,10.05,11.479741850154944,7.5,13.5,0,,1.409383137497304,1150.7340073972748
2012-08-17,11.6,13.5,15.4,10.6,221030.0,29.6,0.1,12.800000000000002,58.90271303225652,0.05213343495048417,13.4715600347164,8.678439965283598,11.189711122829829,28.301886792452827,0.9713394727935196,9279340.0,5.4545454545454515,-0.14074074074074072,8.373616144771722,8.373616144771722,12.3,10.9,13.8,7.5,13.5,1,,1.4099134454903532,1156.9299483511916
2012-08-18,11.6,11.6,12.9,11.0,88050.0,29.6,0.1,12.233333333333334,58.90271303225652,-0.03201489282710801,13.361588195708936,9.078411804291065,11.228786253988893,28.301886792452827,1.0376723675939825,9367390.0,5.4545454545454515,0.0,8.945451444775712,8.945451444775712,12.425,10.9,13.8,7.5,13.5,0,,1.4104391333479374,1163.122377226947
2012-08-19,8.0,11.6,11.6,7.6,238860.0,29.6,0.1,10.4,33.03744407822113,-0.3216030717124223,13.562728091339773,8.767271908660229,10.921282801228045,5.128205128205132,1.2492671984801267,9128530.0,-26.605504587155966,-0.31034482758620685,15.615839981001583,15.615839981001583,11.5,10.9,15.4,8.0,13.5,1,,1.4104583304848477,1165.4215519592858
2012-08-20,10.1,8.0,10.5,7.8,192500.0,29.6,0.1,9.9,47.51560430241129,-0.36028259616708036,13.51257432312993,8.887425676870068,10.84306539158728,32.05128205128205,1.3528909700172604,9321030.0,-7.339449541284409,0.26249999999999996,13.394960099180796,13.394960099180796,11.5,10.9,15.088000000000001,8.0,13.5,1,,1.410789398046976,1170.1431113639876
2012-08-21,9.9,10.1,10.3,9.7,72080.0,29.6,0.1,9.333333333333334,46.48477333141457,-0.3856292622124944,13.48944498724411,8.94055501275589,10.753249640007539,29.487179487179493,1.299113043587456,9248950.0,-10.810810810810805,-0.01980198019801971,13.122353975630869,13.122353975630869,11.5,10.9,14.788480000000002,8.0,13.5,0,,1.411089720920163,1174.6421200279956
2012-08-22,9.8,9.9,10.1,9.6,67510.0,29.6,0.1,9.933333333333335,45.94802251431374,-0.39402974331477714,13.518033361609682,8.841966638390321,10.662463960006821,28.20512820512822,1.2420335404740663,9181440.0,-11.711711711711704,-0.010101010101010055,12.673811637490473,12.673811637490473,11.5,10.9,14.500940800000002,8.0,13.5,0,,1.411372714581292,1179.0207917123794
2012-08-23,10.1,9.8,10.3,9.7,56020.0,29.6,0.1,9.933333333333334,47.89191848083178,-0.36494317788024566,13.519344773727129,8.750655226272874,10.608895963815696,32.05128205128205,1.196174001868776,9237460.0,-9.00900900900901,0.030612244897959107,11.843306949195803,11.843306949195803,11.5,10.9,14.224903168000003,8.0,13.5,0,,1.4116926270441477,1183.704123973337
2012-08-24,10.6,10.1,10.6,9.9,92080.0,29.6,0.1,10.166666666666666,51.05153203235602,-0.30028991165822405,13.510224415373195,8.719775584626802,10.608048729166581,38.46153846153846,1.160733001735292,9329540.0,-7.0175438596491295,0.04950495049504955,10.950311337125395,10.950311337125395,11.5,10.9,13.959907041280003,8.0,13.5,0,,1.4120736398387796,1188.8868157797456
2012-08-25,10.5,10.6,10.6,10.2,40230.0,29.6,0.1,10.4,50.39339372529068,-0.2543395343134437,13.503713349487622,8.686286650512379,10.59775837400786,37.17948717948718,1.1063949301827711,9289310.0,-8.695652173913043,-0.009433962264150941,10.537094573169249,10.537094573169249,11.5,10.95,13.705510759628803,8.0,13.5,0,,1.4124379835026546,1193.958245852916
2012-08-26,10.6,10.5,10.6,10.4,26330.0,29.6,0.1,10.566666666666666,51.07266713685078,-0.20917733608172756,13.49710570724573,8.66289429275427,10.597971862197587,38.46153846153846,1.041652435169716,9315640.0,-8.620689655172415,0.00952380952380949,9.826909765752038,9.826909765752038,10.875,11.0,13.461290329243651,8.0,13.5,0,,1.4128111180969278,1199.119661125822
2012-08-27,10.9,10.6,12.1,10.5,175120.0,29.6,0.1,10.666666666666666,53.145491129248825,-0.1536363400821268,13.488346542578189,8.651653457421812,10.626736446750199,42.307692307692314,1.0815344040861647,9490760.0,-9.166666666666663,0.028301886792452935,9.922333982441877,9.922333982441877,10.675,11.0,13.226838716073905,8.0,13.5,0,,1.4132176307715085,1204.5689930539363
2012-08-28,10.9,10.9,11.2,10.5,54880.0,29.6,0.1,10.800000000000002,53.145491129248825,-0.11329679634859977,13.47942141843869,8.64057858156131,10.652761547059704,42.307692307692314,1.0542819466514386,9545640.0,-10.655737704918025,0.0,9.67231143716916,9.67231143716916,10.725,11.05,13.001765167430948,8.0,13.5,0,,1.413620098562308,1210.0089450139303
2012-08-29,10.9,10.9,11.1,10.6,53650.0,29.6,0.1,10.9,53.145491129248825,-0.08434166761836384,13.4703305559365,8.629669444063502,10.676308066387351,42.307692307692314,1.0146903790334787,9599290.0,-18.045112781954888,0.0,9.309086046178704,9.309086046178704,11.175,11.05,12.78569456073371,8.0,13.5,0,,1.4140185451789826,1215.4393445343264
2012-08-30,10.8,10.9,10.9,10.6,30870.0,29.6,0.1,10.866666666666667,52.22436969716188,-0.0702294800142407,13.437105707245731,8.602894292754268,10.688088250540936,41.025641025641036,0.963641066245373,9568420.0,-19.999999999999996,-0.00917431192660545,8.922602465234936,8.922602465234936,11.175,11.2,12.57826677830436,8.0,13.5,0,,1.414400725245934,1220.7603736643584
2012-08-31,10.2,10.8,10.8,9.7,67790.0,29.6,0.1,10.633333333333335,46.964705695197225,-0.0979091092638168,13.386851146760405,8.523148853239595,10.641603655251323,49.05660377358489,0.9733809900849894,9500630.0,-12.068965517241383,-0.05555555555555569,9.54295088318617,9.54295088318617,11.2,11.2,12.379136107172187,8.0,13.5,0,,1.414702992025518,1225.4512061388011
2012-09-01,10.0,10.2,10.3,9.8,23380.0,29.6,0.1,10.333333333333334,45.326019466697105,-0.12458180757952109,13.321936860648412,8.428063139351588,10.580498545227387,53.33333333333334,0.9395680622217758,9477250.0,-13.79310344827586,-0.019607843137254832,9.395680622217759,9.395680622217759,11.2,11.25,12.187970662885299,8.0,13.5,0,,1.414975362789077,1229.9133900435256
2012-09-02,10.2,10.0,10.4,9.7,25060.0,29.6,0.1,10.133333333333333,47.30604011217144,-0.12341414150626698,13.191885954921819,8.378114045078181,10.544260588539064,55.813953488372086,0.9224560577773634,9502310.0,27.499999999999993,0.020000000000000018,9.043686840954544,9.043686840954544,11.2,11.35,12.004451836369887,8.0,13.5,0,,1.4152705100451133,1234.5769627652944
2012-09-03,10.5,10.2,10.6,10.1,22930.0,29.6,0.1,10.233333333333334,50.21832890135343,-0.09819483320216478,13.019482700948625,8.380517299051373,10.540045294392486,36.000000000000014,0.8922806250789803,9525240.0,3.960396039603964,0.02941176470588247,8.497910715037909,8.497910715037909,11.2,11.35,11.82827376291509,8.0,13.5,0,,1.4156004798383914,1239.54361484888
2012-09-04,10.4,10.5,10.5,10.1,34880.0,29.6,0.1,10.366666666666667,49.24139015225424,-0.08452571895916515,12.545452209926163,8.564547790073837,10.526707647307488,32.00000000000003,0.8571177232876247,9490360.0,5.05050505050505,-0.00952380952380949,8.241516570073314,8.241516570073314,11.2,11.35,11.659142812398487,8.0,13.5,0,,1.4159141034259743,1244.3929339701376
2012-09-05,11.0,10.4,11.2,10.3,60770.0,29.6,0.1,10.633333333333335,54.90935862096233,-0.03394758426131109,11.914722196237383,8.945277803762616,10.57178310946868,54.166666666666686,0.8601807430527942,9551130.0,12.244897959183664,0.05769230769230771,7.819824936843584,7.819824936843584,10.975,11.35,11.496777099902548,8.0,13.5,0,,1.4162981852136494,1249.8457269042171
2012-09-06,11.2,11.0,11.3,10.6,67050.0,29.6,0.1,10.866666666666667,56.64715442266602,0.011663327898183487,11.840943744526655,8.979056255473346,10.631613289519281,62.49999999999999,0.8487392614061662,9618180.0,10.891089108910888,0.018181818181818077,7.578029119697913,7.578029119697913,11.0,11.35,11.340906015906446,8.0,11.2,0,,1.4167021457090938,1255.4869852294798
2012-09-07,11.0,11.2,11.2,10.9,35540.0,29.6,0.1,11.066666666666668,54.389726517287755,0.026216233207273204,11.732922762023007,9.027077237976991,10.666697738136492,54.166666666666686,0.8095435998771542,9582640.0,3.7735849056603805,-0.017857142857142794,7.359487271610493,7.359487271610493,11.0,11.5,7.6,8.0,11.2,0,,1.4170784135999328,1260.9194013241045
2012-09-08,11.0,11.0,11.1,10.8,24250.0,29.6,0.1,11.066666666666668,54.389726517287755,0.03324347483732694,11.357284715197826,9.702715284802172,10.69844081069492,54.166666666666686,0.7731476284573573,9606890.0,4.761904761904762,0.0,7.028614804157794,7.028614804157794,11.0,11.5,7.672,11.0,11.2,0,,1.4174508392566934,1266.3411865643757
2012-09-09,11.0,11.0,11.1,10.9,14030.0,29.6,0.1,11.0,54.389726517287755,0.03510962804786111,11.401740588092748,9.74825941190725,10.727160733485881,54.166666666666686,0.7322085121389746,9620920.0,3.7735849056603805,0.0,6.656441019445223,6.656441019445223,11.0,11.5,7.74256,11.0,11.2,0,,1.4178194449856256,1271.7521778725386
2012-09-10,11.2,11.0,11.2,10.9,42290.0,29.6,0.1,11.066666666666668,56.55223244724745,0.04632659500823451,11.448455317256272,9.83154468274373,10.772193044582464,93.74999999999991,0.7013364755576192,9663210.0,2.7522935779816415,0.018181818181818077,6.261932817478744,6.261932817478744,11.0,11.5,7.8117088,11.0,11.2,0,,1.4182078955024657,1277.353539092932
2012-09-11,11.3,11.2,11.4,10.9,64950.0,29.6,0.1,11.166666666666666,57.633836865401435,0.056329104865725704,11.474670981412302,9.955329018587697,10.822460373669848,94.11764705882355,0.686955298732075,9728160.0,3.6697247706422047,0.008928571428571619,6.0792504312573,6.0792504312573,11.125,11.5,7.879474624,11.0,11.2,0,,1.4186041269415468,1283.0444631141938
2012-09-12,11.4,11.3,11.4,10.8,58630.0,29.6,0.1,11.299999999999999,58.73998936551146,0.06491768301978096,11.540526133673211,10.019473866326788,10.877464147606053,100.0,0.6807442059654981,9786790.0,4.587155963302751,0.008849557522123908,5.971440403206123,5.971440403206123,10.5,11.5,8.02029563904,11.0,11.2,0,,1.4190079989336977,1288.8247626283128
2012-09-13,11.4,11.4,11.4,11.2,20570.0,29.6,0.1,11.366666666666669,58.73998936551146,0.06564008180287884,11.621498596380505,10.018501403619496,10.927229466881666,100.0,0.6464053341108197,9807360.0,5.555555555555552,0.0,5.670222229042278,5.670222229042278,10.350000000000001,11.5,8.1554838134784,11.0,11.2,0,,1.4194079586338026,1294.5956849623497
2012-09-14,11.7,11.4,11.8,11.3,43260.0,29.6,0.1,11.5,62.175995997233684,0.08038993453281015,11.753155198117671,10.006844801882327,11.000826660511983,95.23809523809517,0.6359478102457611,9850620.0,14.705882352941178,0.02631578947368407,5.43545136962189,5.43545136962189,10.575,11.5,8.285264460939263,11.0,11.2,0,,1.419837935207291,1300.6512608938226
2012-09-15,11.8,11.7,11.8,11.6,16270.0,29.6,0.1,11.633333333333335,63.27389639271123,0.09021195430105108,11.889526197637489,9.990473802362514,11.076938407129889,100.0,0.6048086809424925,9866890.0,18.000000000000007,0.008547008547008739,5.125497296122818,5.125497296122818,11.075,11.5,8.496148593282907,11.0,11.2,0,,1.4202750084869173,1306.7954981941052
2012-09-16,11.9,11.8,12.0,11.7,30300.0,29.6,0.1,11.800000000000002,64.38713196292238,0.09622480603866879,12.027111372997085,9.952888627002915,11.155325225498471,94.73684210526316,0.5830366323037431,9897190.0,16.66666666666668,0.008474576271186418,4.899467498350782,4.899467498350782,11.125,11.5,8.694379677685932,11.0,11.2,0,,1.4207190507078455,1313.028304873216
2012-09-17,11.9,11.9,12.0,11.8,26610.0,29.6,0.1,11.866666666666667,64.38713196292238,0.09293385924768013,12.148873302050282,9.93112669794972,11.226246632593854,94.73684210526316,0.5556768728534757,9923800.0,13.333333333333336,0.0,4.669553553390552,4.669553553390552,11.149999999999999,11.5,8.958829303471058,11.0,11.2,0,,1.421159055337593,1319.2537703948751
2012-09-18,12.3,11.9,12.4,11.8,40950.0,29.6,0.1,12.033333333333337,68.77757377426389,0.10929923911556089,12.34434192993671,9.875658070063288,11.328508858061106,95.23809523809526,0.5588428105067987,9964750.0,18.26923076923077,0.03361344537815136,4.5434374837951115,4.5434374837951115,11.325000000000001,11.5,9.202122959193373,11.0,11.2,0,,1.4216379785586566,1325.8517227386228
2012-09-19,12.6,12.3,12.7,12.1,41880.0,29.6,0.1,12.266666666666667,71.60498705110267,0.13049604201503773,12.584196517839816,9.815803482160183,11.449603252531476,95.23809523809526,0.5617826097563131,10006630.0,14.545454545454541,0.024390243902439046,4.45859214092312,4.45859214092312,11.475,11.5,9.521910663274035,11.0,11.2,0,,1.422143998344522,1332.7224237555859
2012-09-20,12.3,12.6,12.7,12.3,32570.0,29.6,0.1,12.4,65.24235301845937,0.11502189066946766,12.688437747063402,9.921562252936598,11.53059341895705,78.94736842105269,0.5502267090594335,9974060.0,9.821428571428585,-0.023809523809523725,4.473387878531979,4.473387878531979,11.475,11.5,9.90328138368115,11.0,11.2,0,,1.4226145521128621,1339.3101019444994
2012-09-21,12.4,12.3,12.5,12.0,35840.0,29.6,0.1,12.433333333333332,66.31676513109142,0.10263918359259216,12.749952829348972,10.10004717065103,11.613394045723044,84.21052631578952,0.5466390869837597,10009900.0,12.727272727272732,0.008130081300812941,4.408379733739998,4.408379733739998,11.575,11.5,10.238887617639412,11.0,11.2,0,,1.4230914707957674,1345.9861467884411
2012-09-22,12.2,12.4,12.4,12.1,14990.0,29.6,0.1,12.300000000000002,62.177095907966255,0.07346402125205354,12.764152936485175,10.285847063514826,11.669261279463706,73.68421052631577,0.5290220093420627,9994910.0,10.909090909090903,-0.016129032258064613,4.336245978213628,4.336245978213628,11.6,11.5,10.534221103522682,11.0,11.2,0,,1.4235432547832743,1352.4668883844402
2012-09-23,12.2,12.2,12.3,11.6,39920.0,29.6,0.1,12.266666666666666,62.17709590796625,0.04788917689458544,12.787964345810103,10.4320356541899,11.719807824276685,73.68421052631577,0.5412347229604869,10034830.0,10.909090909090903,0.0,4.436350188200713,4.436350188200713,11.674999999999999,11.5,10.79411457109996,11.0,11.2,0,,1.423991015311019,1358.9407919789928
2012-09-24,12.1,12.2,12.3,11.9,27290.0,29.6,0.1,12.166666666666666,60.00504768401253,0.019420702197909423,12.75041461047297,10.639585389527031,11.756016602917,68.42105263157895,0.5311465284633093,10007540.0,8.035714285714288,-0.008196721311475419,4.38964073110173,4.38964073110173,11.674999999999999,11.5,11.022820822567965,11.0,11.2,0,,1.4244241686544474,1365.3108490942805
2012-09-25,12.2,12.1,12.2,12.0,21230.0,29.6,0.1,12.166666666666666,61.45512241204777,0.003350189603894549,12.781596317936023,10.728403682063975,11.798300735972523,73.68421052631577,0.5074932050016444,10028770.0,7.964601769911492,0.008264462809917328,4.159780368865938,4.159780368865938,11.674999999999999,11.5,11.22408232385981,11.0,11.2,0,,1.4248639767376807,1371.7702307481522
2012-09-26,12.3,12.2,12.5,12.0,23500.0,29.6,0.1,12.200000000000001,62.90356748303434,-0.004114713466951581,12.82960776772237,10.79039223227763,11.846081618260854,73.33333333333343,0.5069579760729556,10052270.0,7.8947368421052655,0.00819672131147553,4.121609561568744,4.121609561568744,11.674999999999999,11.5,11.401192444996632,11.0,11.2,0,,1.4253103215578429,1378.318872468881
2012-09-27,12.3,12.3,12.4,12.2,19330.0,29.6,0.1,12.266666666666667,62.90356748303434,-0.012166852770348346,12.844278081873197,10.905721918126803,11.889311940331249,71.4285714285715,0.4850324063534588,10071600.0,7.8947368421052655,0.0,3.9433528971825913,3.9433528971825913,11.674999999999999,11.5,11.557049351597035,11.0,11.2,0,,1.42575269252459,1384.8604410715682
2012-09-28,12.4,12.3,12.4,12.1,26680.0,29.6,0.1,12.333333333333334,64.45277784988846,-0.01375545681950796,12.85158700630429,11.03841299369571,11.93794889839494,72.72727272727282,0.47181580589964034,10098280.0,5.982905982905992,0.008130081300812941,3.804966176610003,3.804966176610003,11.774999999999999,11.5,11.694203429405391,11.0,11.2,0,,1.426201493358304,1391.4913639765887
2012-09-29,12.4,12.4,12.5,12.2,17060.0,29.6,0.1,12.366666666666667,64.45277784988846,-0.017559979854729457,12.830536633143947,11.199463366856055,11.981953765214469,72.72727272727282,0.45954324833538035,10115340.0,5.0847457627118615,0.0,3.705993938188551,3.705993938188551,11.725,11.5,11.814899017876744,11.0,11.2,0,,1.4266463253188715,1398.115385307658
2012-09-30,12.4,12.4,12.4,12.3,7790.0,29.6,0.1,12.4,64.45277784988846,-0.022513935850639877,12.814932429347271,11.335067570652727,12.0217676923369,72.72727272727282,0.433861587739996,10123130.0,4.201680672268907,0.0,3.498883772096742,3.498883772096742,11.775,11.5,11.921111135731534,11.0,11.2,0,,1.4270872105274905,1404.7322970640564
2012-10-01,12.4,12.4,12.5,12.3,24830.0,29.6,0.1,12.4,64.45277784988846,-0.02787732578485863,12.790605782596359,11.469394217403643,12.057789816876241,72.72727272727282,0.41715718861571055,10147960.0,4.201680672268907,0.0,3.3641708759331492,3.3641708759331492,11.85,11.5,12.01457779944375,11.0,11.2,0,,1.427524170967355,1411.3418924502528
2012-10-02,12.8,12.4,12.9,12.3,50830.0,29.6,0.1,12.533333333333333,70.97443121540891,-0.007625579625088974,12.832455532033467,11.567544467966531,12.128476500983265,92.30769230769235,0.43021738942887405,10198790.0,4.0650406504065035,0.032258064516129004,3.3610733549130787,3.3610733549130787,12.125,11.5,12.0968284635105,11.0,11.2,0,,1.4279977278566023,1418.328458855879
2012-10-03,12.9,12.8,13.0,12.7,32960.0,29.6,0.1,12.700000000000003,72.34064536275295,0.008491688685784926,12.864491306127348,11.685508693872652,12.20195492946105,92.85714285714288,0.42091614732681165,10231750.0,2.3809523809523867,0.0078125,3.2629158707504775,3.2629158707504775,12.2,11.5,12.20927247861903,11.0,12.9,0,,1.4284771654711974,1425.4042898090631
2012-10-04,12.9,12.9,13.1,12.6,37950.0,29.6,0.1,12.866666666666667,72.34064536275295,0.0147715318837639,12.922452125708741,11.74754787429126,12.26843541236952,86.6666666666667,0.42656499394632513,10269700.0,4.878048780487801,0.0,3.3067053794288768,3.3067053794288768,12.25,11.5,12.3,11.0,12.9,0,,1.4289525542368398,1432.4751498239195
2012-10-05,12.7,12.9,13.0,12.5,31260.0,29.6,0.1,12.833333333333334,65.22001715463756,0.0017590677735204174,12.93353410012366,11.826465899876338,12.30953680166766,73.33333333333331,0.4318103515215876,10238440.0,2.4193548387096686,-0.015503875968992276,3.4000815080439972,3.4000815080439972,12.274999999999999,11.5,12.444,11.0,12.9,0,,1.4294040597842428,1439.3493599314197
2012-10-06,12.5,12.7,12.9,12.4,24670.0,29.6,0.1,12.700000000000001,58.96908215378217,-0.02266731520395776,12.919509568113993,11.900490431886007,12.327676153889787,60.00000000000002,0.436681040698617,10213770.0,2.459016393442629,-0.015748031496062964,3.493448325588936,3.493448325588936,12.274999999999999,11.5,13.1,11.0,12.9,0,,1.4298314890098165,1446.021764318124
2012-10-07,11.8,12.5,12.6,11.7,63510.0,29.6,0.1,12.333333333333334,43.31956641668268,-0.08482441855705536,12.935942558098057,11.874057441901945,12.277421282090758,7.142857142857243,0.46977525207728726,10150260.0,-3.2786885245901525,-0.05599999999999994,3.9811462040448076,3.9811462040448076,12.174999999999999,11.5,13.086,11.0,12.9,1,,1.4301820345462928,1451.9752622281865
2012-10-08,11.8,11.8,11.9,10.6,97940.0,29.6,0.1,12.033333333333333,43.31956641668268,-0.1225063317280859,12.971945943477706,11.788054056522295,12.231952588558304,48.00000000000004,0.5290770197860525,10248200.0,-2.479338842975198,0.0,4.483703557508919,4.483703557508919,11.85,10.35,13.03056,11.0,12.9,1,,1.4305290422432158,1457.9168059294568
2012-10-09,11.9,11.8,12.4,11.6,46770.0,29.6,0.1,11.833333333333334,45.706791500549954,-0.13621133860913343,12.962980582218986,11.727019417781015,12.200338056314656,52.00000000000002,0.548428661229906,10294970.0,-2.459016393442614,0.008474576271186418,4.608644212016016,4.608644212016016,11.85,10.35,12.8847264,11.0,12.9,0,,1.430883202285631,1463.950935567488
2012-10-10,12.1,11.9,12.2,11.8,27720.0,29.6,0.1,11.933333333333335,50.22232903966483,-0.12747742645515137,12.961976873576463,11.708023126423535,12.190782050951356,60.0,0.5378266139991983,10322690.0,-1.62601626016261,0.01680672268907557,4.444848049580151,4.444848049580151,11.85,10.45,12.747642815999999,11.0,12.9,0,,1.431254872095411,1470.1807289722276
2012-10-11,12.0,12.1,12.1,11.9,19830.0,29.6,0.1,12.0,48.06960106137792,-0.1239918329757077,12.95772855856864,11.672271441431363,12.17261233181313,56.000000000000014,0.5136961415706841,10302860.0,-2.439024390243908,-0.008264462809917328,4.2808011797557,4.2808011797557,11.85,11.35,12.618784247039999,11.0,12.9,0,,1.4316124779946446,1476.2959720629776
2012-10-12,12.0,12.0,12.1,11.9,21540.0,29.6,0.1,12.033333333333333,48.06960106137792,-0.11731413568441093,12.96066759871121,11.649332401288794,12.156173062116642,56.000000000000014,0.4912892743156352,10324400.0,-3.2258064516129057,0.0,4.0940772859636265,4.0940772859636265,11.85,11.35,12.497657192217599,11.0,12.9,0,,1.4319665459926647,1482.399594753599
2012-10-13,11.9,12.0,12.1,11.9,11860.0,29.6,0.1,11.966666666666669,45.793130659412725,-0.11510012922788437,12.967938050266929,11.612061949733073,12.131775627629342,52.00000000000002,0.47048289757880407,10312540.0,-4.032258064516129,-0.008333333333333304,3.9536377947798664,3.9536377947798664,11.825,11.399999999999999,12.383797760684542,11.0,12.9,0,,1.4323065675301658,1488.3863058614031
2012-10-14,11.7,11.9,12.0,11.5,22890.0,29.6,0.1,11.866666666666667,41.55451191041788,-0.1219193694923483,12.991387551874666,11.548612448125333,12.09065413928369,43.999999999999986,0.47259126203746094,10289650.0,-5.645161290322589,-0.01680672268907568,4.039241555875734,4.039241555875734,11.8,11.399999999999999,12.27676989504347,11.0,12.9,0,,1.4326218315729036,1494.147037503241
2012-10-15,11.8,11.7,12.0,11.4,27100.0,29.6,0.1,11.800000000000002,44.32915131313224,-0.11461981990540863,12.999666592559471,11.500333407440529,12.062972792685242,48.00000000000004,0.4816918861776423,10316750.0,-4.838709677419352,0.008547008547008739,4.082134628624087,4.082134628624087,11.725,11.399999999999999,12.176163701340862,11.0,12.9,0,,1.432944415303027,1500.0017000520832
2012-10-16,11.9,11.8,12.0,11.5,41190.0,29.6,0.1,11.800000000000002,47.03693135461768,-0.09859229906253542,12.99446059414448,11.465539405855521,12.047451574334266,52.00000000000002,0.482999608593525,10357940.0,-7.031250000000003,0.008474576271186418,4.058820240281722,4.058820240281722,11.675,11.399999999999999,12.08159387926041,11.0,12.9,0,,1.4332741946285927,1505.9500135668216
2012-10-17,11.8,11.9,12.0,11.7,23550.0,29.6,0.1,11.833333333333334,44.69574284585591,-0.09047326502294677,12.991066154976625,11.418933845023378,12.023884757731002,48.00000000000004,0.4699282079797018,10334390.0,-8.527131782945734,-0.008403361344537785,3.9824424405059475,3.9824424405059475,11.875,11.399999999999999,10.6,11.0,12.9,0,,1.4335900073280925,1511.7781744062954
2012-10-18,11.9,11.8,12.0,11.8,21880.0,29.6,0.1,11.866666666666669,47.50935354978932,-0.07476699084385088,12.97145435749621,11.388545642503793,12.012086209375669,54.166666666666686,0.4506476216954374,10356270.0,-7.751937984496124,0.008474576271186418,3.786954804163339,3.786954804163339,11.825,11.399999999999999,10.628,11.0,12.9,0,,1.4339130270994584,1517.7002823596436
2012-10-19,11.7,11.9,12.0,11.6,23180.0,29.6,0.1,11.800000000000002,42.817529384860336,-0.07410342042979397,12.956110350075587,11.333889649924412,11.982363713244652,47.82608695652171,0.4470299344314776,10333090.0,-7.874015748031496,-0.01680672268907568,3.8207686703545094,3.8207686703545094,11.8,11.399999999999999,10.65544,11.0,12.9,0,,1.4342115161496982,1523.3925918895964
2012-10-20,11.7,11.7,11.9,11.6,22110.0,29.6,0.1,11.766666666666666,42.81752938486033,-0.06997068131939331,12.934378553820842,11.285621446179157,11.955471931030875,54.999999999999986,0.43652779625780064,10355200.0,-6.400000000000006,0.0,3.731006805622228,3.731006805622228,11.8,11.399999999999999,10.6823312,11.0,12.9,0,,1.4345067374267138,1529.070574546874
2012-10-21,11.6,11.7,11.8,11.6,9380.0,29.6,0.1,11.666666666666666,40.4983249215365,-0.07010246853771054,12.911665016499882,11.228334983500115,11.921617461408886,55.555555555555536,0.41963295366795783,10345820.0,-1.6949152542372972,-0.008547008547008517,3.617525462654809,3.617525462654809,11.8,11.399999999999999,10.708684576,11.0,12.9,0,,1.4347880164938873,1534.6238491411243
2012-10-22,11.7,11.6,11.8,11.5,37620.0,29.6,0.1,11.666666666666666,43.77784008421918,-0.05997695926791116,12.800557127139559,11.229442872860442,11.900511036512802,29.999999999999893,0.41108774269167514,10383440.0,-0.847457627118656,0.008620689655172376,3.513570450356198,3.513570450356198,11.774999999999999,11.399999999999999,10.734510884479999,11.0,12.9,0,,1.4350767829735955,1540.2725948072573
2012-10-23,11.6,11.7,12.0,11.4,54340.0,29.6,0.1,11.633333333333335,41.32495328594424,-0.05658000434501746,12.641375440697573,11.258624559302426,11.871890937797296,24.999999999999943,0.42458147535655544,10329100.0,-2.5210084033613507,-0.008547008547008517,3.6601851323840986,3.6601851323840986,11.774999999999999,11.399999999999999,10.759820666790398,11.0,12.9,0,,1.4353516696430082,1545.7957836433757
2012-10-24,11.6,11.6,11.8,11.6,21770.0,29.6,0.1,11.633333333333333,41.32495328594424,-0.05106772726663878,12.437358579185451,11.332641420814548,11.845996562768983,28.5714285714285,0.4085399414025158,10350870.0,-4.132231404958678,0.0,3.5218960465734126,3.5218960465734126,11.774999999999999,11.6,10.78462425345459,11.0,12.9,0,,1.4356233998825998,1551.3036541892156
2012-10-25,10.9,11.6,11.7,10.5,84710.0,29.6,0.1,11.366666666666667,28.40450039411894,-0.08907454090684234,12.37284080852756,11.21715919147244,11.75590165202908,25.00000000000003,0.4650728027309075,10266160.0,-9.166666666666663,-0.06034482758620685,4.266722960834014,4.266722960834014,11.525,11.6,12.0,11.0,12.9,1,,1.4358148379962652,1555.9888156317882
2012-10-26,10.2,10.9,10.9,9.7,99000.0,29.6,0.1,10.9,21.2496343100307,-0.1521628786336061,12.510903123113518,10.849096876886481,11.607720542312025,20.83333333333333,0.5175676025358428,10167160.0,-15.000000000000005,-0.06422018348623859,5.07419218172395,5.07419218172395,11.125,11.399999999999999,11.97,10.2,12.9,1,,1.4359212622681177,1559.7937386834756
2012-10-27,10.3,10.2,10.8,9.8,47870.0,29.6,0.1,10.466666666666667,24.187564335535825,-0.17626369380186346,12.627692524662134,10.582307475337867,11.4831757287585,26.086956521739186,0.5520270594975683,10215030.0,-13.4453781512605,0.009803921568627638,5.359486014539497,5.359486014539497,11.125,11.399999999999999,11.8792,10.2,12.9,0,,1.4360372283193874,1563.7054604630666
2012-10-28,10.7,10.3,10.9,10.3,22390.0,29.6,0.1,10.4,34.68423478608746,-0.15511744083049372,12.640871211463487,10.459128788536514,11.408587564114834,43.478260869565204,0.5554536981048848,10237420.0,-8.547008547008547,0.03883495145631044,5.191156057054998,5.191156057054998,11.125,11.399999999999999,11.792032,10.2,12.9,0,,1.436197696699256,1568.0934963943223
2012-10-29,10.6,10.7,10.9,10.3,37580.0,29.6,0.1,10.533333333333333,33.43778909930812,-0.13827501153801414,12.637865993947182,10.33213400605282,11.331579224675325,39.130434782608695,0.5586355768116787,10199840.0,-10.169491525423737,-0.009345794392523366,5.270146951053573,5.270146951053573,11.125,11.399999999999999,11.70835072,10.2,12.9,0,,1.4363438745806485,1572.3400346933754
2012-10-30,10.9,10.6,10.9,10.6,26020.0,29.6,0.1,10.733333333333334,40.361999473057416,-0.09917082127433108,12.568459662602853,10.281540337397148,11.290476441372913,52.173913043478294,0.5401616070394161,10225860.0,-8.403361344537814,0.028301886792452935,4.95561107375611,4.95561107375611,11.1,11.399999999999999,11.628016691200001,10.2,12.9,0,,1.436521785292089,1576.9320451890126
2012-10-31,11.2,10.9,11.2,10.7,40670.0,29.6,0.1,10.9,46.37006262074056,-0.04793726642422902,12.500840490392708,10.269159509607295,11.281859637432635,65.2173913043478,0.537292920822315,10266530.0,-5.084745762711876,0.02752293577981635,4.797258221627812,4.797258221627812,11.075,11.399999999999999,11.550896023552001,10.2,12.9,0,,1.4367303444297048,1581.8611277324471
2012-11-01,10.6,11.2,11.3,10.4,50360.0,29.6,0.1,10.9,38.10246759024007,-0.049113647149885864,12.44331733125032,10.186682668749683,11.216920624343812,39.130434782608695,0.5632005693350067,10216170.0,-10.924369747899165,-0.05357142857142849,5.313212918254781,5.313212918254781,10.95,11.399999999999999,11.47686018260992,10.2,12.9,0,,1.4368683693199582,1586.0499704355614
2012-11-02,10.5,10.6,10.8,10.3,24490.0,29.6,0.1,10.766666666666667,36.920929907921426,-0.05105712047837585,12.392998257838336,10.097001742161666,11.148642469644402,34.78260869565219,0.5586862429539348,10191680.0,-10.25641025641025,-0.009433962264150941,5.320821361466045,5.320821361466045,10.875,11.399999999999999,11.405785775305523,10.2,12.9,0,,1.4369921545848843,1590.0947350180152
2012-11-03,10.6,10.5,10.6,10.4,16730.0,29.6,0.1,10.566666666666666,38.95937096684935,-0.04049961023705323,12.350861748874454,10.029138251125545,11.096390805868745,39.130434782608695,0.5330657970286536,10208410.0,-9.401709401709399,0.00952380952380949,5.028922613477865,5.028922613477865,10.775,11.399999999999999,11.337554344293302,10.2,12.9,0,,1.4371250133764397,1594.24442920009
2012-11-04,10.8,10.6,10.9,10.5,16750.0,29.6,0.1,10.633333333333335,42.93150568454706,-0.016186094625054714,12.277365376648975,10.002634623351026,11.068163110071723,47.826086956521785,0.5235610972408927,10225160.0,-6.896551724137923,0.018867924528301883,4.8477879374156725,4.8477879374156725,10.75,11.399999999999999,11.27205217052157,10.2,12.9,0,,1.4372781860133248,1598.6208880841791
2012-11-05,10.8,10.8,10.9,10.6,21780.0,29.6,0.1,10.733333333333334,42.93150568454706,0.0027482226108411223,12.175458619113934,9.994541380886064,11.042623766255367,47.826086956521785,0.5075924474379719,10246940.0,-7.69230769230768,0.0,4.699930068870111,4.699930068870111,10.85,11.399999999999999,11.209170083700707,10.2,12.9,0,,1.4374287156562164,1602.978149995048
2012-11-06,10.9,10.8,10.9,10.7,27000.0,29.6,0.1,10.833333333333334,45.00667859964509,0.023693896946534787,12.081921302210429,9.99807869778957,11.029040550421524,57.14285714285716,0.4856215583352598,10273940.0,-6.034482758620683,0.0092592592592593,4.455243654451924,4.455243654451924,10.85,11.399999999999999,11.148803280352679,10.2,12.9,0,,1.43758787586609,1607.4380639418841
2012-11-07,10.9,10.9,11.2,10.8,31730.0,29.6,0.1,10.866666666666669,45.00667859964509,0.03836647452046427,11.955194280961031,10.024805719038966,11.016750974190902,60.00000000000006,0.47950573273988395,10305670.0,-6.034482758620683,0.0,4.399135162751229,4.399135162751229,10.85,11.399999999999999,9.7,10.2,12.9,0,,1.4377443823496427,1611.878911849541
2012-11-08,10.9,10.9,11.1,10.8,26060.0,29.6,0.1,10.9,45.00667859964509,0.04825059085631883,11.85884542140008,10.041154578599919,11.00563183379177,75.0,0.46668389468703503,10331730.0,0.0,0.0,4.281503620981972,4.281503620981972,10.825,11.399999999999999,9.729999999999999,10.2,12.9,0,,1.437898250104859,1616.3006221700027
2012-11-09,10.8,10.9,11.0,10.8,14730.0,29.6,0.1,10.866666666666667,43.05144066187211,0.04812351150658495,11.747555636145114,10.062444363854889,10.986047849621125,66.66666666666667,0.44763504506653246,10317000.0,5.882352941176485,-0.00917431192660545,4.144768935801226,4.144768935801226,10.825,11.399999999999999,9.7594,10.2,12.9,0,,1.4380382762481878,1620.5805819007685
2012-11-10,10.9,10.8,11.0,10.8,13490.0,29.6,0.1,10.866666666666669,45.59670301833572,0.05438211990613978,11.649999999999938,10.090000000000064,10.977852816323875,59.999999999999964,0.4299468275617801,10330490.0,5.825242718446598,0.0092592592592593,3.9444663079062394,3.9444663079062394,10.8,11.399999999999999,9.788212,10.2,12.9,0,,1.4381869380034904,1624.9637486364747
2012-11-11,10.9,10.9,10.9,10.7,12630.0,29.6,0.1,10.866666666666667,45.59670301833572,0.05780935284805169,11.511469001495964,10.148530998504036,10.970438262388267,59.999999999999964,0.41352205416451016,10343120.0,1.8691588785046829,0.0,3.793780313435873,3.793780313435873,10.825,11.399999999999999,9.816447759999999,10.2,12.9,0,,1.4383330053983017,1629.3275732317907
2012-11-12,11.0,10.9,11.2,10.8,39220.0,29.6,0.1,10.933333333333335,48.27770400967562,0.06553228046491727,11.389915248150029,10.210084751849973,10.973253665970336,69.99999999999993,0.4125561931527593,10382340.0,3.7735849056603805,0.00917431192660545,3.7505108468432664,3.7505108468432664,10.85,11.399999999999999,9.844118804799999,10.2,12.9,0,,1.4384875683061298,1633.7940162638972
2012-11-13,10.9,11.0,11.1,10.9,16760.0,29.6,0.1,10.933333333333335,45.84468537814428,0.06262992356886846,11.230939910288779,10.299060089711222,10.966277126354115,59.999999999999964,0.39737360792756216,10365580.0,0.0,-0.009090909090909038,3.645629430528093,3.645629430528093,10.875,11.399999999999999,9.871236428703998,10.2,12.9,0,,1.4386284644082838,1638.1190117760614
2012-11-14,10.9,10.9,11.1,10.8,24540.0,29.6,0.1,10.933333333333335,45.84468537814428,0.05945901064772391,11.230939910288779,10.299060089711222,10.959965019082293,59.999999999999964,0.3904183502184505,10390120.0,-2.678571428571419,0.0,3.581819726774775,3.581819726774775,10.899999999999999,11.399999999999999,9.897811700129918,10.2,12.9,0,,1.43876680987239,1642.4244680220881
2012-11-15,11.2,10.9,11.3,10.9,31900.0,29.6,0.1,11.0,53.92383693250793,0.07529577654056607,11.240558456618958,10.389441543381045,10.982825493455408,89.99999999999986,0.3911027537742755,10422020.0,5.660377358490563,0.02752293577981635,3.491988872984603,3.491988872984603,10.925,11.399999999999999,9.92385546612732,10.2,12.9,0,,1.4389354275076096,1647.074908014514
2012-11-16,11.8,11.2,11.8,11.2,58250.0,29.6,0.1,11.300000000000002,65.12871826574582,0.12118968267676308,11.437357287336066,10.342642712663935,11.060651636935845,100.0,0.4060239856475416,10480270.0,12.380952380952388,0.0535714285714286,3.4408812343012,3.4408812343012,11.05,11.399999999999999,9.978901247482227,10.2,11.8,1,,1.439164390191957,1652.40870850367
2012-11-17,11.8,11.8,11.8,11.5,19110.0,29.6,0.1,11.600000000000001,65.12871826574582,0.1449501735266059,11.61275744099178,10.27724255900822,11.131065766751478,99.99999999999999,0.3984508438155744,10499380.0,11.320754716981142,0.0,3.376702066233681,3.376702066233681,11.05,11.399999999999999,10.088167172633293,10.2,11.8,0,,1.4393905037377224,1657.7255118635126
2012-11-18,11.6,11.8,11.8,11.6,15510.0,29.6,0.1,11.733333333333334,59.53204600455524,0.14049840074836895,11.700620294492643,10.28937970550736,11.175726169918004,83.33333333333326,0.38427578354303343,10483870.0,7.407407407407398,-0.016949152542372947,3.312722271922702,3.312722271922702,11.0,11.399999999999999,10.190877142275296,11.6,11.8,0,,1.4395932013453763,1662.7941401395315
2012-11-19,11.8,11.6,11.8,11.6,25200.0,29.6,0.1,11.733333333333334,62.95984121302272,0.14380393822751944,11.825875308175462,10.25412469182454,11.235180820402004,100.0,0.371113227575674,10509070.0,9.25925925925926,0.017241379310344973,3.14502735233622,3.14502735233622,11.0,11.399999999999999,10.287424513738777,11.6,11.8,0,,1.4398137120139918,1668.0763942845786
2012-11-20,11.7,11.8,11.8,11.6,27220.0,29.6,0.1,11.700000000000001,60.21351399936409,0.13232526834606276,11.899925146345392,10.23007485365461,11.27944931369705,90.90909090909079,0.3588908541774116,10481850.0,7.339449541284393,-0.008474576271186529,3.0674431980975356,3.0674431980975356,11.025,11.399999999999999,10.37817904291445,11.6,11.8,0,,1.4400211971102592,1673.2258069446239
2012-11-21,11.8,11.7,11.8,11.6,19230.0,29.6,0.1,11.766666666666666,61.99865414782683,0.12464381126178187,11.98958082328945,10.26041917671055,11.329025569535426,100.0,0.34754150745045376,10501080.0,8.256880733944957,0.008547008547008739,2.9452670122919806,2.9452670122919806,11.05,11.399999999999999,10.463488300339582,11.6,11.8,0,,1.4402361416910376,1678.4732071288443
2012-11-22,12.4,11.8,12.4,11.7,58300.0,29.6,0.1,11.966666666666669,70.53968139405133,0.15136979171801374,12.198979060041557,10.241020939958444,11.431023134341576,100.0,0.3727171140611357,10559380.0,13.761467889908257,0.05084745762711851,3.005783177912385,3.005783177912385,11.475000000000001,11.399999999999999,10.543679002319207,11.6,11.8,1,,1.4405077468251648,1684.379245956972
2012-11-23,12.4,12.4,12.4,12.1,18970.0,29.6,0.1,12.200000000000001,70.53968139405133,0.15962506671881374,12.371885116196587,10.248114883803414,11.523306645356664,100.0,0.36752303448534035,10578350.0,14.814814814814811,0.0,2.963895439397906,2.963895439397906,11.5,11.399999999999999,10.69218468213367,11.6,11.8,0,,1.44077638428234,1690.2699411048206
2012-11-24,12.4,12.4,12.5,12.3,19570.0,29.6,0.1,12.4,70.53968139405133,0.1555066884045559,12.524724636200267,10.255275363799734,11.60680125056079,94.44444444444447,0.3555571034506731,10597920.0,13.761467889908257,0.0,2.8673959955699444,2.8673959955699444,11.625,11.399999999999999,10.828809907562976,11.6,11.8,0,,1.4410420700203337,1696.1451578757915
2012-11-25,12.5,12.4,12.6,12.3,24020.0,29.6,0.1,12.433333333333335,71.85640175627687,0.14987597128957791,12.673123532862874,10.276876467137129,11.69186779812643,94.44444444444447,0.3515887389184821,10621940.0,14.678899082568803,0.008064516129032251,2.8127099113478566,2.8127099113478566,11.75,11.35,10.995928916806678,11.6,11.8,0,,1.4413144107905043,1702.1151028195013
2012-11-26,12.3,12.5,12.6,11.9,35910.0,29.6,0.1,12.4,65.54653047553711,0.12410562420800314,12.763974979234522,10.326025020765478,11.749785150685817,83.33333333333339,0.3764752575671619,10586030.0,11.818181818181825,-0.015999999999999903,3.0607744517655435,3.0607744517655435,11.774999999999999,11.3,11.188417446789876,11.6,11.8,0,,1.4415645609686898,1707.8475998679128
2012-11-27,12.2,12.3,12.3,11.9,33200.0,29.6,0.1,12.333333333333334,62.587188432802456,0.09316197597054157,12.823095214729577,10.396904785270426,11.792662755382405,77.77777777777774,0.3781555963123647,10552830.0,11.926605504587146,-0.008130081300813163,3.0996360353472516,3.0996360353472516,11.774999999999999,11.149999999999999,11.35780735317509,11.6,11.8,0,,1.4418021164102526,1713.4511556907296
2012-11-28,12.4,12.2,12.4,12.1,30690.0,29.6,0.1,12.300000000000002,65.90290580030732,0.07953088412196474,12.898713310464949,10.471286689535049,11.850504397726938,88.2352941176471,0.37257305371862437,10583520.0,13.761467889908257,0.016393442622950838,3.004621400956648,3.004621400956648,11.8,11.149999999999999,11.506870470794079,11.6,11.8,0,0.0,1.4420561985192177,1719.2628655155627
2012-11-29,12.4,12.4,12.6,12.1,26510.0,29.6,0.1,12.333333333333334,65.90290580030732,0.06452073184110929,12.945296572900125,10.584703427099877,11.902837312229135,85.71428571428578,0.38167497845300835,10610030.0,10.714285714285724,0.0,3.0780240197823256,3.0780240197823256,11.825,11.149999999999999,11.638046014298789,11.6,11.8,0,1.0,1.4423074071626734,1725.0584480541288
2012-11-30,12.6,12.4,12.6,12.4,24350.0,29.6,0.1,12.466666666666669,69.08090177779586,0.06204954514826744,13.013615056623008,10.686384943376991,11.969233758683503,100.0,0.36869819427779343,10634380.0,6.7796610169491425,0.016129032258064502,2.9261761450618526,2.9261761450618526,11.875,11.149999999999999,11.753480492582934,11.6,11.8,0,2.0,1.4425747506227105,1731.0601822243775
2012-12-01,12.6,12.6,12.7,12.5,14700.0,29.6,0.1,12.533333333333333,69.08090177779586,0.0546621266274851,13.056204709230101,10.8137952907699,12.029306734046978,90.90909090909093,0.356648323257951,10649080.0,6.7796610169491425,0.0,2.8305422480789764,2.8305422480789764,12.0,11.2,11.855062833472982,11.6,11.8,0,3.0,1.4428391846808215,1737.0463398516654
2012-12-02,12.5,12.6,12.7,12.4,14010.0,29.6,0.1,12.566666666666668,65.5387009998391,0.03807421750081741,13.069999999999883,10.95000000000012,12.074134664137741,81.81818181818187,0.35260201445381156,10635070.0,7.758620689655175,-0.007936507936507908,2.8208161156304925,2.8208161156304925,12.0,11.2,11.973354036786764,11.6,11.8,0,4.0,1.4430912886111353,1742.9054842025398
2012-12-03,12.7,12.5,12.7,12.5,26760.0,29.6,0.1,12.6,68.96611098475131,0.035647705014133724,13.06953597148313,11.130464028516869,12.133740886600814,100.0,0.34170187056425355,10661830.0,7.627118644067784,0.016000000000000014,2.6905659099547523,2.6905659099547523,12.0,11.2,12.075084471636618,11.6,11.8,0,5.0,1.4433593229135586,1748.9706364560825
2012-12-04,13.4,12.7,13.5,12.6,63250.0,29.6,0.1,12.866666666666667,77.42785627463797,0.07405206696203981,13.188068014212767,11.261931985787232,12.25433699263883,94.73684210526316,0.38158030838109264,10725080.0,14.529914529914539,0.0551181102362206,2.847614241649945,2.847614241649945,12.399999999999999,11.6,12.162572645607492,11.6,11.8,1,6.0,1.4436878501153507,1755.7734983772125
2012-12-05,13.4,13.4,13.4,13.1,29800.0,29.6,0.1,13.166666666666666,77.42785627463797,0.09119406555438614,13.307162537850392,11.36283746214961,12.363447755244657,94.44444444444447,0.3757531434967289,10754880.0,13.559322033898303,0.0,2.804127936542753,2.804127936542753,12.399999999999999,11.6,12.376561022310293,11.6,11.8,0,7.0,1.4440132753631962,1762.5637774504942
2012-12-06,13.3,13.4,13.7,12.9,46560.0,29.6,0.1,13.366666666666667,74.0812591926489,0.08752099872004737,13.435475499463397,11.384524500536603,12.452643207126119,77.77777777777784,0.40605649038981956,10708320.0,7.258064516129036,-0.007462686567164201,3.0530563187204476,3.0530563187204476,12.549999999999999,11.7,12.556311258740646,11.6,11.8,0,8.0,1.444326785613291,1769.2355166182606
2012-12-07,13.5,13.3,13.6,13.0,32800.0,29.6,0.1,13.4,76.2886403440739,0.08993982144954249,13.583990358083899,11.406009641916103,12.552391473114106,88.88888888888893,0.41990959821911816,10741120.0,8.87096774193548,0.015037593984962294,3.110441468289764,3.110441468289764,12.575,11.7,12.76217523216733,11.6,11.8,0,9.0,1.4446548293976735,1776.1052454030432
2012-12-08,13.4,13.5,13.6,13.4,13170.0,29.6,0.1,13.4,72.94357089457992,0.07669983366240135,13.660685827739535,11.509314172260467,12.633116094722286,83.33333333333339,0.4042017697748954,10727950.0,8.064516129032258,-0.007407407407407418,3.0164311177231,3.0164311177231,12.65,11.7,12.9,11.6,11.8,0,10.0,1.4449710459244134,1782.856765843793
2012-12-09,13.4,13.4,13.5,13.0,28170.0,29.6,0.1,13.433333333333335,72.94357089457992,0.06054622078891925,13.733222823197332,11.59677717680267,12.706152657129689,83.33333333333339,0.41104450050526,10756120.0,7.200000000000002,0.0,3.067496272427313,3.067496272427313,12.65,11.7,13.7,13.4,11.8,0,11.0,1.445284224852554,1789.5950350503804
2012-12-10,13.4,13.4,13.6,13.3,24670.0,29.6,0.1,13.4,72.94357089457992,0.04327520615260244,13.766857905510731,11.733142094489272,12.77223335645067,83.33333333333339,0.40311275046916994,10780790.0,8.943089430894306,0.0,3.0083041079788804,3.0083041079788804,12.675,11.7,13.686,13.4,11.8,0,12.0,1.4455943820389776,1796.3198891968113
2012-12-11,13.6,13.4,13.7,13.3,28050.0,29.6,0.1,13.466666666666669,75.614492317826,0.03887410068028202,13.822649479722886,11.857350520277114,12.85106827488394,93.75000000000001,0.40289041114994345,10808840.0,11.475409836065577,0.014925373134328401,2.9624294937495845,2.9624294937495845,12.774999999999999,11.7,13.0,13.4,11.8,0,13.0,1.4459188943302586,1803.243336015932
2012-12-12,13.7,13.6,13.8,13.3,37680.0,29.6,0.1,13.566666666666668,76.84528461143907,0.03629994984108309,13.933542658327623,11.87645734167238,12.931918915371185,94.11764705882345,0.4098268103535189,10846520.0,10.483870967741925,0.007352941176470562,2.991436571923496,2.991436571923496,12.925,11.75,13.014,13.4,13.7,0,14.0,1.446248931229278,1810.2592034201682
2012-12-13,13.7,13.7,13.8,13.5,24200.0,29.6,0.1,13.666666666666666,76.84528461143907,0.02854133870232778,14.026598315349613,11.913401684650385,13.005069494859644,92.85714285714275,0.4019820381854105,10870720.0,10.483870967741925,0.0,2.934175461207376,2.934175461207376,13.025,11.75,13.04544,13.4,13.7,0,15.0,1.446575903833959,1817.2625751709818
2012-12-14,13.6,13.7,13.9,13.0,70140.0,29.6,0.1,13.666666666666666,72.5958224798447,0.011493109637897125,14.086598315349608,11.973401684650387,13.061729542968248,79.99999999999996,0.43755474974359554,10800580.0,7.936507936507936,-0.007299270072992692,3.2173143363499674,3.2173143363499674,13.075,11.8,13.8,13.4,13.7,1,16.0,1.4468912728210461,1824.147450523221
2012-12-15,13.5,13.6,13.6,13.4,15190.0,29.6,0.1,13.6,68.51553753683211,-0.010510170755800352,14.126135746449583,12.033864253550414,13.10346958649508,73.33333333333331,0.42058655333333866,10785390.0,7.142857142857145,-0.007352941176470562,3.1154559506173234,3.1154559506173234,13.1,11.8,13.8,13.4,13.7,0,17.0,1.447195030346127,1830.912115276402
2012-12-16,13.3,13.5,13.7,13.1,42760.0,29.6,0.1,13.466666666666669,61.11685277143258,-0.040823544587078486,14.116103442849495,12.143896557150507,13.122186768733645,57.14285714285718,0.43340179952381447,10742630.0,6.400000000000006,-0.014814814814814725,3.2586601467955973,3.2586601467955973,13.1,11.8,13.9,13.4,13.7,0,18.0,1.4474784404572236,1837.4460856071573
2012-12-17,13.3,13.3,13.5,12.8,63630.0,29.6,0.1,13.366666666666667,61.11685277143258,-0.061899868965656024,14.07556162055167,12.294438379448328,13.139121362187584,53.8461538461539,0.45244452812925623,10806260.0,4.72440944881891,0.0,3.401838557362829,3.401838557362829,13.075000000000001,11.850000000000001,13.882,13.4,13.7,0,19.0,1.4477589679840266,1843.9650716988647
2012-12-18,13.3,13.3,13.4,13.1,23220.0,29.6,0.1,13.3,61.11685277143258,-0.07594065162533692,14.045107354892357,12.414892645107644,13.154443137217338,45.45454545454547,0.44155563326288083,10829480.0,-0.7462686567164152,0.0,3.319967167390081,3.319967167390081,13.125,12.100000000000001,13.83872,13.4,13.7,0,20.0,1.4480366279388983,1850.4689252601584
2012-12-19,13.6,13.3,13.6,13.2,38810.0,29.6,0.1,13.4,67.65954998730092,-0.06551726875682606,14.024574706888012,12.55542529311199,13.196877124149019,72.72727272727265,0.43858737374410367,10868290.0,1.4925373134328304,0.022556390977443552,3.2249071598831156,3.2249071598831156,13.125,12.100000000000001,13.797171200000001,13.4,13.7,0,21.0,1.4483373334297258,1857.2839136123948
2012-12-20,13.5,13.6,13.7,13.3,32980.0,29.6,0.1,13.466666666666667,63.805503227106215,-0.06568437025746876,14.002158152164538,12.66784184783546,13.22574596946816,63.63636363636359,0.4358311327623819,10835310.0,1.5037593984962352,-0.007352941176470562,3.228378761202829,3.228378761202829,13.125,12.100000000000001,13.757284352000001,13.4,13.7,0,22.0,1.4486265533579168,1863.976501094125
2012-12-21,13.5,13.5,13.6,13.4,25330.0,29.6,0.1,13.533333333333333,63.805503227106215,-0.06594914810396835,13.95827329179169,12.801726708208308,13.251865400947384,63.63636363636359,0.41898605185078314,10860640.0,0.0,0.0,3.103600384079875,3.103600384079875,13.125,12.100000000000001,13.718992977920001,13.4,13.7,0,23.0,1.4489128910449969,1870.6543760777713
2012-12-22,13.4,13.5,13.6,13.3,14780.0,29.6,0.1,13.466666666666669,59.85154047095481,-0.07249272243260407,13.839125584816482,13.010874415183519,13.265973458000015,54.54545454545453,0.4104870481471557,10845860.0,0.0,-0.007407407407407418,3.063336180202654,3.063336180202654,13.125,12.100000000000001,13.7,13.4,13.7,0,24.0,1.44918775872757,1877.2077291285282
2012-12-23,13.3,13.4,13.5,13.0,23980.0,29.6,0.1,13.4,56.10718073737674,-0.08246347419849598,13.71170995305907,13.198290046940933,13.269214081047632,45.45454545454547,0.41688083042235885,10821880.0,-0.7462686567164152,-0.007462686567164201,3.1344423340026983,3.1344423340026983,13.125,12.100000000000001,13.664,13.4,13.7,0,25.0,1.4494511461713173,1883.6348877751236
2012-12-24,13.4,13.3,13.4,13.2,16690.0,29.6,0.1,13.366666666666667,58.877718765725994,-0.08110814740126798,13.71170995305907,13.198290046940933,13.281669882852619,54.54545454545453,0.40138934253504754,10838570.0,0.0,0.007518796992481258,2.9954428547391605,2.9954428547391605,13.125,12.15,13.629439999999999,13.4,13.7,0,26.0,1.4497204020447407,1890.1570526192368
2012-12-25,13.4,13.4,13.4,13.1,13170.0,29.6,0.1,13.366666666666669,58.877718765725994,-0.07892180696091305,13.711709953059067,13.19829004694093,13.292939417819035,54.54545454545453,0.3941472466396871,10851740.0,-1.4705882352941124,0.0,2.9413973629827392,2.9413973629827392,13.2,12.2,13.596262399999999,13.4,13.7,0,27.0,1.4499868639771447,1896.6634834335798
2012-12-26,13.5,13.4,13.5,13.2,15840.0,29.6,0.1,13.433333333333332,61.68272975868039,-0.06976756970302317,13.712184141885333,13.217815858114667,13.31265947326484,63.63636363636359,0.38742244330828096,10867580.0,-1.459854014598535,0.00746268656716409,2.869795876357637,2.869795876357637,13.25,12.25,13.564411903999998,13.4,13.7,0,28.0,1.4502591097909687,1903.2647749856637
2012-12-27,13.4,13.5,13.5,13.3,19820.0,29.6,0.1,13.433333333333335,57.461680908956076,-0.06933038831386545,13.708193472918989,13.21180652708101,13.320977618668188,54.54545454545453,0.374035125929118,10847760.0,-2.1897810218978027,-0.007407407407407418,2.7913069099187906,2.7913069099187906,13.25,12.3,13.533835427839998,13.4,13.7,0,29.0,1.450520007745759,1909.7394548232596
2012-12-28,13.4,13.4,13.6,13.3,23810.0,29.6,0.1,13.433333333333335,57.461680908956076,-0.06784002207579368,13.708193472918989,13.21180652708101,13.328503559747407,66.66666666666673,0.3687469026484666,10871570.0,-1.4705882352941124,0.0,2.751842557078109,2.751842557078109,13.274999999999999,12.3,12.8,13.4,13.7,0,30.0,1.4507781549484717,1916.1979751486745
2012-12-29,13.4,13.4,13.7,13.3,26150.0,29.6,0.1,13.4,57.461680908956076,-0.06561304630597795,13.708193472918989,13.21180652708101,13.335312744533368,66.66666666666673,0.3709792667450046,10897720.0,-0.740740740740738,0.0,2.7685019906343626,2.7685019906343626,13.3,12.3,12.816,13.4,13.7,0,31.0,1.4510335656136757,1922.6401974537916
2012-12-30,13.4,13.4,13.6,13.4,11760.0,29.6,0.1,13.4,57.461680908956076,-0.0628915742972363,13.708193472918989,13.21180652708101,13.34147343553019,66.66666666666673,0.3587664619775042,10909480.0,0.7518796992481176,0.0,2.677361656548539,2.677361656548539,13.350000000000001,12.3,12.851360000000001,13.4,13.7,0,32.0,1.4512862538752433,1929.0659845720675
2012-12-31,13.5,13.4,13.6,13.4,15050.0,29.6,0.1,13.433333333333335,61.047065194107134,-0.05347771668438975,13.695624188309468,13.214375811690536,13.356571203574934,71.4285714285715,0.34742600040768246,10924530.0,1.5037593984962352,0.00746268656716409,2.573525928945796,2.573525928945796,13.350000000000001,12.3,12.8853056,13.4,13.7,0,33.0,1.4515447485002664,1935.5872708385648
2013-01-01,13.3,13.5,13.6,13.2,28410.0,29.6,0.1,13.4,51.66741213750933,-0.05938610401121783,13.656585198060682,13.213414801939315,13.35118346990113,42.857142857143,0.35118128609284804,10896120.0,0.0,-0.014814814814814725,2.6404607976905865,2.6404607976905865,13.375,12.3,12.917893376,13.3,13.7,0,34.0,1.4517834461021903,1941.8667442529145
2013-01-02,13.3,13.3,13.4,13.2,17970.0,29.6,0.1,13.366666666666669,51.66741213750933,-0.0616895644910532,13.607613602841532,13.22238639715847,13.346308853720071,42.857142857143,0.3403826228005018,10914090.0,-2.2058823529411686,0.0,2.5592678406052767,2.5592678406052767,13.375,12.350000000000001,12.94917764096,13.3,13.7,0,35.0,1.4520194922666512,1948.128987667598
2013-01-03,13.4,13.3,13.5,13.3,18030.0,29.6,0.1,13.333333333333336,55.62139683229915,-0.05509040607983226,13.57791616465674,13.232083835343262,13.351422296222921,57.14285714285725,0.3303552926004659,10932120.0,-0.740740740740738,0.007518796992481258,2.465338004481089,2.465338004481089,13.4,12.350000000000001,12.9792105353216,13.3,13.7,0,36.0,1.4522614500422766,1954.4875548732225
2013-01-04,13.5,13.4,13.5,13.3,29640.0,29.6,0.1,13.4,59.2146195437407,-0.043131635229498116,13.57791616465674,13.232083835343262,13.3655725537255,71.4285714285715,0.32104420027186115,10961760.0,0.0,0.00746268656716409,2.3781051871989716,2.3781051871989716,13.4,12.350000000000001,13.008042113908736,13.3,13.5,0,37.0,1.4525092310260084,1960.9421214963218
2013-01-05,13.4,13.5,13.6,13.3,21330.0,29.6,0.1,13.433333333333335,54.46546395068703,-0.04110568870639211,13.576132477257147,13.243867522742857,13.368851358132595,57.14285714285725,0.31954104310958525,10940430.0,0.0,-0.007407407407407418,2.384634650071532,2.384634650071532,13.4,12.4,13.035720429352386,13.3,13.5,0,38.0,1.4527458774970763,1967.2664904561987
2013-01-06,13.4,13.4,13.5,13.4,12740.0,29.6,0.1,13.433333333333335,54.46546395068704,-0.03893619294411421,13.573429795176272,13.25657020482373,13.371817895453301,50.00000000000015,0.3038595400303291,10953170.0,0.7518796992481176,0.0,2.2676085076890233,2.2676085076890233,13.4,12.55,13.06229161217829,13.3,13.5,0,39.0,1.4529798982849376,1973.5735016303042
2013-01-07,13.6,13.4,13.6,13.4,25480.0,29.6,0.1,13.466666666666669,61.60765491513416,-0.023938175629279107,13.598522995462321,13.261477004537682,13.393549524457747,83.33333333333339,0.29644100145673413,10978650.0,1.4925373134328304,0.014925373134328401,2.1797132460053983,2.1797132460053983,13.375,12.7,13.087799947691158,13.3,13.5,0,40.0,1.4532281395990747,1980.08992584468
2013-01-08,13.7,13.6,13.9,13.5,42800.0,29.6,0.1,13.566666666666668,64.59769346685988,-0.008012916823068206,13.627613602841523,13.242386397158475,13.422735284033198,71.42857142857132,0.30383807278125313,11021450.0,2.2388059701492455,0.007352941176470562,2.2177961516879794,2.2177961516879794,13.450000000000001,12.75,13.11228794978351,13.3,13.5,0,41.0,1.4534820399768846,1986.701982850919
2013-01-09,13.8,13.7,13.9,13.6,28610.0,29.6,0.1,13.700000000000001,67.33718778937732,0.007676953662706737,13.698997991958953,13.201002008041046,13.458665256982417,85.7142857142858,0.3035639247254494,11050060.0,2.2222222222222276,0.007299270072992803,2.1997385849670246,2.1997385849670246,13.450000000000001,12.75,13.1595506727965,13.3,13.5,0,42.0,1.4537415153431619,1993.4093881502483
2013-01-10,14.1,13.8,14.3,13.8,51810.0,29.6,0.1,13.866666666666667,73.86980770341592,0.035142833805564544,13.857359245281717,13.102640754718283,13.519744756317426,81.81818181818174,0.31759507295934586,11101870.0,5.22388059701492,0.021739130434782483,2.2524473259528075,2.2524473259528075,13.65,12.95,13.20397763242871,13.3,13.5,1,43.0,1.4540226597572115,2000.4322768972584
2013-01-11,14.1,14.1,14.4,13.9,40440.0,29.6,0.1,14.0,73.86980770341592,0.049324485067750556,13.976627555502901,13.0533724444971,13.575007160477671,74.99999999999996,0.33062399631939254,11142310.0,5.22388059701492,0.0,2.344851037726188,2.344851037726188,13.725000000000001,13.0,13.291659421834414,13.3,13.5,0,44.0,1.4543010526137659,2007.4399814964645
2013-01-12,14.2,14.1,14.3,14.0,26930.0,29.6,0.1,14.133333333333333,75.74514989098284,0.060705759335561105,14.098144961882555,13.021855038117442,13.634530288051227,83.33333333333326,0.32843656801086457,11169240.0,5.970149253731335,0.007092198581560183,2.3129335775413,2.3129335775413,13.775,13.05,13.402493479650973,13.3,13.5,0,45.0,1.4545846924452401,2014.5419416150653
2013-01-13,14.1,14.2,14.3,13.9,38330.0,29.6,0.1,14.133333333333333,70.31083434050785,0.056833292883263886,14.176291665172977,13.01370833482702,13.678860736808254,74.99999999999996,0.33354824172437425,11130910.0,5.22388059701492,-0.007042253521126751,2.365590366839534,2.365590366839534,13.775,13.15,13.502244131685876,13.3,13.5,0,46.0,1.4548576061220957,2021.518970348532
2013-01-14,14.3,14.1,14.4,14.1,22100.0,29.6,0.1,14.200000000000001,74.28456619191972,0.06261884292666647,14.289307323229586,12.990692676770415,13.73801685711223,91.6666666666667,0.33115193874406185,11153010.0,5.925925925925931,0.014184397163120588,2.315747823385048,2.315747823385048,13.8,13.15,13.592019718517289,13.3,13.5,0,47.0,1.455143687409598,2028.6998811420178
2013-01-15,14.3,14.3,14.5,14.0,51570.0,29.6,0.1,14.233333333333334,74.28456619191972,0.061248308736206986,14.385974503788605,12.974025496211398,13.79153906119678,84.61538461538468,0.3432125145480574,11204580.0,7.518796992481203,0.0,2.4000875143220797,2.4000875143220797,13.85,13.2,13.67281774666556,13.3,13.5,0,48.0,1.4554270194552035,2035.8658614253359
2013-01-16,14.7,14.3,14.7,14.2,45530.0,29.6,0.1,14.433333333333335,80.37672715270651,0.08085179349351515,14.565914124619352,12.92408587538065,13.87805915060661,100.0,0.35441162065176757,11250110.0,10.526315789473673,0.027972027972027913,2.4109634057943374,2.4109634057943374,13.975,13.3,13.772079617065693,13.3,13.5,0,49.0,1.4557386463120456,2043.4490170993975
2013-01-17,15.5,14.7,15.7,14.6,65489.99999999999,29.6,0.1,14.833333333333334,87.00669908409903,0.13791652786386788,14.95544108843463,12.744558911565369,14.032529707691696,91.6666666666667,0.4076679334623555,11315600.0,15.671641791044774,0.054421768707483054,2.630115699757132,2.630115699757132,14.5,13.8,13.901988470676496,13.3,13.5,1,50.0,1.4561069864522551,2051.8515888249954
2013-01-18,15.7,15.5,16.0,15.4,56100.0,29.6,0.1,15.299999999999999,88.09006308537681,0.1768648821207286,15.311514017750847,12.618485982249153,14.19133640219725,88.88888888888886,0.4214059382150444,11371700.0,16.29629629629629,0.012903225806451646,2.68411425614678,2.68411425614678,14.725000000000001,14.05,14.189670315368257,13.3,13.5,0,51.0,1.4564867061681996,2060.4466898357778
2013-01-19,15.6,15.7,15.8,15.3,34590.0,29.6,0.1,15.6,84.30508505897255,0.18286809321807307,15.570158854436382,12.579841145563616,14.325494840083225,84.6153846153846,0.42701979977111265,11337110.0,16.417910447761187,-0.006369426751592355,2.737306408789184,2.737306408789184,14.75,14.05,14.51552965860197,13.3,13.5,0,52.0,1.45685622114752,2068.931900674876
2013-01-20,15.7,15.6,15.9,15.5,25980.0,29.6,0.1,15.666666666666666,84.99920634391785,0.1802539679796345,15.812605603332546,12.557394396667451,14.456400093408632,88.46153846153842,0.4250898140731761,11363090.0,17.164179104477604,0.0064102564102563875,2.707578433587109,2.707578433587109,14.774999999999999,14.2,14.782734320053615,13.3,13.5,0,53.0,1.4572298883079278,2077.5089786106005
2013-01-21,16.8,15.7,17.0,15.6,61500.0,29.6,0.1,16.033333333333335,90.15635544387949,0.23578252859911814,16.293287355775004,12.426712644225004,14.679600084512572,94.2857142857143,0.4947262559250921,11424590.0,23.52941176470589,0.07006369426751591,2.9447991424112625,2.9447991424112625,15.274999999999999,14.7,15.001842142443964,13.3,13.5,0,54.0,1.457676288535353,2087.1552584957126
2013-01-22,17.3,16.8,17.6,16.6,60980.0,29.6,0.1,16.599999999999998,91.57431172436875,0.28601490503189764,16.81424044857674,12.305759551423257,14.92916198122566,92.49999999999999,0.5308172376447284,11485570.0,26.277372262773735,0.029761904761904656,3.068307732050453,3.068307732050453,15.600000000000001,15.0,15.401473713955172,13.3,13.5,0,55.0,1.4581522085093932,2097.2672057968084
2013-01-23,17.5,17.3,17.6,16.8,49440.0,29.6,0.1,17.200000000000003,92.0665908756878,0.31049728667417864,17.28949995048513,12.240500049514862,15.174003697299407,97.36842105263155,0.5500445778129622,11535010.0,26.811594202898544,0.01156069364161838,3.143111873216927,3.143111873216927,15.600000000000001,15.05,15.6,13.3,13.5,0,56.0,1.4586376164610861,2107.5631746582712
2013-01-24,16.9,17.5,19.2,15.6,172010.0,29.6,0.1,17.233333333333334,77.44752743019663,0.2657948463635629,17.552078523850483,12.317921476149515,15.338384297556606,56.60377358490564,0.7678985365406078,11363000.0,19.858156028368786,-0.034285714285714364,4.54377832272549,4.54377832272549,16.45,15.899999999999999,17.6,16.9,13.5,1,57.0,1.4590807646988229,2117.2973766290615
2013-01-25,17.4,16.9,17.8,15.4,80770.0,29.6,0.1,17.266666666666666,80.26045224746044,0.2496657057537668,17.861371214636666,12.408628785363334,15.534728650170262,66.03773584905659,0.8844772125019931,11443770.0,23.404255319148927,0.029585798816567976,5.08320237070111,5.08320237070111,16.549999999999997,16.0,15.6,16.9,13.5,0,58.0,1.4595531590821043,2127.499712401149
2013-01-26,17.9,17.4,17.9,16.5,34810.0,29.6,0.1,17.400000000000002,82.59793982186537,0.25172223339695265,18.21615125649875,12.503848743501253,15.759992588249284,75.47169811320752,0.9213002687518506,11478580.0,26.056338028169012,0.028735632183908066,5.146928875708663,5.146928875708663,16.725,16.0,15.6,16.9,17.9,0,59.0,1.4600537534397722,2138.1614395923543
2013-01-27,17.8,17.9,18.0,17.2,23770.0,29.6,0.1,17.7,80.54366667990772,0.2262050548301816,18.494448665988063,12.645551334011934,15.954279008416018,73.0769230769231,0.9126359638410041,11454810.0,26.24113475177306,-0.005586592178770777,5.127168336185417,5.127168336185417,16.725,16.0,15.4,16.9,17.9,0,60.0,1.4605447213913247,2148.7339743045
2013-01-28,18.7,17.8,18.9,17.8,57670.0,29.6,0.1,18.133333333333336,84.32274707262566,0.2480449608092017,18.9123130501292,12.727686949870805,16.21577624570973,90.38461538461539,0.9260191092809322,11512480.0,30.76923076923076,0.050561797752809,4.9519738464220975,4.9519738464220975,16.775,16.0,15.556000000000001,16.9,17.9,0,61.0,1.4610870707801131,2160.1154177031517
2013-01-29,19.5,18.7,19.8,18.7,86080.0,29.6,0.1,18.666666666666668,86.78066273376398,0.2914753749403973,19.441150476222454,12.768849523777545,16.52855946040404,94.64285714285714,0.9384463157608657,11598560.0,36.36363636363636,0.04278074866310155,4.81254520903008,4.81254520903008,17.075000000000003,16.3,15.82352,16.9,17.9,0,62.0,1.4616723355183256,2172.1927741744153
2013-01-30,19.7,19.5,19.8,19.1,45070.0,29.6,0.1,19.3,87.3160596846902,0.3072066776001152,19.93423935512939,12.835760644870609,16.830601416556036,98.07692307692305,0.9214144360636609,11643630.0,34.01360544217687,0.01025641025641022,4.6772306399170605,4.6772306399170605,17.075000000000003,16.3,16.221168,16.9,17.9,0,63.0,1.4622652367672941,2184.4506815273253
2013-01-31,20.4,19.7,21.4,19.5,99230.0,29.6,0.1,19.866666666666667,88.9959183452652,0.3359606986793704,20.492097045171608,12.90790295482839,17.170544138788795,83.60655737704917,0.9913134049162565,11742860.0,31.612903225806445,0.035532994923857864,4.859379435864003,4.859379435864003,17.9,17.1,16.5790512,16.9,17.9,0,64.0,1.462893080122699,2197.3014873958577
2013-02-01,20.5,20.4,21.1,20.3,49920.0,29.6,0.1,20.2,89.21565324497332,0.3323134533925143,20.967353729108673,13.062646270891328,17.48763517318986,85.24590163934427,0.9776481617079525,11792780.0,30.573248407643316,0.004901960784313708,4.769015422965622,4.769015422965622,17.9,17.1,17.157565056,16.9,17.9,0,65.0,1.463522533799374,2210.2514614725196
2013-02-02,19.6,20.5,20.5,18.0,80500.0,29.6,0.1,20.166666666666668,74.74872806678601,0.24397384329089844,21.157247082874225,13.422752917125774,17.68881277574321,70.00000000000004,1.086387578728813,11712280.0,25.641025641025657,-0.04390243902439017,5.542793769024556,5.542793769024556,17.924999999999997,17.1,17.66665724928,16.9,17.9,0,66.0,1.4640986373625897,2222.466289679279
2013-02-03,20.6,19.6,20.9,19.4,34240.0,29.6,0.1,20.233333333333334,78.85212938923871,0.22787910353683527,21.47306153001722,13.736938469982773,17.966068701862902,86.66666666666671,1.1159313231053265,11746520.0,31.210191082802563,0.05102040816326525,5.417142345171488,5.417142345171488,18.225,17.1,18.0,16.9,17.9,0,67.0,1.4647259952198646,2235.5309014668314
2013-02-04,20.4,20.6,21.0,19.9,52220.0,29.6,0.1,20.2,76.18558854005796,0.1808091826007423,21.647325246750565,14.172674753249435,18.197871682637864,83.33333333333333,1.114793371454946,11694300.0,21.428571428571416,-0.009708737864077777,5.46467338948503,5.46467338948503,18.45,17.1,18.0,16.9,17.9,0,68.0,1.465338831519629,2248.448256455325
2013-02-05,20.6,20.4,20.8,20.2,29210.0,29.6,0.1,20.533333333333335,77.02239357549571,0.14190706604953407,21.811369365442083,14.598630634557914,18.426645808100925,86.66666666666671,1.0780224163510215,11723510.0,19.075144508670526,0.009803921568627638,5.233118525975832,5.233118525975832,18.625,17.1,18.408,16.9,17.9,0,69.0,1.4659586782940512,2261.547848638665
2013-02-06,21.2,20.6,21.3,20.6,51990.0,29.6,0.1,20.733333333333334,79.3649782655048,0.13536731490111742,22.097159547344578,14.882840452655426,18.69077477875798,96.66666666666667,1.0510208151830913,11775500.0,21.14285714285714,0.029126213592232997,4.957645354637223,4.957645354637223,18.674999999999997,17.1,18.76704,16.9,17.9,0,70.0,1.4666063368197155,2275.1557581694647
2013-02-07,22.1,21.2,22.2,20.8,64260.00000000001,29.6,0.1,21.3,82.28281609140069,0.16829126163823394,22.504807166821983,15.115192833178012,19.015462895066744,98.52941176470591,1.0759478998128704,11839760.0,30.769230769230788,0.04245283018867929,4.8685425330899115,4.8685425330899115,19.075000000000003,17.6,19.082995200000003,16.9,17.9,0,71.0,1.4672958123151787,2289.49980084806
2013-02-08,22.7,22.1,22.8,22.0,48650.0,29.6,0.1,22.0,83.91568805096529,0.20469549300653322,22.921740608559375,15.408259391440621,19.36637119077467,98.41269841269839,1.0562373355405226,11888410.0,30.459770114942536,0.02714932126696823,4.6530279098701435,4.6530279098701435,19.4,17.9,19.519375872,16.9,17.9,0,72.0,1.468010706428089,2304.3345747962453
2013-02-09,23.6,22.7,24.0,22.6,38130.0,29.6,0.1,22.8,85.99999455999745,0.2600514861049681,23.43577089106142,15.684229108938577,19.769573934510415,94.11764705882355,1.0807918115733421,11926540.0,31.84357541899443,0.0396475770925111,4.579626320226026,4.579626320226026,20.0,18.5,20.044275732480003,16.9,17.9,0,73.0,1.468764158695125,2319.8772254094074
2013-02-10,24.0,23.6,24.1,22.7,56430.0,29.6,0.1,23.433333333333337,86.81762122903174,0.29188268182088084,24.0336844798792,15.806315520120798,20.17247165503323,98.41269841269839,1.1035923964609606,11982970.0,34.8314606741573,0.016949152542372836,4.59830165192067,4.59830165192067,20.1,18.55,20.7563061006336,16.9,17.9,0,74.0,1.4695318482413433,2335.7521754362624
2013-02-11,24.6,24.0,24.7,23.6,29530.0,29.6,0.1,24.066666666666666,87.95405387992938,0.3193986195003711,24.68921389126357,15.880786108736435,20.59414102122054,98.5074626865672,1.103335796713749,12012500.0,31.550802139037447,0.025000000000000133,4.485104864690036,4.485104864690036,20.849999999999998,18.85,21.42504488050688,16.9,17.9,0,75.0,1.4703223337087734,2352.102719905616
2013-02-12,25.2,24.6,25.8,24.3,74240.0,29.6,0.1,24.599999999999998,88.97739159197882,0.34203943206044185,25.369404217557683,15.97059578244232,21.032794257294775,92.30769230769228,1.1316689540913383,12086740.0,29.230769230769226,0.024390243902439046,4.4907498178227705,4.4907498178227705,21.700000000000003,19.4,22.080035904405506,16.9,17.9,0,76.0,1.4711348678360958,2368.9253624724183
2013-02-13,24.2,25.2,26.3,24.2,90150.0,29.6,0.1,24.666666666666668,77.20518291327454,0.2575499026745742,25.639465224105713,16.430534775894287,21.334432899457177,74.69879518072287,1.2008354573705284,11996590.0,22.842639593908633,-0.03968253968253965,4.962129989134415,4.962129989134415,22.025,19.7,22.824028723524403,24.2,17.9,0,77.0,1.471898910106954,2385.076330139255
2013-02-14,27.2,24.2,27.6,21.7,145740.0,29.6,0.1,25.53333333333333,84.03108031922869,0.3650258781048068,26.544910357765247,16.50508964223475,21.89305833760411,95.83333333333331,1.5364900675583482,12142330.0,33.333333333333336,0.12396694214876036,5.648860542493928,5.648860542493928,22.8,20.35,26.3,24.2,17.9,1,78.0,1.4727861105216258,2403.363751313222
2013-02-15,27.1,27.2,27.5,26.1,51710.0,29.6,0.1,26.166666666666668,83.13739731660604,0.38852131908815624,27.270934165310685,16.69906583468932,22.388957543546578,94.79166666666667,1.526740777018466,12090620.0,32.19512195121952,-0.00367647058823517,5.633729804496184,5.633729804496184,22.85,20.4,21.7,24.2,17.9,0,79.0,1.473664744252546,2421.649822580977
2013-02-16,27.2,27.1,27.5,26.8,18830.0,29.6,0.1,27.166666666666668,83.32834176375881,0.3700257323003373,27.83959840656652,17.070401593433484,22.84715206320881,95.12195121951217,1.4676878643742897,12109450.0,38.77551020408162,0.0036900369003689537,5.3959112660819475,5.3959112660819475,23.075,20.4,21.7,24.2,27.2,0,80.0,1.4745428574049986,2440.066828404703
2013-02-17,26.8,27.2,27.4,25.0,77040.0,29.6,0.1,27.03333333333333,79.45276693409306,0.29342835662761724,28.27235623365634,17.44764376634366,23.22361377147464,89.6103896103896,1.5342815883475545,12032410.0,30.09708737864077,-0.014705882352941124,5.724931299804307,5.724931299804307,23.075,20.4,21.816,24.2,27.2,0,81.0,1.4754003640633166,2458.2772728985988
2013-02-18,27.0,26.8,27.1,26.4,29740.0,29.6,0.1,27.0,79.95477310010568,0.22205108201585944,28.703189828453162,17.766810171546844,23.58326960276277,91.89189189189189,1.4746900463227293,12062150.0,32.352941176470594,0.00746268656716409,5.461814986380479,5.461814986380479,23.075,20.4,21.929679999999998,24.2,27.2,0,82.0,1.4762614905993363,2476.6854715534528
2013-02-19,29.4,27.0,29.6,26.8,99700.0,29.6,0.1,27.733333333333334,84.76498762282796,0.2975801413660806,29.556300197899223,17.883699802100775,24.13724392630917,97.77777777777776,1.5693550430139631,12161850.0,42.71844660194173,0.0888888888888888,5.337942323176746,5.337942323176746,24.075,21.4,22.041086399999998,24.2,27.2,0,83.0,1.4772104465159774,2496.734561987461
2013-02-20,29.6,29.4,29.9,29.0,37210.0,29.6,0.1,28.666666666666668,85.08616593582836,0.32015078096274063,30.338441361253548,18.021558638746452,24.657506409517822,96.70329670329674,1.5215439685129657,12199060.0,39.622641509433976,0.006802721088435382,5.140351244976235,5.140351244976235,24.5,21.549999999999997,22.343442943999996,24.2,27.2,0,84.0,1.4781620134726439,2516.9919073595647
2013-02-21,29.8,29.6,30.0,29.3,34730.0,29.8,0.1,29.600000000000005,85.41724197741782,0.3076152304194202,31.022295665091782,18.267704334908224,25.147267703849458,97.59036144578313,1.4628622564763254,12233790.0,34.84162895927601,0.006756756756756799,4.90893374656485,4.90893374656485,24.725,21.6,22.796836367359997,24.2,27.2,0,85.0,1.4791161315964791,2537.4589201050085
2013-02-22,30.3,29.8,31.3,29.7,66950.0,30.3,0.1,29.900000000000002,86.23965943773153,0.2921771161007891,31.569866978271012,18.790133021728987,25.63800411300665,89.58333333333333,1.4726578095851595,12300740.0,33.48017621145375,0.016778523489932917,4.8602567973107575,4.8602567973107575,25.525,22.25,23.373089457971197,24.2,27.2,0,86.0,1.4800834899733613,2558.3255801937544
2013-02-23,29.8,30.3,30.7,28.0,72280.0,30.3,0.1,29.96666666666667,81.30181314358943,0.21124542793604384,31.96910736202178,19.310892637978228,26.034384673672687,84.375,1.5603251089005052,12228460.0,26.271186440677962,-0.01650165016501648,5.235990298323843,5.235990298323843,26.4,22.3,24.165780512174077,24.2,27.2,0,87.0,1.4810281248798227,2578.9628986902953
2013-02-24,29.9,29.8,30.4,29.2,24280.0,30.3,0.1,30.0,81.5295962970424,0.13131533656257188,32.221807676683305,20.008192323316692,26.40253851427529,85.41666666666664,1.5345876011218977,12252740.0,24.583333333333325,0.003355704697986406,5.132400003752167,5.132400003752167,26.4,22.3,24.87920246095667,24.2,27.2,0,88.0,1.4819716794460676,2599.7483376873765
2013-02-25,30.4,29.9,30.4,29.5,26780.0,30.4,0.1,30.03333333333333,82.66659674087748,0.08143086543440692,32.42925102480981,20.780748975190193,26.783249131963355,90.62499999999997,1.4892599153274764,12279520.0,23.57723577235771,0.01672240802675584,4.898881300419331,4.898881300419331,26.4,22.3,25.521282214861003,24.2,27.2,0,89.0,1.4829284080284615,2620.9390886731817
2013-02-26,31.1,30.4,31.7,30.1,42860.0,31.1,0.1,30.46666666666667,84.138692154703,0.06557136875175962,32.680322571321305,21.519677428678698,27.19436826225256,94.00000000000003,1.4971699213755136,12322380.0,23.412698412698422,0.023026315789473673,4.814051194133484,4.814051194133484,26.95,22.55,26.0991539933749,24.2,27.2,0,90.0,1.4839049033123564,2642.661970434412
2013-02-27,30.9,31.1,31.6,30.8,30470.0,31.1,0.1,30.8,81.99599209031108,0.014284100051944915,32.85541155509128,22.22458844490872,27.54728557060946,91.99999999999999,1.4473720698486914,12291910.0,27.685950413223136,-0.006430868167202619,4.68405200598282,4.68405200598282,27.05,22.55,26.771255514169912,24.2,27.2,0,91.0,1.484869691241478,2664.351934350015
2013-02-28,33.4,30.9,34.5,30.9,126520.0,33.4,0.1,31.8,86.59234327954496,0.11575508952950253,33.48716222964517,22.662837770354823,28.10468694483713,88.42105263157893,1.6011312077166422,12418430.0,22.79411764705882,0.08090614886731395,4.793806011127671,4.793806011127671,29.1,24.0,27.362704852469523,24.2,27.2,1,92.0,1.4859132456939572,2687.6736443639234
2013-03-01,34.5,33.4,34.9,32.9,39790.0,34.5,0.1,32.93333333333334,88.03924776495921,0.21804416026350726,34.30809282624657,22.931907173753423,28.713764378662166,95.95959595959597,1.6296218357368821,12458220.0,27.306273062730618,0.03293413173652704,4.723541552860528,4.723541552860528,29.424999999999997,24.25,28.36192617312379,24.2,27.2,0,93.0,1.486986563132441,2711.755013699258
2013-03-02,34.3,34.5,34.8,33.2,36660.0,34.5,0.1,34.06666666666666,86.21743363483526,0.23202389665762002,34.92093985450918,23.349060145490824,29.24578681878958,93.93939393939392,1.6275059903271045,12421560.0,26.10294117647058,-0.005797101449275477,4.744915423694183,4.744915423694183,29.5,24.35,29.408017985423985,24.2,27.2,0,94.0,1.4880485880361194,2735.841721105903
2013-03-03,34.5,34.3,34.5,33.8,12530.0,34.5,0.1,34.43333333333333,86.5178824771496,0.21491844837438556,35.472978692413456,23.787021307586553,29.746188074142953,95.29411764705884,1.5612555624465971,12434090.0,28.731343283582085,0.005830903790087438,4.525378441874195,4.525378441874195,29.6,24.4,30.286735107756147,24.2,27.2,0,95.0,1.4891118087283657,2760.1666867788094
2013-03-04,36.2,34.5,36.7,34.2,46770.0,36.2,0.1,35.0,88.76065425670008,0.27446275752901794,36.31501426241191,24.044985737588092,30.36083682898648,94.94949494949495,1.6283087365575546,12480860.0,34.07407407407408,0.049275362318840665,4.498090432479432,4.498090432479432,30.85,25.3,31.024857490515164,24.2,27.2,0,96.0,1.49022141176177,2785.5968179314036
2013-03-05,40.3,36.2,40.7,36.2,85430.0,40.3,0.1,37.0,92.15163751797242,0.531465075634832,37.94036483586573,24.029635164134277,31.307423797654433,96.85039370078736,1.833429541089158,12566290.0,37.074829931972786,0.11325966850828717,4.549452955556223,4.549452955556223,33.150000000000006,27.3,32.04638314222243,24.2,27.2,0,97.0,1.4914403941676233,2813.3761748970333
2013-03-06,41.0,40.3,49.1,40.1,126450.0,41.0,0.1,39.166666666666664,92.56412930923288,0.6805663887708597,39.65419168838532,23.69580831161468,32.230526293115915,61.611374407582936,2.3453274310113605,12692740.0,38.51351351351351,0.017369727047146455,5.720310807344782,5.720310807344782,37.5,31.55,33.777106513777944,24.2,27.2,1,98.0,1.4926722386162865,2841.6862717464523
2013-03-07,42.0,41.0,45.5,33.3,157320.0,42.0,0.1,41.099999999999994,93.12039989383811,0.7718154558496959,41.28467145471265,23.555328545287352,33.16095236043821,66.35071090047393,3.0492326145105495,12850060.0,40.93959731543624,0.024390243902439046,7.260077653596546,7.260077653596546,37.675,31.55,49.1,24.2,27.2,1,99.0,1.4939242173602538,2870.6810829087453
2013-03-08,44.2,42.0,44.5,41.0,47100.0,44.2,0.1,42.400000000000006,94.15616155554106,0.8968425020410349,43.169313107483624,23.370686892516368,34.21229023087267,76.77725118483413,3.081430284902653,12897160.0,45.87458745874588,0.05238095238095242,6.971561730548989,6.971561730548989,37.7,31.65,49.1,24.2,27.2,0,100.0,1.495224933986584,2900.9460696246615
2013-03-09,46.8,44.2,47.0,43.4,44480.0,46.8,0.1,44.333333333333336,95.09587151120954,1.059969786845473,45.326057163383204,23.213942836616802,35.41111973269432,88.44221105527636,3.118470978838178,12941640.0,57.046979865771796,0.0588235294117645,6.663399527432004,6.663399527432004,38.2,31.85,48.784,24.2,27.2,0,101.0,1.496580671996582,2932.642159980454
2013-03-10,46.0,46.8,48.0,45.5,36360.0,46.8,0.1,45.666666666666664,90.28511785606598,1.0190302187296947,46.863642041904114,23.576357958095898,36.41958452005676,84.18367346938776,3.0742944803497365,12905280.0,53.846153846153854,-0.017094017094017033,6.683248870325515,6.683248870325515,38.275000000000006,32.2,48.47432,24.2,27.2,0,102.0,1.4979121914463072,2964.194602921435
2013-03-11,48.4,46.0,48.5,45.5,41390.0,48.4,0.1,47.06666666666666,91.6498614793451,1.054225568664906,48.816438233747746,23.523561766252257,37.56057647052754,96.3157894736842,3.0689877317533267,12946670.0,59.21052631578948,0.05217391304347818,6.3408837432919976,6.3408837432919976,38.3,32.2,33.3,24.2,48.4,0,103.0,1.4992918367703478,2997.0814716890955
2013-03-12,44.3,48.4,48.4,36.7,183410.0,48.4,0.1,46.23333333333333,72.82777110412873,0.7180782037211442,49.646973944408956,24.163026055591047,38.202426330477294,73.77049180327866,3.68548860805666,12763260.0,42.44372990353696,-0.08471074380165289,8.31938737710307,8.31938737710307,39.125,32.25,33.604,44.3,48.4,1,104.0,1.5005717105523326,3028.25873343848
2013-03-13,46.9,44.3,47.3,43.8,49520.0,48.4,0.1,46.53333333333333,76.16998696585097,0.5927435216224257,50.772209650939246,24.74779034906075,39.03076667995565,87.9120879120879,3.6722394217668985,12812780.0,51.779935275080916,0.05869074492099324,7.829934801208739,7.829934801208739,39.125,32.25,33.90192,44.3,48.4,0,105.0,1.5019063078009878,3060.9152679711187
2013-03-14,47.2,46.9,48.0,46.0,37040.0,48.4,0.1,46.13333333333333,76.52872587840687,0.4579807869859067,51.76379553758613,25.44620446241388,39.80878890091225,88.27160493827162,3.552793748783549,12849820.0,41.31736526946109,0.006396588486140775,7.527105399965145,7.527105399965145,39.125,32.25,34.1938816,44.3,48.4,0,106.0,1.5032418309378295,3093.947247302114
2013-03-15,47.0,47.2,47.5,46.4,20290.0,48.4,0.1,47.03333333333333,75.7104430840073,0.2914205541425643,52.45673198615167,26.47326801384833,40.49366614844441,86.79245283018868,3.37759419529901,12829530.0,36.231884057971016,-0.00423728813559332,7.186370628295766,7.186370628295766,39.325,32.25,34.480003968,44.3,48.4,0,107.0,1.504567054892493,3127.117739466226
2013-03-16,47.0,47.0,47.4,46.3,16320.0,48.4,0.1,47.06666666666666,75.7104430840073,0.12576095444880142,52.92628414720199,27.71371585279801,41.11331699144971,86.70886075949366,3.214908895634795,12845850.0,37.02623906705541,0.0,6.840231692839989,6.840231692839989,40.275000000000006,32.25,34.76040388864,44.3,48.4,0,108.0,1.5058865038379614,3160.5218570792013
2013-03-17,47.4,47.0,47.7,46.8,13940.0,48.4,0.1,47.13333333333333,76.29828172530483,-0.005409565006459616,53.26844618122493,29.071553818775072,41.71204870654974,89.24050632911391,3.04955826023231,12859790.0,37.39130434782608,0.008510638297872353,6.4336672156799795,6.4336672156799795,40.575,32.25,35.0351958108672,44.3,48.4,0,109.0,1.5072091357339097,3194.356348341706
2013-03-18,51.6,47.4,52.9,47.1,65310.0,51.6,0.1,48.666666666666664,81.39087022734188,0.13443263024611873,54.180236751937606,30.209763248062394,42.653758353545,93.36734693877553,3.2460183845014305,12925100.0,42.54143646408839,0.08860759493670889,6.290733303297345,6.290733303297345,42.625,34.7,35.30449189464986,44.3,48.4,0,110.0,1.508615417886552,3230.4159609123762
2013-03-19,59.1,51.6,62.0,50.0,111700.0,59.1,0.1,52.70000000000001,86.83187715857395,0.6471014771764212,56.540760511079185,30.66923948892082,44.22006708177881,89.89547038327527,3.871302785608471,13036800.0,46.65012406947892,0.14534883720930236,6.550427725225839,6.550427725225839,47.175,39.6,36.008312218863864,44.3,48.4,0,111.0,1.5101584525866831,3269.963543138618
2013-03-20,64.5,59.1,66.0,57.7,93140.0,64.5,0.1,58.4,89.26549516648285,1.2310839292458695,60.13176008357052,30.188239916429488,46.151489264466534,95.41284403669725,4.187638300922152,13129940.0,57.3170731707317,0.09137055837563457,6.492462482049848,6.492462482049848,49.175,41.9,37.56781348573203,44.3,48.4,0,112.0,1.511786940803616,3311.948353723475
2013-03-21,70.8,64.5,74.9,63.1,94310.0,70.8,0.1,64.8,91.28833380387235,1.8837810504581567,64.85603744193818,29.09396255806182,48.49896647737448,89.26701570680626,4.731378422284855,13224250.0,68.57142857142856,0.0976744186046512,6.682737884583129,6.682737884583129,55.7,46.45,39.84238840687347,44.3,48.4,0,113.0,1.5135065737651252,3356.583957010579
2013-03-22,69.9,70.8,73.8,65.0,73200.0,70.8,0.1,68.4,88.7163424953174,2.081551035889113,68.2495607798687,29.260439220131303,50.53716014619596,86.91099476439791,5.021994249264509,13151050.0,58.144796380090504,-0.012711864406779516,7.184541129133774,7.184541129133774,56.325,46.45,43.34814956618612,44.3,48.4,0,114.0,1.5152058265507293,3401.350292085368
2013-03-23,64.3,69.9,70.5,52.3,150460.0,70.8,0.1,68.33333333333333,74.62728178798403,1.679126780771548,69.70896413888997,30.781035861110027,51.847906798939206,72.25130890052354,5.963280374317044,13000590.0,37.39316239316239,-0.0801144492131618,9.27415299271702,9.27415299271702,56.55,46.45,46.50333460956751,44.3,48.4,1,115.0,1.5168107054882054,3444.480529283092
2013-03-24,71.5,64.3,72.5,62.7,42020.0,71.5,0.1,68.56666666666666,79.20083265368447,1.734647175080954,72.43761855919566,31.582381440804355,53.71953472284976,91.09947643979056,6.2373317761515406,13042610.0,55.434782608695656,0.11197511664074655,8.72354094566649,8.72354094566649,56.725,46.45,49.34300114861076,44.3,48.4,0,116.0,1.5185200637006715,3490.674968145851
2013-03-25,73.6,71.5,78.0,69.5,79740.0,73.6,0.1,69.8,80.31534724104932,1.7448642357110957,75.40054947521452,31.94945052478547,55.61291236829263,89.3462469733656,6.398950934997859,13122350.0,52.06611570247933,0.029370629370629286,8.694226813855789,8.694226813855789,58.425,48.0,51.89870103374969,44.3,48.4,0,117.0,1.5202527730774673,3538.064831551739
2013-03-26,78.5,73.6,79.7,73.1,56670.0,78.5,0.1,74.53333333333332,82.65131971145419,1.9008630094078889,78.98207203812744,32.11792796187255,57.79263499988381,96.65738161559888,6.413311582498012,13179020.0,77.20090293453725,0.06657608695652173,8.16982367197199,8.16982367197199,59.85,49.55,55.03085690969973,44.3,48.4,0,118.0,1.522045816993685,3587.596271124541
2013-03-27,88.9,78.5,89.5,78.4,72230.0,88.9,0.1,80.33333333333333,86.35300127377685,2.4867219227944837,84.59312540235726,31.196874597642747,60.755241190371066,98.62068965517244,6.748075040891011,13251250.0,89.55223880597016,0.132484076433121,7.5906355915534425,7.5906355915534425,65.55,54.7,58.48453694234177,44.3,48.4,0,119.0,1.5239614993922732,3640.904585760896
2013-03-28,86.2,88.9,95.7,75.0,140260.0,88.9,0.1,84.53333333333335,81.4916095633364,2.469618013352603,88.59349471563134,31.39650528436867,63.17855155319287,80.76923076923077,7.744641109398796,13110990.0,82.62711864406779,-0.030371203599550034,8.984502447098372,8.984502447098372,69.25,57.95,63.44701103156709,44.3,48.4,0,120.0,1.525837511548951,3694.003383747914
2013-03-29,90.5,86.2,93.1,83.0,83180.0,90.5,0.1,88.53333333333335,83.12132200951532,2.5165801908075593,93.00314714625996,31.356852853740055,65.78059426241259,89.4736842105263,7.912881030156025,13194170.0,92.5531914893617,0.04988399071925742,8.743514950448645,8.743514950448645,69.25,58.150000000000006,69.25254904588502,44.3,48.4,0,121.0,1.5277568059041653,3749.0033875181393
2013-03-30,92.2,90.5,95.0,87.0,37290.0,92.2,0.1,89.63333333333333,83.7312271239007,2.4295741941869657,96.99543954478993,31.984560455210087,68.29672814218283,92.84253578732107,7.919103813716309,13231460.0,96.17021276595746,0.01878453038674044,8.589049689497081,8.589049689497081,69.25,58.25,74.01309021762572,44.3,48.4,0,122.0,1.529687931227024,3805.141494691541
2013-03-31,93.0,92.2,93.8,91.0,21130.0,93.0,0.1,91.89999999999999,84.02379273880382,2.200187151087297,100.59474575550334,32.84525424449665,70.64942070007018,94.44444444444444,7.553453541308001,13252590.0,96.20253164556962,0.008676789587852562,8.121993055169893,8.121993055169893,69.25,58.7,77.9167339784531,44.3,48.4,0,123.0,1.531620479192261,3862.1671583147286
2013-04-01,104.0,93.0,106.0,92.2,90560.0,104.0,0.1,96.39999999999999,87.3834592020006,2.5395087736479507,105.61162752194909,33.798372478050915,73.82566634768254,96.42857142857143,7.999635431214572,13343150.0,101.55038759689923,0.11827956989247301,7.691957145398627,7.691957145398627,77.0,63.85,81.11772186233154,44.3,48.4,0,124.0,1.5336615025092808,3922.9903956452163
2013-04-02,118.0,104.0,118.4,99.0,81290.0,118.0,0.1,105.0,90.20631474836847,3.403163107237763,113.27501718105329,33.244982818946696,78.03274574314135,99.3948562783661,8.813947186127818,13424440.0,99.66159052453469,0.13461538461538458,7.46944676790493,7.46944676790493,85.75,70.05,86.09417748986523,44.3,48.4,0,125.0,1.5358255918679486,3988.1657157510786
2013-04-03,135.0,118.0,147.0,110.0,152710.0,135.0,0.1,119.0,92.42318632325532,4.733881333142611,124.02514420462744,31.274855795372574,83.45819852950885,87.32840549102428,10.827236672832973,13577150.0,109.30232558139534,0.14406779661016955,8.02017531320961,8.02017531320961,100.94999999999999,84.35,92.2,44.3,48.4,1,126.0,1.5381208353479379,4058.10530237089
2013-04-04,132.1,135.0,142.1,116.4,88360.0,135.0,0.1,128.36666666666667,88.73328532851066,5.006826726814236,131.7378195068269,32.0721804931731,88.090751050508,84.26610348468849,11.88957691048776,13488790.0,86.5819209039548,-0.021481481481481546,9.000436722549402,9.000436722549402,101.425,84.35,99.0,44.3,48.4,0,127.0,1.540384969339706,4128.397821780965
2013-04-05,142.3,132.1,144.9,130.2,68590.0,142.3,0.1,136.46666666666667,90.2132730299424,5.42707217827412,140.32005498599221,33.0199450140078,93.25353666474534,95.03695881731787,12.090321416881492,13557380.0,103.57653791130186,0.07721423164269514,8.496360798932882,8.496360798932882,101.425,84.35,108.6,44.3,48.4,0,128.0,1.5427174443465335,4201.901673344206
2013-04-06,142.6,142.3,143.9,139.5,18290.0,142.6,0.1,139.0,90.2538239608282,5.273448224218157,147.1516690345864,35.70833096541359,97.95319983953151,94.78054567022538,11.5410127442471,13575670.0,121.77293934681181,0.0021082220660575413,8.093276819247617,8.093276819247617,103.425,84.35,116.28,44.3,48.4,0,129.0,1.5450433551691314,4276.533871097886
2013-04-07,162.3,142.6,164.9,142.6,60960.0,162.3,0.1,149.06666666666666,92.46245404525973,5.994230688856703,157.54210045883661,36.38789954116338,104.08146652148089,97.27463312368974,12.309511833943736,13636630.0,126.99300699300701,0.1381486676016832,7.584418874888314,7.584418874888314,115.15,94.95,122.424,44.3,48.4,0,130.0,1.5474940343758523,4356.255397751196
2013-04-08,187.5,162.3,194.9,162.6,114250.0,187.5,0.1,164.13333333333333,94.25571568142259,7.562624635581731,173.07922572925236,33.690774270747625,112.02608875753033,93.92446633825944,13.758832417233467,13750880.0,154.75543478260872,0.155268022181146,7.33804395585785,7.33804395585785,131.7,109.95,130.91920000000002,44.3,48.4,0,131.0,1.5500843563230984,4441.758035489767
2013-04-09,230.0,187.5,240.1,186.5,105840.0,230.0,0.1,193.26666666666665,95.98891531484627,10.666876068719365,198.18887148229763,25.131128517702365,123.26169935205127,93.88249545729862,16.60463010171679,13856720.0,192.9936305732484,0.22666666666666657,7.219404392050778,7.219404392050778,154.675,132.55,142.6,44.3,230.0,0,132.0,1.5528754818410393,4535.239106711295
2013-04-10,165.0,230.0,266.0,105.0,190180.0,230.0,0.1,194.16666666666666,64.12254876415275,7.686332401532354,203.74066097953005,28.999339020469904,127.23677560423685,47.12041884816754,26.918585094451306,13666540.0,85.60179977502811,-0.28260869565217395,16.314293996637154,16.314293996637154,169.325,146.2,240.1,44.3,230.0,1,133.0,1.5553149562383726,4619.474632706804
2013-04-11,124.9,165.0,188.7,110.2,118750.0,230.0,0.1,173.29999999999998,52.53534266040568,2.6197431944125995,203.89052789737704,34.34947210262297,127.0142255466905,22.896174863387984,30.602971873419072,13547790.0,44.89559164733179,-0.24303030303030304,24.501979082000858,24.501979082000858,170.95,146.4,240.1,44.3,230.0,0,134.0,1.5574593748313856,4695.711323051328
2013-04-12,117.0,124.9,140.0,54.3,556470.0,230.0,0.1,135.63333333333333,50.5955828341268,-1.4397821150710541,202.73723200184085,40.77276799815914,126.06048978033901,29.61738308927728,34.538473882460565,12991320.0,29.2817679558011,-0.06325060048038433,29.520063147402194,29.520063147402194,158.35000000000002,147.0,266.0,44.3,230.0,1,135.0,1.5595286196797649,4770.741212742452
2013-04-13,93.0,117.0,130.0,85.5,238350.0,230.0,0.1,111.63333333333333,45.142402119661654,-5.679475091601731,201.6573835668797,44.002616433120295,122.91187170602102,18.28058573453,35.25001146228481,12752970.0,0.8676789587852464,-0.20512820512820518,37.90323813148904,37.90323813148904,159.075,147.0,257.532,44.3,230.0,1,136.0,1.561354621491034,4838.84391401422
2013-04-14,90.0,93.0,110.0,84.4,166280.0,230.0,0.1,100.0,44.496806131519605,-8.456726347075165,200.73378558425875,46.56621441574126,119.77740773401901,16.86348606518659,34.56072492926446,12586690.0,-3.225806451612903,-0.032258064516129004,38.40080547696051,38.40080547696051,159.65,147.0,249.40272,44.3,230.0,0,137.0,1.5631399037057512,4906.5483325021905
2013-04-15,82.4,90.0,102.0,71.5,236670.0,230.0,0.1,88.46666666666665,42.82587176612208,-10.446046027588562,200.48941205984931,47.20058794015068,116.21765461649339,13.273500236183283,34.27067314860271,12350020.0,-20.769230769230766,-0.08444444444444443,41.59062275315863,41.59062275315863,159.65,147.0,241.5986112,44.3,230.0,0,138.0,1.5648279149813111,4971.866756447822
2013-04-16,68.4,82.4,84.5,50.0,572350.0,230.0,0.1,80.26666666666667,39.856727398969326,-12.221846433359143,201.81849618821855,43.82150381178148,111.66359227206546,8.51851851851852,34.28705363798823,11777670.0,-42.03389830508474,-0.16990291262135926,50.12727140056759,50.12727140056759,158.0,147.6,234.106666752,68.4,230.0,1,139.0,1.5663188966247148,5031.2075913605995
2013-04-17,93.1,68.4,98.8,63.3,327630.0,230.0,0.1,81.3,46.857139837885384,-11.273127052644599,201.57888333707226,44.75111666292776,109.89563110329732,19.9537037037037,34.373692663846214,12105300.0,-31.03703703703704,0.36111111111111094,36.92125957448573,36.92125957448573,158.0,147.75,223.06026674688,68.4,230.0,0,140.0,1.5681185640863227,5102.139561373877
2013-04-18,109.0,93.1,113.0,86.0,172980.0,230.0,0.1,90.16666666666667,50.82507978221892,-9.202366594825493,201.36899844071465,46.81100155928536,109.81033290298329,27.314814814814813,33.847000330714344,12278280.0,-17.486752460257378,0.1707841031149302,31.05229388138931,31.05229388138931,158.0,148.05,212.67665074206718,68.4,230.0,0,141.0,1.5700720300806257,5179.586700905988
2013-04-19,118.5,109.0,136.4,105.5,257170.00000000003,230.0,0.1,106.86666666666667,53.07929738619179,-6.9243442059095415,201.3522310225987,49.457768977401315,110.6379202455563,31.712962962962962,33.636500307091886,12535450.0,-16.725228390723828,0.08715596330275233,28.38523232665982,28.38523232665982,138.675,148.4,202.91605169754314,68.4,230.0,0,142.0,1.5721031592792558,5261.046230103551
2013-04-20,126.6,118.5,132.0,115.0,74360.0,230.0,0.1,118.03333333333335,54.974504889415655,-4.7093945000421,201.56292357470753,52.60707642529246,112.15811831740808,35.46296296296296,32.44817885658532,12609810.0,-11.220196353436187,0.06835443037974676,25.63047303047814,25.63047303047814,126.5,148.45,193.74108859569054,68.4,230.0,0,143.0,1.574193879791861,5346.002873345164
2013-04-21,119.2,126.6,130.5,110.0,99130.0,230.0,0.1,121.43333333333334,52.87333881353634,-3.628528980096579,201.67251451863984,54.01748548136017,112.82877371575017,32.03703703703704,31.59473750968637,12510680.0,-26.555760936537283,-0.05845181674565558,26.505652273226822,26.505652273226822,125.6,149.45,185.11662327994912,68.4,230.0,0,144.0,1.5762154643550834,5429.748443138692
2013-04-22,127.4,119.2,127.4,118.5,59150.0,230.0,0.1,124.39999999999999,54.92905218496863,-2.3113205065491824,202.00538675431127,54.62461324568872,114.2165095523454,35.833333333333336,29.97368483042306,12569830.0,-32.05333333333333,0.06879194630872476,23.527225141619358,23.527225141619358,125.6,149.6,177.00962588315218,68.4,230.0,0,145.0,1.578296963580985,5517.105666368035
2013-04-23,143.5,127.4,144.0,125.0,116150.0,230.0,0.1,130.03333333333333,58.73509320145633,-0.40559958204914004,202.67733562957199,54.80266437042799,117.00541340450299,43.28703703703704,29.189850199678556,12685980.0,-37.608695652173914,0.12637362637362637,20.34135902416624,20.34135902416624,127.5,149.65,169.38904833016306,68.4,230.0,0,146.0,1.5804913908842775,5610.264452114255
2013-04-24,154.2,143.5,166.4,141.0,225900.0,230.0,0.1,141.70000000000002,61.0869691789654,1.4253975642868522,204.60615234531883,55.08384765468115,120.54775498502651,75.12617159336698,28.919146613987234,12911880.0,-6.545454545454553,0.07456445993031346,18.75431038520573,18.75431038520573,133.1,149.65,50.0,68.4,230.0,0,147.0,1.582750552718766,5707.568299704598
2013-04-25,141.7,154.2,162.0,120.1,187650.0,230.0,0.1,146.46666666666667,56.999842295820486,1.629756828172411,204.55661558328785,55.07338441671216,122.56225451026208,78.78006872852232,29.84635042727386,12724230.0,13.450760608486775,-0.08106355382619979,21.06305605312199,21.06305605312199,136.425,149.65,52.328,68.4,230.0,0,148.0,1.584915728238381,5802.801075816713
2013-04-26,136.9,141.7,145.0,121.4,129009.99999999999,230.0,0.1,144.26666666666665,55.46520388624617,1.2915395961687341,204.11774966440518,54.94225033559482,123.92775408071331,74.65635738831615,29.40018253961144,12595220.0,17.008547008547016,-0.0338743824982356,21.475662921556932,21.475662921556932,142.1,149.65,54.609440000000006,68.4,230.0,0,149.0,1.5870379613198855,5897.88564572463
2013-04-27,128.0,136.9,139.9,122.7,59880.0,230.0,0.1,135.53333333333333,52.63547759324008,0.3663797325305733,200.87156096477563,54.7584390352244,124.31558702540728,67.01030927835052,28.52874092963919,12535340.0,37.634408602150536,-0.06501095690284886,22.28807885128062,22.28807885128062,146.975,149.65,56.84525120000001,68.4,230.0,0,150.0,1.5890843103878198,5991.395893977302
2013-04-28,134.4,128.0,136.7,127.5,27520.0,230.0,0.1,133.1,54.43568806440355,0.09740921004717862,193.02219566150197,57.297804338498054,125.27600730870182,72.5085910652921,27.148116577522106,12562860.0,49.33333333333334,0.050000000000000044,20.19949150113252,20.19949150113252,148.1,151.35,59.03634617600001,68.4,230.0,0,151.0,1.591172223427854,6088.15564711697
2013-04-29,144.0,134.4,149.1,133.0,70210.0,230.0,0.1,135.46666666666667,57.07137052753865,0.4578198422638273,169.89082295862448,71.82917704137554,127.05924470787308,80.75601374570446,26.35896539341339,12633070.0,74.75728155339804,0.0714285714285714,18.3048370787593,18.3048370787593,148.1,151.35,61.18361925248001,68.4,144.0,0,152.0,1.5933219138660921,6189.140992717061
2013-04-30,139.2,144.0,146.9,134.0,65230.00000000001,230.0,0.1,139.20000000000002,55.34743716618335,0.27380324521384125,165.12182103933912,74.01817896066089,128.21550711664707,73.61784675072744,25.39761072245529,12567840.0,103.50877192982453,-0.03333333333333344,18.245410001763858,18.245410001763858,150.225,151.35,63.287946867430406,68.4,144.0,0,153.0,1.5954294418254402,6289.981362420289
2013-05-01,116.4,139.2,140.1,104.0,180010.0,230.0,0.1,133.2,47.93984460089592,-1.3911453394404596,164.64855920145123,73.64144079854879,127.09022072458545,37.810945273631845,26.162067099422774,12387830.0,25.02685284640173,-0.1637931034482758,22.47600266273434,22.47600266273434,146.6,151.35,65.3501879300818,68.4,144.0,0,154.0,1.5973490179421934,6384.164642901225
2013-05-02,106.3,116.4,126.9,91.1,234170.0,230.0,0.1,120.63333333333333,45.06266075831323,-3.0833790153875187,164.45220326293207,72.76779673706797,125.11019970319636,20.185922974767596,26.850490878035433,12153660.0,-2.4770642201834887,-0.08676975945017185,25.259163572940203,25.259163572940203,143.375,151.35,67.37118417148017,68.4,144.0,0,155.0,1.5991700080925924,6475.34871069337
2013-05-03,98.1,106.3,109.0,79.0,246480.0,230.0,0.1,106.93333333333332,42.8159176938927,-4.575723566647012,164.1883394621356,73.54166053786443,122.53779973146337,21.853546910755142,27.075455815318616,11907180.0,-17.215189873417728,-0.07714016933207901,27.599853022750885,27.599853022750885,139.25,154.9,69.35176048805056,68.4,144.0,0,156.0,1.600903342965817,6563.860908744073
2013-05-04,112.9,98.1,116.3,92.0,132620.0,230.0,0.1,105.76666666666665,47.86803281279437,-4.38631505230038,163.47768454840883,76.54231545159122,121.61991404275257,38.787185354691076,26.877208971367285,12039800.0,-10.821484992101098,0.15086646279306848,23.80620812344312,23.80620812344312,136.025,156.0,71.29272527828955,68.4,144.0,0,157.0,1.6027709898670384,6659.790862291548
2013-05-05,116.0,112.9,118.8,107.0,84210.0,230.0,0.1,108.99999999999999,48.88666400451723,-3.889414772109834,161.6707903873845,81.70920961261552,121.084684133919,42.33409610983981,25.80026547341248,12124010.0,-2.684563758389264,0.027457927369353374,22.241608166734895,22.241608166734895,136.025,156.15,73.19487077272376,68.4,144.0,0,158.0,1.6046586770296911,6758.0757037079875
2013-05-06,112.3,116.0,124.9,106.0,150070.0,230.0,0.1,113.73333333333333,47.68894407127724,-3.6509282949168806,155.9608647584126,91.80913524158737,120.24804754973624,38.10068649885583,25.307389368168735,11973940.0,-11.852433281004714,-0.03189655172413797,22.535520363462812,22.535520363462812,116.69999999999999,156.15,75.05897335726928,68.4,144.0,0,159.0,1.606506716718981,6855.941444334002
2013-05-07,109.6,112.3,114.0,97.5,139670.0,230.0,0.1,112.63333333333333,46.788105325025825,-3.5147735704415712,154.33106682751273,95.08893317248724,119.23394778309469,35.011441647597245,24.678290127585253,11834270.0,-23.623693379790943,-0.024042742653606397,22.516688072614283,22.516688072614283,111.125,156.4,76.88579389012389,109.6,144.0,0,160.0,1.6083233515005957,6953.724776663788
2013-05-08,113.2,109.6,116.8,109.5,61720.0,230.0,0.1,111.69999999999999,48.19330694624622,-3.039833699732272,154.14954669508194,95.69045330491805,118.65928608946663,41.20481927710844,23.436983689900593,11895990.0,-26.58884565499351,0.03284671532846728,20.70404919602526,20.70404919602526,110.575,156.55,78.67607801232141,109.6,144.0,0,161.0,1.6101653468204185,7054.157214872993
2013-05-09,112.8,113.2,113.7,108.8,26950.0,230.0,0.1,111.86666666666666,48.04150104249158,-2.625789254919813,154.2183923004103,95.05160769958968,118.10125884285077,48.21683309557774,22.112913426336263,11869040.0,-20.39520112914608,-0.0035335689045936647,19.603646654553426,19.603646654553426,108.875,158.0,80.43055645207498,109.6,144.0,0,162.0,1.611996787794519,7155.5312263204705
2013-05-10,117.7,112.8,122.5,111.5,77480.0,230.0,0.1,114.56666666666666,50.1144906127254,-1.9273994542040018,153.9092126409832,94.47078735901681,118.06304371496023,55.206847360912995,21.319133895883674,11946520.0,-14.024835646457271,0.043439716312056786,18.113112910691314,18.113112910691314,105.575,158.0,82.14994532303348,109.6,144.0,0,163.0,1.613863675840327,7260.161467879482
2013-05-11,115.6,117.7,118.7,113.0,28040.0,230.0,0.1,115.36666666666666,49.208367155368485,-1.5297289539755368,153.89109101087132,94.12890898912865,117.82846812305927,52.21112696148359,20.203481474749122,11918480.0,-9.687500000000004,-0.017841971112999233,17.477060099263948,17.477060099263948,105.075,158.0,83.8349464165728,109.6,144.0,0,164.0,1.6157055394738504,7365.058626263044
2013-05-12,114.8,115.6,117.5,112.4,20600.0,230.0,0.1,116.03333333333332,48.84603345337842,-1.2549405054514648,153.4791428449379,93.28085715506214,117.54004258752981,51.06990014265335,19.124661369409896,11897880.0,-14.58333333333334,-0.00692041522491349,16.659112691123603,16.659112691123603,111.65,158.0,85.48624748824135,109.6,144.0,0,165.0,1.617533489148613,7470.765564831643
2013-05-13,118.0,114.8,118.9,114.5,26180.0,230.0,0.1,116.13333333333333,50.4186849513306,-0.8134460923218453,150.81530999484292,93.39469000515712,117.58384805538412,57.437407952871865,18.072899843023475,11924060.0,-18.055555555555554,0.027874564459930307,15.31601681612159,15.31601681612159,116.95,158.0,87.10452253847652,109.6,144.0,0,166.0,1.6193818385230918,7579.077663301846
2013-05-14,111.4,118.0,119.8,109.4,87780.0,230.0,0.1,114.7333333333333,47.19586690983725,-0.9141665741053473,144.92226547520735,95.00773452479264,116.99491014534753,53.02782324058921,17.524835568521798,11836280.0,-19.97126436781608,-0.055932203389830515,15.731450241042905,15.731450241042905,116.95,158.0,88.69043208770698,109.6,144.0,0,167.0,1.6211659807777148,7685.550883104668
2013-05-15,114.2,111.4,116.4,103.0,117970.0,230.0,0.1,114.53333333333332,48.69420383609436,-0.7474873030591733,141.55666279632237,95.62333720367765,116.728728226743,73.48643006263048,17.230204456484525,11954250.0,-1.8900343642611708,0.025134649910233398,15.087744707954926,15.087744707954926,116.35,158.0,90.24462344595284,109.6,144.0,0,168.0,1.62296796073696,7794.499836480341
2013-05-16,118.2,114.2,119.0,112.1,45230.0,230.0,0.1,114.59999999999998,50.840244388598045,-0.34365977880011045,139.03138650473878,96.27861349526124,116.86884934800557,85.40305010893246,16.492332709592773,11999480.0,11.19473189087489,0.035026269702276736,13.952904153631787,13.952904153631787,117.725,158.0,91.76773097703378,109.6,144.0,0,169.0,1.6247972329795441,7906.506460425997
2013-05-17,123.5,118.2,125.6,116.6,79120.0,230.0,0.1,118.63333333333333,53.60912733662353,0.2713846032467181,138.45799086931459,96.4020091306854,117.50038750533837,93.75000000000001,15.957166087479004,12078600.0,25.89194699286443,0.04483925549915391,12.92078225706802,12.92078225706802,118.5,158.0,93.2603763574931,109.6,144.0,0,170.0,1.6266630406046447,8022.1732443648125
2013-05-18,123.2,123.5,125.3,122.3,22650.0,230.0,0.1,121.63333333333333,53.42569532317576,0.6285765191996933,136.618022685828,97.121977314172,118.04320774292519,91.45907473309612,15.031654224087648,12055950.0,9.123117803365806,-0.0024291497975708065,12.201018039032181,12.201018039032181,118.5,158.0,94.72316883034324,109.6,144.0,0,171.0,1.6285194112431483,8139.015837515722
2013-05-19,122.5,123.2,124.5,119.5,20570.0,230.0,0.1,123.06666666666666,52.97025661291263,0.7784671958092159,131.43130071340335,100.15869928659666,118.4676641483609,88.96797153024913,14.315107493795674,12035380.0,5.603448275862069,-0.005681818181818232,11.685802035751571,11.685802035751571,118.5,158.0,96.15670545373638,109.6,144.0,0,172.0,1.6303631516518802,8256.853098898757
2013-05-20,122.0,122.5,123.7,120.1,17320.0,230.0,0.1,122.56666666666666,52.62516857474211,0.8015572032967632,126.75350667385598,103.11649332614405,118.80407708661224,87.18861209964415,13.54974267281027,12018060.0,8.63757791629564,-0.004081632653061273,11.106346453123173,11.106346453123173,117.4,158.0,97.56157134466166,109.6,144.0,0,173.0,1.6321958996174681,8375.774046232202
2013-05-21,122.9,122.0,123.1,121.1,13390.0,230.0,0.1,122.46666666666665,53.215984928441564,0.8314784099089677,127.56908607492765,102.95091392507233,119.19416498312536,88.05309734513278,12.724761053323821,12031450.0,12.135036496350377,0.007377049180327999,10.353751874144686,10.353751874144686,114.175,158.0,98.93833991776843,109.6,144.0,0,174.0,1.6340289892227833,8496.445070602236
2013-05-22,123.8,122.9,124.5,122.0,18310.0,230.0,0.1,122.89999999999999,53.835986898348835,0.8622176532101548,128.25857620506332,104.01142379493666,119.63281593711342,92.0353982300885,11.994420978086406,12049760.0,9.363957597173139,0.007323026851098424,9.688546832056872,9.688546832056872,114.175,158.0,100.28757311941307,109.6,144.0,0,175.0,1.6358623659586322,8618.889178567335
2013-05-23,126.3,123.8,126.9,123.0,22120.0,230.0,0.1,124.33333333333333,55.59632728956315,0.9920013177998407,127.27340685826707,107.81659314173294,120.26778584786452,97.48953974895393,11.416248051080235,12071880.0,11.96808510638298,0.020193861066235774,9.03899291455284,9.03899291455284,114.5,158.0,101.60982165702481,109.6,144.0,0,176.0,1.6377085353979033,8743.89260534583
2013-05-24,133.1,126.3,134.0,125.4,48770.0,230.0,0.1,127.7333333333333,60.057803944901586,1.4492156154401816,130.15835727278863,106.95164272721135,121.48990148140122,97.09677419354837,11.215087476003076,12120650.0,13.084112149532704,0.05384006334125102,8.42606121412703,8.42606121412703,118.55,158.0,102.90562522388431,109.6,144.0,0,177.0,1.639599380312326,8873.481370907468
2013-05-25,132.0,133.1,133.5,128.2,16840.0,230.0,0.1,130.46666666666667,59.0246580192966,1.5802265618047844,132.2749806501394,106.43501934986057,122.49086324507729,93.54838709677419,10.792581227717141,12103810.0,14.186851211072671,-0.008264462809917328,8.176197899785713,8.176197899785713,119.125,158.0,104.17551271940663,109.6,144.0,0,178.0,1.6414750096796973,9004.057596289202
2013-05-26,133.5,132.0,136.0,130.6,23360.0,230.0,0.1,132.86666666666665,60.034289797668265,1.662236026849671,134.2891882645428,106.54081173545723,123.53935245983183,92.42424242424242,10.407396854308773,12127170.0,16.28919860627178,0.011363636363636465,7.795802887122677,7.795802887122677,118.65,158.0,105.4200024650185,109.6,133.5,0,179.0,1.6433547319020656,9136.83429563192
2013-05-27,129.8,133.5,135.5,124.0,46830.0,230.0,0.1,131.76666666666665,56.34621021124705,1.3735928170551133,134.9392702355686,107.91072976443137,124.13560460651452,81.21212121212125,10.48543993614386,12080340.0,10.00000000000001,-0.027715355805243314,8.078150952345037,8.078150952345037,117.625,158.0,106.63960241571813,109.6,133.5,0,180.0,1.6451998634884724,9269.35913438244
2013-05-28,129.0,129.8,130.6,125.4,22800.0,230.0,0.1,130.76666666666665,55.55157062625864,1.0497033746163886,135.55985294036526,108.8701470596347,124.59888035827504,78.78787878787878,10.107908512133585,12057540.0,15.798922800718126,-0.006163328197226536,7.8355879939020046,7.8355879939020046,117.775,158.0,107.83481036740376,109.6,133.5,0,181.0,1.6470320305149515,9402.977601185914
2013-05-29,132.3,129.0,132.7,127.6,19250.0,230.0,0.1,130.36666666666665,58.17204974621757,0.979961031492385,136.49021052464872,109.88978947535132,125.3323203241536,84.5188284518829,9.7502007612669,12076790.0,15.849387040280217,0.0255813953488373,7.369766259460997,7.369766259460997,121.275,158.0,109.00611416005569,109.6,133.5,0,182.0,1.6488820753706561,9539.727118461036
2013-05-30,128.8,132.3,132.4,126.5,24700.0,230.0,0.1,130.03333333333333,54.501971810241514,0.636975532065041,137.00885690513795,110.48114309486205,125.66257553137707,62.886597938144405,9.475186421176407,12052090.0,8.967851099830803,-0.026455026455026398,7.356511196565532,7.356511196565532,122.875,158.0,110.15399187685458,109.6,133.5,0,183.0,1.6506989830070333,9676.254837422419
2013-05-31,128.8,128.8,130.0,126.3,16580.0,230.0,0.1,129.96666666666667,54.501971810241514,0.36261640978035814,137.29025901951434,111.51974098048566,125.96137786172211,56.36363636363643,9.062673105378092,12068670.0,4.291497975708512,0.0,7.036236883057525,7.036236883057525,123.125,158.0,111.27891203931749,109.6,133.5,0,184.0,1.6525090876533934,9814.29134023318
2013-06-01,129.3,128.8,129.8,127.1,6360.0,230.0,0.1,128.96666666666667,54.9726334402722,0.17673568548312923,137.3884012008082,112.87159879919184,126.27934187489144,59.39393939393946,8.608196454993944,12075030.0,4.9512987012987075,0.0038819875776396895,6.657537861557575,6.657537861557575,123.375,119.35,112.38133379853114,109.6,133.5,0,185.0,1.6543161987143968,9954.109109238016
2013-06-02,122.5,129.3,130.1,115.0,101140.0,230.0,0.1,126.86666666666666,47.73962728201886,-0.4102160805920745,137.24120629132676,113.46879370867327,125.91940455347321,35.714285714285715,9.071896708208662,11973890.0,0.0,-0.052590873936581684,7.405629965884622,7.405629965884622,122.5,108.2,113.46170712256053,109.6,133.5,1,186.0,1.6560638447581526,10091.762267112608
2013-06-03,120.7,122.5,122.8,115.1,28900.0,230.0,0.1,124.16666666666664,46.01375656918807,-0.8977591396328157,136.10602936025245,115.53397063974757,125.42231840552338,27.142857142857153,8.973904086193759,11944990.0,-1.065573770491801,-0.014693877551020362,7.434883252853155,7.434883252853155,122.5,108.2,114.52047298010932,109.6,133.5,0,187.0,1.6577904800309626,10229.841950338616
2013-06-04,121.4,120.7,124.0,118.8,21950.0,230.0,0.1,121.53333333333332,46.8189429466128,-1.1358465999680374,135.24567151401237,117.11432848598763,125.0392404621402,30.476190476190503,8.70433950860849,11966940.0,-1.2205044751830756,0.0057995028997515075,7.169966646300238,7.169966646300238,122.375,108.2,115.0,109.6,133.5,0,188.0,1.6595162286679168,10369.765417035362
2013-06-05,121.9,121.4,123.5,119.5,16640.0,230.0,0.1,121.33333333333331,47.422158746690016,-1.215273894305077,134.90766351906566,117.82233648093435,124.74026518003161,32.85714285714288,8.368315257993597,11983580.0,-1.5347334410339188,0.004118616144975329,6.864901770298275,6.864901770298275,121.675,108.2,115.1,109.6,133.5,0,189.0,1.6612394669413577,10511.437806997132
2013-06-06,119.0,121.9,123.3,117.0,22100.0,230.0,0.1,120.76666666666665,44.284672320242436,-1.4053025622864475,135.19436911109634,117.08563088890368,124.19357325812383,19.047619047619047,8.220578453851198,11961480.0,-5.779889152810766,-0.02378999179655461,6.908049120883359,6.908049120883359,121.675,108.2,116.12599999999999,109.6,133.5,0,190.0,1.6629328121538471,10652.847612647935
2013-06-07,111.0,119.0,119.1,106.2,65770.0,230.0,0.1,117.29999999999997,37.01023997467394,-1.976959528447489,136.69281326547997,114.36718673452003,122.93704247163585,16.10738255033556,8.554822850004683,11895710.0,-16.604057099924866,-0.0672268907563025,7.707047612616831,7.707047612616831,119.4,114.85,166.4,109.6,133.5,1,191.0,1.6645521904775282,10790.61998786125
2013-06-08,107.9,111.0,113.2,107.0,17220.0,230.0,0.1,112.63333333333333,34.63597348787788,-2.4406340723846096,138.32050294922402,111.27949705077596,121.50494318862292,5.704697986577191,8.386621217861492,11878490.0,-18.257575757575754,-0.027927927927927865,7.772586856220104,7.772586856220104,118.825,122.7,165.196,109.6,133.5,0,192.0,1.6661379117636648,10927.63006577974
2013-06-09,100.4,107.9,109.0,88.0,149430.0,230.0,0.1,106.43333333333332,29.675825608468728,-3.0875557623171392,140.91425485445578,106.52574514554422,119.49494859923026,26.105263157894747,9.287576845157101,11729060.0,-24.794007490636698,-0.06950880444856344,9.250574546969224,9.250574546969224,110.525,122.7,164.01608,109.6,133.5,1,193.0,1.6676477441621993,11060.549430411815
2013-06-10,106.3,100.4,110.6,95.0,64319.99999999999,230.0,0.1,104.86666666666666,37.28463354810795,-2.9532266500114375,141.69009574443643,104.0899042555636,118.238286827875,40.939597315436245,9.738464213360166,11793380.0,-18.104776579352862,0.05876494023904377,9.161302176256035,9.161302176256035,110.525,122.7,160.97543679999998,109.6,133.5,0,194.0,1.6692069967146337,11198.955035889217
2013-06-11,109.0,106.3,109.6,103.2,16129.999999999998,230.0,0.1,105.2333333333333,40.45946829050168,-2.5337519475461985,141.89016210672995,102.40983789327007,117.358449987125,46.979865771812094,9.50000248383444,11809510.0,-15.503875968992247,0.02539981185324547,8.715598609022422,8.715598609022422,109.0,122.7,158.05641932799998,109.6,133.5,0,195.0,1.670784512900591,11340.551795507785
2013-06-12,108.8,109.0,112.3,106.0,17700.0,230.0,0.1,108.03333333333332,40.29673816169418,-2.1368393622667936,141.73988455867703,100.81011544132299,116.54335951216072,46.84684684684683,9.271430877846266,11791810.0,-17.762660619803487,-0.0018348623853211565,8.521535733314582,8.521535733314582,109.0,122.7,155.25416255487997,109.6,133.5,0,196.0,1.6723542140379704,11483.330721534618
2013-06-13,103.9,108.8,110.3,100.3,30440.0,230.0,0.1,107.2333333333333,36.43070044801677,-2.0699478193241667,140.85536834278284,98.77463165721718,115.33923003481209,37.76722090261284,9.323471529428675,11761370.0,-19.332298136645964,-0.04503676470588225,8.973504840643574,8.973504840643574,108.875,122.7,152.56399605268476,109.6,133.5,0,197.0,1.6738734213327011,11623.833974565725
2013-06-14,100.0,103.9,104.7,97.1,36050.0,230.0,0.1,104.2333333333333,33.662510394648805,-2.144878143756963,140.15330212208727,96.27669787791274,113.8783509838776,28.503562945368174,9.20036642018377,11725320.0,-22.360248447204974,-0.037536092396535214,9.20036642018377,9.20036642018377,108.825,122.7,149.98143621057736,109.6,133.5,0,198.0,1.6753498721765079,11762.567207408412
2013-06-15,99.8,100.0,103.7,97.5,22530.0,230.0,0.1,101.2333333333333,33.52183883965692,-2.0637577284120603,138.68916063392248,94.37083936607753,112.53755565207973,28.028503562945367,8.986054533027787,11702790.0,-22.815158546017024,-0.0020000000000000018,9.004062658344477,9.004062658344477,107.775,120.5,147.50217876215427,99.8,133.5,0,199.0,1.6768186596878498,11902.335929293089
2013-06-16,99.9,99.8,101.8,98.9,8660.0,230.0,0.1,99.89999999999998,33.67108986958496,-1.8652311783336044,137.444397582264,92.625602417736,111.33397892331024,33.05555555555557,8.551336352097229,11711450.0,-18.448979591836732,0.0010020040080160886,8.559896248345574,8.559896248345574,106.3,114.05,145.1220916116681,99.8,133.5,0,200.0,1.6782827039565076,12043.38265847226
2013-06-17,101.9,99.9,102.4,98.9,15190.0,230.0,0.1,100.53333333333332,36.73056531353496,-1.4780190269371722,135.82358597878812,91.53641402121193,110.43550474013784,38.61111111111112,8.190526612661712,11726640.0,-15.575807787903893,0.020020020020020013,8.037808255801483,8.037808255801483,106.075,114.05,142.8372079472014,99.8,133.5,0,201.0,1.6797601205450619,12187.252444825632
2013-06-18,107.3,101.9,113.3,101.0,60610.0,230.0,0.1,103.03333333333332,44.212736141854286,-0.7724919355811801,132.99425053338877,91.8657494666112,110.1368852410771,54.366197183098585,8.484060426043017,11787250.0,-11.61449752883032,0.05299313052011767,7.906859670123969,7.906859670123969,108.075,114.05,140.64371962931332,99.8,133.5,0,202.0,1.6812814212580078,12336.631116823397
2013-06-19,108.3,107.3,111.0,104.7,17570.0,230.0,0.1,105.83333333333331,45.498129340972326,-0.18347315801830266,130.601403308953,92.208596691047,109.96194378954594,57.507082152974505,8.328056109897087,11804820.0,-11.156685808039384,0.009319664492078328,7.689802502213378,7.689802502213378,108.6,114.05,138.5379708441408,99.8,133.5,0,203.0,1.682805784817738,12488.124615058636
2013-06-20,111.3,108.3,114.5,107.1,43090.0,230.0,0.1,108.96666666666664,49.274164936317476,0.42969662804822484,127.99208464072895,93.06791535927108,110.08937771435109,74.91961414790997,8.26176638776158,11847910.0,-6.4705882352941195,0.027700831024930705,7.422970698797466,7.422970698797466,108.9,112.95,136.51645201037516,99.8,111.3,0,204.0,1.6843505040368,12643.290727523534
2013-06-21,109.5,111.3,115.0,107.6,38080.0,230.0,0.1,109.69999999999997,47.16281451619467,0.718556273102597,124.73057602594392,94.3494239740561,110.0332465034605,79.62962962962963,8.20021164577861,11809830.0,-1.3513513513513513,-0.016172506738544423,7.488777758701927,7.488777758701927,108.9,109.55,134.57579392996016,99.8,111.3,0,205.0,1.6858737092836635,12798.482122227222
2013-06-22,108.2,109.5,110.0,107.5,7280.0,230.0,0.1,109.66666666666664,45.641711938391175,0.8192732016038162,122.80625530844716,94.84374469155284,109.85865159836902,74.81481481481482,7.793053671080139,11802550.0,0.2780352177942513,-0.01187214611872145,7.202452561072216,7.202452561072216,108.19999999999999,107.5,132.71276217276176,99.8,111.3,0,206.0,1.6873796560331968,12954.036462233069
2013-06-23,107.9,108.2,109.0,106.2,11050.0,230.0,0.1,108.5333333333333,45.27878754243307,0.8587365469500661,121.06153291845219,95.30846708154785,109.6721133509053,64.50000000000003,7.4364069802887,11791500.0,7.470119521912349,-0.0027726432532346745,6.8919434479042625,6.8919434479042625,108.3,107.5,130.9242516858513,99.8,111.3,0,207.0,1.6888771737995654,13110.72793074984
2013-06-24,102.1,107.9,108.3,100.8,28900.0,230.0,0.1,106.06666666666665,38.84736268977106,0.5047842139885432,118.81993103427699,95.62006896572301,108.95095969843813,27.93296089385474,7.440949338839507,11762600.0,-3.9510818438381965,-0.053753475440222576,7.287903368109213,7.287903368109213,108.575,112.0,129.20728161841723,99.8,111.3,0,208.0,1.6903161706369352,13263.914592854204
2013-06-25,103.3,102.1,110.0,100.0,93710.0,230.0,0.1,104.43333333333332,40.723367174459234,0.3683744631569086,115.83314413597442,96.74685586402559,108.41277306049163,34.63687150837989,7.623738671779543,11856310.0,-5.22935779816514,0.01175318315377094,7.380192325052801,7.380192325052801,108.0,112.0,127.55899035368054,99.8,111.3,1,209.0,1.6917607439528963,13419.429651196802
2013-06-26,104.0,103.3,105.5,101.8,13230.0,230.0,0.1,103.13333333333331,41.84412999430087,0.34271858102426744,113.12693614049725,97.95306385950276,107.99250895949243,38.547486033519576,7.343471623795289,11869540.0,-4.411764705882351,0.006776379477250849,7.061030407495471,7.061030407495471,108.275,112.0,125.97663073953332,99.8,111.3,0,210.0,1.6932061715765425,13576.865643185867
2013-06-27,101.7,104.0,104.0,100.1,14730.0,230.0,0.1,102.99999999999999,39.220187378560155,0.1955918854449319,112.40190248331336,97.74809751668664,107.39322239192171,25.69832402234641,7.097509364952769,11854810.0,-2.117420596727625,-0.022115384615384537,6.978868598773618,6.978868598773618,108.275,112.0,124.45756550995199,99.8,111.3,0,211.0,1.694624717128545,13733.587937682041
2013-06-28,94.7,101.7,101.8,92.3,47770.0,230.0,0.1,100.13333333333331,32.533570928636706,-0.3203465516386088,112.8928004222784,95.93719957772161,106.18434406888156,10.572687224669627,7.269115838884714,11807040.0,-5.299999999999997,-0.06882989183874144,7.675940695759993,7.675940695759993,104.825,112.0,122.9992628895539,99.8,111.3,0,212.0,1.6959699028093895,13885.021981409249
2013-06-29,95.0,94.7,100.4,93.0,25540.0,230.0,0.1,97.13333333333331,33.060301346842564,-0.5738036173468695,113.4232487571731,94.86675124282692,105.1191684432738,11.894273127753316,7.2784647075358055,11832580.0,-4.809619238476951,0.0031678986272438703,7.6615417974061115,7.6615417974061115,104.825,112.0,121.59929237397175,99.8,111.3,0,213.0,1.6973128073546393,14037.916751867313
2013-06-30,97.5,95.0,98.1,93.8,8580.0,230.0,0.1,95.7333333333333,37.443362304436405,-0.5077491314725884,113.35973458982608,94.05026541017392,104.39353335343819,22.90748898678415,7.065717228426105,11841160.0,-2.4024024024024078,0.026315789473684292,7.246889465052416,7.246889465052416,103.45,112.0,120.25532067901288,99.8,111.3,0,214.0,1.6986751063727417,14194.4322144592
2013-07-01,88.1,97.5,98.2,86.0,53170.0,230.0,0.1,93.53333333333332,29.59634847213958,-1.0031666167856272,114.1465834781272,91.17341652187282,102.84176827215836,7.241379310344808,7.4324517121099545,11787990.0,-13.542688910696771,-0.09641025641025647,8.43638105801357,8.43638105801357,101.325,111.0,118.96510785185237,99.8,111.3,0,215.0,1.699935882109427,14342.53398393833
2013-07-02,90.4,88.1,92.6,87.5,27770.0,230.0,0.1,91.99999999999999,33.28073750416604,-1.0755801665944489,114.03136282110268,89.44863717889734,101.65683796052423,15.172413793103468,7.265848018387814,11815760.0,-15.750232991612295,0.026106696935300988,8.037442498216608,8.037442498216608,100.275,111.0,116.98720138074123,99.8,111.3,0,216.0,1.7012160538843677,14494.157466432825
2013-07-03,78.9,90.4,91.2,76.0,73620.0,230.0,0.1,85.8,25.96427456771535,-1.7572993025551682,116.24524039803853,84.73475960196146,99.48952005952192,7.43589743589745,7.832573159931542,11742140.0,-27.146814404432124,-0.12721238938053092,9.927215665312474,9.927215665312474,94.25,106.0,115.12796929789675,99.8,111.3,1,217.0,1.7023622761820594,14633.69591002
2013-07-04,80.0,78.9,84.3,72.0,63550.0,230.0,0.1,83.09999999999998,27.60374601813227,-1.9770747274324094,117.60484474126085,81.37515525873914,97.63337529194841,18.6046511627907,8.151675077079288,11805690.0,-28.122192273135667,0.0139416983523446,10.18959384634911,10.18959384634911,91.125,104.0,111.99773175406501,99.8,111.3,0,218.0,1.703516895257772,14775.454426101269
2013-07-05,68.5,80.0,80.6,65.4,91060.0,230.0,0.1,75.8,22.095064805892648,-2.6953882034832866,120.5171999814092,75.33280001859079,94.85876812128666,6.950672645739899,8.65512685728791,11714630.0,-37.44292237442922,-0.14375000000000004,12.635221689471402,12.635221689471402,87.45,100.7,107.99795857865851,68.5,111.3,1,219.0,1.7045200852321944,14902.817076885442
2013-07-06,69.7,68.5,75.0,66.8,41040.0,230.0,0.1,72.7333333333333,23.80382407174376,-2.871892826930397,122.10229452472538,70.7277054752746,92.4626949668784,9.641255605381161,8.622617796053058,11755670.0,-35.5822550831793,0.01751824817518255,12.371044183720313,12.371044183720313,86.9,100.7,102.88620354921949,68.5,111.3,0,220.0,1.7055353830724718,15032.55568601643
2013-07-07,76.5,69.7,77.0,66.6,42950.0,230.0,0.1,71.56666666666665,32.79889653538304,-2.335624952070365,122.10218642588629,68.18781357411373,90.94243830336617,24.887892376681606,8.749573667763554,11798620.0,-29.10101946246525,0.09756097560975596,11.437351199690921,11.437351199690921,86.55000000000001,100.7,98.38785912331315,68.5,111.3,0,221.0,1.7066341928879294,15172.284705207863
2013-07-08,76.0,76.5,80.0,72.5,58990.0,230.0,0.1,74.06666666666665,32.49513303771758,-1.841262716265046,121.15989122531103,66.00010877468897,89.51934894114083,23.76681614349775,8.660318405780442,11739630.0,-25.563173359451515,-0.006535947712418277,11.39515579707953,11.39515579707953,86.0,100.7,94.42931602851557,68.5,111.3,0,222.0,1.7077222692573943,15312.172288036256
2013-07-09,76.7,76.0,78.3,72.5,32520.000000000004,230.0,0.1,76.39999999999998,33.42474543487192,-1.3183036017071323,119.64626557059722,64.35373442940278,88.29845856579409,28.17955112219451,8.456009948224695,11772150.0,-25.750242013552754,0.009210526315789558,11.02478480863715,11.02478480863715,86.0,100.7,90.9457981050937,68.5,111.3,0,223.0,1.7088144627992388,15453.803101339367
2013-07-10,88.0,76.7,89.8,75.5,60070.0,230.0,0.1,80.2333333333333,46.284472539513594,-0.12536298145385238,117.05692021954133,64.61307978045869,88.27003394048037,58.549222797927456,8.873437809065788,11832220.0,-15.384615384615385,0.1473272490221642,10.083452055756577,10.083452055756577,84.6,100.7,65.4,68.5,111.3,0,224.0,1.7100314446844995,15610.369131943911
2013-07-11,89.0,88.0,90.7,85.0,35570.0,230.0,0.1,84.56666666666665,47.255435948737635,0.7679369385871002,114.59676259619216,65.02323740380784,88.33955451757748,64.83516483516483,8.646763679846803,11867790.0,-12.487708947885942,0.011363636363636465,9.715464808816632,9.715464808816632,84.25,100.7,65.888,68.5,111.3,0,225.0,1.7112541807712933,15769.168484548174
2013-07-12,94.0,89.0,104.2,88.0,101550.0,230.0,0.1,90.33333333333331,51.933834184818146,1.6801199864732794,112.51452540625137,65.68547459374862,88.87864456352249,73.71134020618555,9.186280559857746,11969340.0,-0.7391763463569195,0.05617977528089879,9.772638893465688,9.772638893465688,87.5,100.7,66.88048,68.5,111.3,1,226.0,1.7125233701504072,15934.772953202544
2013-07-13,98.3,94.0,98.3,87.8,34460.0,230.0,0.1,93.76666666666665,55.58267575661576,2.5078187724097862,110.836174288117,66.40382571188299,89.77591650985369,84.79381443298968,9.28011766272505,12003800.0,3.473684210526313,0.04574468085106376,9.440607998703001,9.440607998703001,87.5,100.7,69.1196512,68.5,111.3,0,227.0,1.7138295242840738,16106.295359577845
2013-07-14,94.4,98.3,99.0,92.9,12340.0,230.0,0.1,95.56666666666665,51.74585156151158,2.710154452055436,109.75952322352325,66.71047677647675,90.21630541367715,74.74226804123712,9.052966401101832,11991460.0,-3.1794871794871735,-0.039674465920650936,9.590006780828212,9.590006780828212,87.80000000000001,100.7,71.224472128,68.5,111.3,0,228.0,1.7150926287056045,16274.7768013261
2013-07-15,98.9,94.4,101.9,93.1,34510.0,230.0,0.1,97.19999999999999,55.55790971790742,3.0398092671679953,109.00235571719296,67.02764428280705,91.0433239457079,86.34020618556701,9.034897372451702,12025970.0,12.25879682179343,0.04766949152542366,9.135386625330336,9.135386625330336,87.80000000000001,100.7,73.20300380032,68.5,111.3,0,229.0,1.7163943686237095,16449.48166712844
2013-07-16,97.1,98.9,100.7,96.0,16530.0,230.0,0.1,96.8,53.72946411068999,3.023004577411381,107.80445802598103,67.53554197401897,91.62015023659285,81.70103092783503,8.725261845848008,12009440.0,7.411504424778748,-0.018200202224469275,8.98585154052318,8.98585154052318,89.275,100.7,75.0628235723008,68.5,111.3,0,230.0,1.7176738435723555,16623.487159999648
2013-07-17,98.5,97.1,100.0,96.2,17270.0,230.0,0.1,98.16666666666664,54.97074793255709,2.9872531969378855,107.2428051731119,67.7771948268881,92.275374023584,85.30927835051546,8.373457428287436,12026710.0,24.84157160963244,0.014418125643666402,8.50097200841364,8.50097200841364,88.025,100.45,76.81105415796276,68.5,111.3,0,231.0,1.7189616877309886,16800.332634965074
2013-07-18,90.1,98.5,98.8,86.2,59500.0,230.0,0.1,95.2333333333333,46.84974398715397,2.3092788845140717,106.77806144210219,67.78193855789782,92.06819554514743,63.65979381443297,8.675353326266904,11967210.0,12.624999999999991,-0.08527918781725896,9.628583048020982,9.628583048020982,88.775,99.05,78.454390908485,68.5,111.3,0,232.0,1.7201612552553058,16968.585799013432
2013-07-19,92.0,90.1,95.2,87.6,27680.0,230.0,0.1,93.5333333333333,48.69598513684268,1.9163708376513116,106.43337794273302,67.82662205726697,92.06170073132387,67.5531914893617,8.598542374390698,11994890.0,34.306569343065696,0.021087680355160954,9.346241711294237,9.346241711294237,91.15,99.05,79.9991274539759,68.5,111.3,0,233.0,1.7213755125702892,17140.299715651727
2013-07-20,89.8,92.0,93.1,89.3,9430.0,230.0,0.1,90.63333333333331,46.67429498480636,1.4567134740238181,105.50522121404734,67.98477878595264,91.84630066167398,61.702127659574465,8.255789347648506,11985460.0,28.83787661406025,-0.023913043478260954,9.193529340365819,9.193529340365819,91.45,98.9,81.45117980673734,68.5,111.3,0,234.0,1.7225623902006046,17310.44584574706
2013-07-21,92.0,89.8,92.0,88.0,8770.0,230.0,0.1,91.26666666666665,48.9564593232449,1.2567925064740533,105.83310985518244,68.04689014481755,91.8609386938955,61.51419558359621,7.95180439424504,11994230.0,20.26143790849673,0.024498886414253906,8.643265645918522,8.643265645918522,89.75,97.75,82.81610901833311,68.5,111.3,0,235.0,1.7237670721982432,17484.473706159235
2013-07-22,91.6,92.0,92.0,89.8,9100.0,230.0,0.1,91.13333333333331,48.54962444573395,1.0613590572571727,105.94423395125789,68.05576604874211,91.83608738971498,60.252365930599346,7.540961223227538,11985130.0,20.526315789473674,-0.004347826086956608,8.232490418370675,8.232490418370675,89.42500000000001,97.75,84.09914247723312,68.5,111.3,0,236.0,1.7249629183757584,17659.17176467159
2013-07-23,95.6,91.6,97.1,91.6,24610.0,230.0,0.1,93.06666666666665,52.77588874671165,1.1573619107554423,106.7496794844637,68.92032051553632,92.19455525736116,70.03484320557489,7.395178278711286,12009740.0,24.64146023468056,0.04366812227074246,7.735542132543187,7.735542132543187,89.42500000000001,97.75,85.30519392859912,68.5,111.3,0,237.0,1.726193744832401,17839.999550493285
2013-07-24,95.1,95.6,96.0,92.3,14600.0,230.0,0.1,94.09999999999997,52.19869391061627,1.1411814154342224,107.39860441393756,69.78139558606244,92.47126428046963,52.60416666666663,7.1312369730890515,11995140.0,8.068181818181811,-0.005230125523012608,7.498671895992694,7.498671895992694,89.125,94.7,86.43888229288318,68.5,111.3,0,238.0,1.7274148569300032,18021.46710790949
2013-07-25,96.9,95.1,97.5,93.6,22510.0,230.0,0.1,95.86666666666666,54.143064718457524,1.199714422224898,106.70693385026098,73.31306614973903,92.89304863471061,59.44444444444446,6.90043433215412,12017650.0,8.87640449438203,0.018927444794952786,7.121191261252961,7.121191261252961,88.95,94.7,87.50454935531019,68.5,111.3,0,239.0,1.7286485547922468,18206.400457796186
2013-07-26,96.0,96.9,97.5,96.0,11150.0,230.0,0.1,95.99999999999999,52.98261217966516,1.126965923607859,105.34453993538983,77.30546006461017,93.18894876473817,62.42038216560507,6.51468902271454,12006500.0,2.127659574468085,-0.009287925696594534,6.7861343986609794,6.7861343986609794,88.65,94.45,88.50627639399158,68.5,111.3,0,240.0,1.7298687595689886,18391.507508831248
2013-07-27,94.4,96.0,97.0,93.0,15120.0,230.0,0.1,95.76666666666665,50.894205638261106,0.9285053692813252,104.519528446245,79.920471553755,93.30428697762025,52.22929936305733,6.33506837823493,11991380.0,-3.9674465920650985,-0.016666666666666607,6.710877519316663,6.710877519316663,88.67500000000001,94.35,89.44789981035208,94.4,111.3,0,241.0,1.73106859704796,18575.859492016865
2013-07-28,98.8,94.4,100.6,94.0,42230.0,230.0,0.1,96.39999999999998,56.02733112336804,1.0424442954336883,103.46552324226656,83.25447675773344,93.82768821784688,80.25477707006365,6.353992065503863,12033610.0,4.661016949152533,0.0466101694915253,6.431166058202291,6.431166058202291,89.55000000000001,92.25,90.33302582173096,94.4,111.3,0,242.0,1.7323058491786962,18766.994616335072
2013-07-29,101.5,98.8,102.8,98.4,24740.0,230.0,0.1,98.2333333333333,58.868637141641635,1.2353503270783723,101.92884711260845,87.27115288739154,94.55838457805194,92.1686746987952,6.214421203682157,12058350.0,2.628918099089984,0.027327935222672073,6.122582466681928,6.122582466681928,90.10000000000001,90.2,91.1650442724271,94.4,111.3,0,243.0,1.7335631882146558,18962.78205823625
2013-07-30,108.0,101.5,108.0,100.5,27850.0,230.0,0.1,102.76666666666665,64.7703466784898,1.7073304668837128,104.36994868856077,86.83005131143922,95.83853842776128,99.99999999999999,6.306248260562002,12086200.0,11.225540679711644,0.0640394088669951,5.839118759779631,5.839118759779631,92.80000000000001,90.2,91.94714161608147,94.4,108.0,0,244.0,1.734872970843034,19167.67501969528
2013-07-31,106.2,108.0,111.7,103.6,45500.0,230.0,0.1,105.2333333333333,62.112513800693996,1.7959089111033635,105.82555390780432,87.0944460921957,96.82534429178402,78.43137254901961,6.434373384807574,12040700.0,7.817258883248734,-0.016666666666666607,6.058732000760427,6.058732000760427,95.4,90.2,93.23137028679496,94.4,108.0,0,245.0,1.7361622166450905,19372.010387593484
2013-08-01,104.0,106.2,108.0,103.0,15020.0,230.0,0.1,106.06666666666665,58.929635303010116,1.6099148666296137,106.80243872218611,87.1175612778139,97.50864483542364,68.04979253112033,6.331918143035604,12025680.0,15.427302996670372,-0.020715630885122405,6.088382829841927,6.088382829841927,95.575,90.2,95.07823325811546,94.4,108.0,0,246.0,1.7374271967673127,19575.210440709074
2013-08-02,104.5,104.0,108.0,101.2,27500.0,230.0,0.1,104.89999999999998,59.43836653100114,1.4302125914221544,107.63823996635824,86.90176003364178,98.17448818443091,69.62025316455696,6.365352561390203,12053180.0,13.586956521739129,0.004807692307692291,6.091246470229859,6.091246470229859,97.225,90.2,96.74040993230392,94.4,108.0,0,247.0,1.738691699202367,19780.492860233473
2013-08-03,104.9,104.5,105.9,102.0,8900.0,230.0,0.1,104.46666666666665,59.866658400383926,1.2542326553294112,108.5836004653054,87.00639953469458,98.81501311924701,71.30801687763714,6.189255949862333,12062080.0,16.815144766147004,0.003827751196172402,5.9001486652643775,5.9001486652643775,97.225,90.2,98.23636893907353,94.4,108.0,0,248.0,1.7399548279905972,19987.75279996808
2013-08-04,105.1,104.9,106.0,103.5,6380.0,230.0,0.1,104.83333333333331,60.09355195320994,1.0741887856329022,109.34946085857334,86.86053914142667,99.41358329836635,69.86301369863011,5.925737667729309,12068460.0,14.239130434782602,0.0019065776930409228,5.63818997881,5.63818997881,97.975,90.2,99.58273204516618,94.4,108.0,0,249.0,1.7412148270456114,20196.758411757182
2013-08-05,106.7,105.1,107.8,105.0,15440.0,230.0,0.1,105.56666666666665,61.946999952792424,0.98793235405914,110.42092412952988,86.74907587047011,100.10752774614099,75.12437810945275,5.7024706914629295,12083900.0,16.484716157205252,0.015223596574690745,5.344396149449794,5.344396149449794,100.6,90.2,100.79445884064957,94.4,108.0,0,250.0,1.7424838369608844,20409.257408945577
2013-08-06,106.6,106.7,107.5,105.1,13410.0,230.0,0.1,106.13333333333331,61.753951296379235,0.8542400502480634,111.33016207348945,86.64983792651054,100.72585843698471,73.71134020618554,5.466579927787007,12070490.0,11.506276150627617,-0.0009372071227742307,5.128123759650101,5.128123759650101,102.0,90.2,101.88501295658462,94.4,108.0,0,251.0,1.7437470986892871,20623.178327645233
2013-08-07,106.0,106.6,107.0,105.2,7720.0,230.0,0.1,106.43333333333332,60.53499275951907,0.6639684144077229,111.7755421061763,87.79445789382369,101.22815763346236,69.51871657754009,5.204681361516506,12062770.0,11.461619348054686,-0.0056285178236397115,4.910076756147648,4.910076756147648,102.525,90.2,102.86651166092615,94.4,108.0,0,252.0,1.7450003176656688,20837.890682365058
2013-08-08,103.1,106.0,106.7,101.0,24020.0,230.0,0.1,105.2333333333333,54.894883926663184,0.29991435783090603,111.85597151785235,88.82402848214765,101.40642833503738,54.01069518716574,5.240061264265328,12038750.0,6.398348813209482,-0.027358490566037785,5.082503651081793,5.082503651081793,102.65,90.2,111.7,94.4,108.0,0,253.0,1.7462232897523005,21050.386529816988
2013-08-09,102.8,103.1,105.8,101.9,12040.0,230.0,0.1,103.96666666666664,54.33093971113553,0.011263522315964725,111.47425486145707,90.50574513854292,101.5391494459862,52.406417112299444,5.14434260253209,12026710.0,7.08333333333333,-0.0029097963142580285,5.0042243215292705,5.0042243215292705,101.725,90.2,111.486,94.4,108.0,0,254.0,1.7474388461328663,21263.95910975408
2013-08-10,103.0,102.8,103.9,102.4,4000.0,230.0,0.1,102.96666666666664,54.66531051172696,-0.18311132120683737,111.20196667350834,91.87803332649165,101.678278070178,50.84745762711864,4.88403241663694,12030710.0,9.110169491525417,0.0019455252918287869,4.741779045278583,4.741779045278583,101.725,90.2,111.27628,94.4,108.0,0,255.0,1.7486514557874202,21479.27084677722
2013-08-11,105.0,103.0,105.2,102.7,8170.0,230.0,0.1,103.59999999999998,57.97861476366229,-0.19291720627934428,110.82345459150889,93.5965454084911,101.99463253968486,49.62406015037591,4.713744386877159,12038880.0,6.2753036437247,0.01941747572815533,4.489280368454437,4.489280368454437,101.67500000000001,90.2,111.0707544,94.4,108.0,0,256.0,1.7498769232488374,21698.73852471855
2013-08-12,106.8,105.0,108.1,103.5,20080.0,230.0,0.1,104.93333333333332,60.75836011833578,-0.09884863861844728,111.04117887607235,94.49882112392767,102.4522865835244,56.249999999999964,4.705619787814505,12058960.0,5.221674876847287,0.017142857142857126,4.406011037279499,4.406011037279499,101.75,88.55000000000001,110.869339312,94.4,108.0,0,257.0,1.7511131634180204,21922.124511129823
2013-08-13,109.6,106.8,109.6,104.5,18750.0,230.0,0.1,107.13333333333331,64.67316067150276,0.11943815373554267,111.48711486403849,95.50288513596152,103.1330211946173,80.37383177570086,4.733789802970612,12077710.0,1.481481481481476,0.02621722846441954,4.319151280082675,4.319151280082675,102.475,88.55000000000001,110.67195252575999,94.4,108.0,0,258.0,1.7523682371773575,22150.758194327
2013-08-14,112.6,109.6,115.0,108.0,50570.0,230.0,0.1,109.66666666666663,68.319841437498,0.4166308775145571,112.6040855353597,95.9559144646403,104.03463822370136,82.85714285714282,4.895661959901282,12128280.0,6.0263653483992385,0.027372262773722733,4.347834777887462,4.347834777887462,104.75,90.2,101.0,94.4,108.0,1,259.0,1.7536431016874925,22384.907110538035
2013-08-15,110.0,112.6,113.3,108.8,15860.0,230.0,0.1,110.7333333333333,62.315998806538694,0.38937247335613323,112.73644248350904,97.22355751649094,104.6027679166822,64.28571428571429,4.867400391336905,12112420.0,5.769230769230769,-0.023090586145648295,4.424909446669913,4.424909446669913,104.75,90.2,101.28,94.4,108.0,0,260.0,1.754891839489843,22617.399159839213
2013-08-16,109.0,110.0,112.3,108.2,13540.0,230.0,0.1,110.5333333333333,60.12739974441342,0.2614041219373009,111.94503007209939,99.4749699279006,105.02155192461723,57.142857142857146,4.812586077669983,12098880.0,4.30622009569378,-0.009090909090909038,4.4152165850183325,4.4152165850183325,105.2,90.2,101.5544,109.0,108.0,0,261.0,1.7561274852866449,22850.222852474442
2013-08-17,112.8,109.0,114.0,108.2,12780.0,230.0,0.1,110.59999999999998,65.13797448650527,0.38275003254486606,112.52715620202585,100.29284379797414,105.76235650322512,84.28571428571426,4.883115643550697,12111660.0,7.530981887511907,0.034862385321100975,4.329003230098135,4.329003230098135,105.875,90.2,101.823312,109.0,108.0,0,262.0,1.7573895216206825,23089.743627700736
2013-08-18,113.4,112.8,114.7,112.0,9620.0,230.0,0.1,111.7333333333333,65.86732394070616,0.44891125045894853,113.40452341975424,100.60547658024575,106.48975112196558,88.5714285714286,4.727178811868504,12121280.0,7.8972407231208495,0.005319148936170359,4.168588017520727,4.168588017520727,106.17500000000001,90.2,102.08684576,109.0,108.0,0,263.0,1.758651560686666,23331.79552954895
2013-08-19,118.5,113.4,123.8,111.8,53070.0,230.0,0.1,114.89999999999998,71.35337789026232,0.7631718193629355,115.65898517651391,99.4010148234861,107.63358434844505,76.75438596491229,5.246666039592183,12174350.0,11.059044048734767,0.04497354497354489,4.427566278136863,4.427566278136863,110.825,94.6,102.34510884480001,109.0,108.0,1,264.0,1.759948690894136,23582.22109584101
2013-08-20,121.2,118.5,123.0,116.8,24290.0,230.0,0.1,117.69999999999997,73.75809181476615,1.0615603805588059,118.32242998481854,98.23757001518146,108.92562393430744,88.59649122807019,5.314761322478455,12198640.0,13.696060037523461,0.0227848101265824,4.385116602704996,4.385116602704996,111.025,94.6,103.20330449100801,109.0,108.0,0,265.0,1.76126133784759,23837.95655451242
2013-08-21,123.3,121.2,125.0,119.7,30640.0,230.0,0.1,120.99999999999999,75.48200416104487,1.2936485442440153,121.01708137926263,97.47291862073737,110.29461213104007,92.91666666666664,5.3137069423014225,12229280.0,16.320754716981128,0.017326732673267342,4.30957578451048,4.30957578451048,111.875,95.2,104.02717231136769,109.0,108.0,0,266.0,1.7625846017298181,24098.28683735704
2013-08-22,122.0,123.3,124.5,120.5,13960.0,230.0,0.1,122.16666666666664,72.31494225157418,1.2520859144832297,122.90883888396368,97.33116111603633,111.40941097570293,87.01298701298701,5.219870732137035,12215320.0,18.33171677982542,-0.010543390105433925,4.278582567325438,4.278582567325438,113.0,95.2,105.28554197268564,109.0,108.0,0,267.0,1.7638933185569334,24358.991744279723
2013-08-23,118.5,122.0,122.0,118.4,19470.0,230.0,0.1,121.26666666666665,64.4717644296653,0.8979304331494955,123.84990421420713,97.75009578579287,112.08470516849312,71.23893805309734,5.104165679841532,12195850.0,15.272373540856035,-0.02868852459016391,4.307312809992854,4.307312809992854,114.15,95.2,106.4684094543245,109.0,108.0,0,268.0,1.7651708136655062,24617.13430794636
2013-08-24,119.6,118.5,121.4,118.0,8960.0,230.0,0.1,120.0333333333333,65.72979178574994,0.6579279123968584,124.83617951197343,98.21382048802658,112.80044753339854,75.78475336322867,4.982439559852851,12204810.0,16.116504854368927,0.009282700421940904,4.16591936442546,4.16591936442546,114.675,95.2,107.58030488706503,109.0,108.0,0,269.0,1.7664518240163374,24878.649514266515
2013-08-25,122.1,119.6,123.0,119.1,7440.0,230.0,0.1,120.06666666666665,68.46297748848926,0.5899007630965807,126.17037026532915,98.41962973467085,113.6861191968844,86.51162790697673,4.90512244843479,12212250.0,16.28571428571428,0.020903010033444858,4.017299302567396,4.017299302567396,114.8,95.2,108.62548659384112,109.0,108.0,0,270.0,1.7677466642976618,25145.411297205792
2013-08-26,120.1,122.1,123.0,119.9,11440.0,230.0,0.1,120.59999999999997,64.06125640759507,0.34470655013865326,126.9842927042352,98.9557072957648,114.2969649876573,76.09756097560974,4.776185130689448,12200810.0,12.453183520599248,-0.016380016380016404,3.976840242039507,3.976840242039507,115.7,95.8,109.60795739821064,109.0,108.0,0,271.0,1.7690217539988695,25411.52535840923
2013-08-27,131.3,120.1,133.0,120.0,53850.0,230.0,0.1,124.49999999999999,74.10266304441942,0.8429284462224356,129.96653202965243,98.5034679703476,115.91630165549947,93.20000000000003,5.363600478497345,12254660.0,19.799270072992716,0.09325562031640322,4.084996556357459,4.084996556357459,119.7,99.8,110.531479954318,109.0,108.0,1,272.0,1.7703723243117377,25694.120492245904
2013-08-28,128.8,131.3,131.7,128.0,12560.0,230.0,0.1,126.7333333333333,69.43885281051696,0.9047683432869729,131.5981342201133,99.44186577988665,117.1433205454519,83.0645161290323,5.24477187289039,12242100.0,14.387211367673194,-0.01904036557501909,4.072027851622973,4.072027851622973,120.95,102.75,112.32896155797256,109.0,108.0,0,273.0,1.7717005943069613,25975.807786557176
2013-08-29,129.3,128.8,131.2,128.2,8220.0,230.0,0.1,129.79999999999998,69.84758963785055,0.8792415492835728,132.87939740058786,100.81060259941215,118.30109954112315,85.08064516129036,5.084431024826791,12250320.0,17.545454545454557,0.0038819875776396895,3.932274574498678,3.932274574498678,121.25,102.75,113.98264463333476,109.0,108.0,0,274.0,1.773027406419295,26260.339180100764
2013-08-30,138.0,129.3,142.8,128.6,46070.0,230.0,0.1,132.03333333333333,75.88994484882107,1.321594036577297,135.80028697813486,101.38971302186512,120.17718529911141,86.12716763005777,5.735543094482021,12296390.0,26.605504587155966,0.06728538283062635,4.156190648175378,4.156190648175378,126.15,109.15,115.50403306266797,109.0,108.0,1,275.0,1.7744077682735484,26558.021312578032
2013-08-31,141.0,138.0,148.7,135.9,31150.0,230.0,0.1,136.1,77.55986737195184,1.6672424808223028,139.00934661759518,101.78065338240484,122.16031050871986,79.13279132791331,6.240147159161876,12327540.0,25.000000000000007,0.021739130434782705,4.425636283093529,4.425636283093529,129.1,116.85,118.23362975640117,109.0,108.0,0,276.0,1.7758023571413963,26861.796448508827
2013-09-01,146.0,141.0,147.3,141.0,14100.0,230.0,0.1,141.66666666666666,80.04110340581587,2.057994586521766,142.9774610558482,101.73253894415178,124.43075712693701,92.68292682926833,6.244422362078886,12341640.0,28.747795414462075,0.03546099290780136,4.2770016178622505,4.2770016178622505,129.1,117.44999999999999,121.88959418563303,109.0,146.0,0,277.0,1.7772230822032795,27174.07548963006
2013-09-02,144.0,146.0,148.5,142.1,10650.0,230.0,0.1,143.66666666666666,76.40201866843995,2.0051186896739246,145.86067189691371,102.2893281030863,126.29449454341919,85.26645768025082,6.255535050501824,12330990.0,21.518987341772153,-0.013698630136986356,4.344121562848489,4.344121562848489,129.375,117.44999999999999,125.10684288335706,109.0,146.0,0,278.0,1.7786262845301808,27486.62419529212
2013-09-03,144.0,144.0,148.9,142.2,17000.0,230.0,0.1,144.66666666666666,76.40201866843994,1.8000224537658278,148.40070038473823,102.88929961526179,127.98073315833165,84.14239482200645,6.287282546894552,12347990.0,18.81188118811881,0.0,4.36616843534344,4.36616843534344,129.9,117.55000000000001,127.9380217373542,109.0,146.0,0,279.0,1.7800243698358178,27801.796292140814
2013-09-04,132.5,144.0,145.8,130.1,28750.0,230.0,0.1,140.16666666666666,58.626876923205614,0.7722631927421792,148.52326182437878,105.01673817562124,128.41113952420483,46.925566343042064,6.959619507830657,12319240.0,7.4614760746147635,-0.07986111111111116,5.252543024777854,5.252543024777854,130.05,117.55000000000001,148.9,109.0,146.0,0,280.0,1.7813429401098009,28104.868580763705
2013-09-05,130.2,132.5,138.0,127.2,27030.0,230.0,0.1,135.56666666666663,55.829281205276715,-0.13188611294466046,148.0267423115703,107.6332576884297,128.58150718856626,39.482200647249144,7.233932400128467,12292210.0,6.721311475409827,-0.017358490566037776,5.556015668301434,5.556015668301434,131.925,117.55000000000001,148.9,109.0,146.0,0,281.0,1.7826409844260676,28407.16398504223
2013-09-06,121.9,130.2,134.0,121.9,19170.0,230.0,0.1,128.19999999999996,47.09549595238654,-1.2937674804859212,147.49263129591918,109.07736870408083,127.94517317060757,12.621359223300987,7.581508657262147,12273040.0,2.8691983122362914,-0.06374807987711206,6.219449267647372,6.219449267647372,130.8,117.55000000000001,148.032,121.9,146.0,0,282.0,1.7838754138968869,28699.871910512473
2013-09-07,129.0,121.9,131.0,121.3,14190.0,230.0,0.1,127.0333333333333,53.75940185249992,-1.5705417895110347,147.01741209419987,111.11258790580014,128.04563286864496,33.22147651006712,7.732829467457708,12287230.0,7.859531772575255,0.05824446267432326,5.994441447641634,5.994441447641634,130.9,117.55000000000001,146.46408000000002,121.9,146.0,0,283.0,1.785155673066555,29004.983365106553
2013-09-08,126.3,129.0,129.9,124.1,7350.0,230.0,0.1,125.7333333333333,51.12224348104653,-1.8998726979913574,146.80106295388012,112.10893704611985,127.8793821192502,22.06896551724135,7.594770219782157,12279880.0,3.4398034398034425,-0.020930232558139528,6.0132780837546775,6.0132780837546775,131.77499999999998,118.25,144.45095360000002,121.9,146.0,0,284.0,1.7864123183448137,29308.486865786897
2013-09-09,133.1,126.3,137.5,124.0,29690.0,230.0,0.1,129.46666666666667,56.86174516058565,-1.6342829939523327,147.03522887687927,113.06477112312075,128.37658382217876,45.32871972318337,8.016572346940574,12309570.0,10.824313072439635,0.05384006334125102,6.022969456754752,6.022969456754752,131.825,118.45,142.598877312,121.9,146.0,0,285.0,1.787710941487439,29623.95353047028
2013-09-10,132.6,133.1,136.0,131.4,8880.0,230.0,0.1,130.66666666666666,56.33789233095056,-1.4718753110099048,147.24285401657883,113.78714598342114,128.7788139343522,40.94202898550723,7.772531465016248,12300690.0,0.9900990099009771,-0.0037565740045079066,5.861637605592947,5.861637605592947,131.825,118.45,140.89496712704002,121.9,146.0,0,286.0,1.7890014091626738,29941.121769785437
2013-09-11,142.1,132.6,145.9,127.5,41560.0,230.0,0.1,135.9333333333333,63.26306107316687,-0.7411224592884729,148.49416860997826,114.54583139002169,130.04749832155676,75.36231884057968,8.53163636037223,12342250.0,10.326086956521726,0.0716440422322775,6.0039664745758135,6.0039664745758135,131.825,119.35,121.3,121.9,146.0,0,287.0,1.7903485782196302,30273.81085571323
2013-09-12,139.4,142.1,145.5,137.5,20530.0,230.0,0.1,138.03333333333333,60.33410163978135,-0.469335469028235,148.7597244496463,116.37027555035368,130.9382127671228,65.57971014492755,8.493662334631356,12321720.0,7.811291569992261,-0.0190007037297677,6.093014587253483,6.093014587253483,131.975,120.25,121.792,121.9,146.0,0,288.0,1.7916737890772898,30605.488553668423
2013-09-13,140.7,139.4,145.6,137.8,20120.0,230.0,0.1,140.73333333333332,61.26401404384068,-0.24312654648033316,149.02890651538814,118.21109348461185,131.86790678930157,70.28985507246371,8.44411502501483,12341840.0,1.9565217391304266,0.009325681492108995,6.001503216073085,6.001503216073085,131.975,120.6,122.27416,121.9,146.0,0,289.0,1.7930023684827794,30941.564416040797
2013-09-14,136.7,140.7,142.0,136.5,8900.0,230.0,0.1,138.9333333333333,56.84789797741499,-0.39502280294779535,148.8640621467586,119.83593785324139,132.32810614270142,55.79710144927531,8.233821094656628,12332940.0,-3.04964539007093,-0.028429282160625458,6.023278050224308,6.023278050224308,133.225,120.95,122.74667679999999,121.9,146.0,0,290.0,1.794300518671434,31274.648894330254
2013-09-15,138.3,136.7,141.0,135.0,6440.0,230.0,0.1,138.56666666666666,58.147473101098726,-0.4176661534951478,148.29278941746438,122.22721058253568,132.8968579386346,61.594202898550755,8.074262445038297,12339380.0,-5.273972602739718,0.0117044623262621,5.838223026058059,5.838223026058059,133.52499999999998,120.95,123.20974326399998,121.9,146.0,0,291.0,1.7956041872413517,31612.57787668396
2013-09-16,139.4,138.3,142.2,137.9,10610.0,230.0,0.1,138.13333333333333,59.06032682353034,-0.38906617106441743,148.6837979475822,122.64620205241779,133.5162048016218,65.57971014492755,7.804672270392703,12349990.0,-3.1944444444444406,0.00795372378886472,5.598760595690604,5.598760595690604,134.2,120.95,123.66354839871998,121.9,146.0,0,292.0,1.7969100691693796,31954.68626304616
2013-09-17,139.1,139.4,141.4,138.0,9640.0,230.0,0.1,138.9333333333333,58.684389581389624,-0.4183050874504861,148.8828500738996,123.47714992610044,134.04799482051496,72.35772357723573,7.49005282250751,12340350.0,-3.4027777777777817,-0.002152080344332896,5.384653359099575,5.384653359099575,134.2,121.45,124.10827743074559,121.9,146.0,0,293.0,1.7982092502331832,32298.999631331535
2013-09-18,140.4,139.1,142.0,139.0,9490.0,230.0,0.1,139.63333333333333,59.87625640918133,-0.3792018887603108,149.1537398716605,124.31626012833948,134.65294769475165,77.64227642276424,7.169334763756973,12349840.0,5.9622641509434,0.009345794392523477,5.106363791849696,5.106363791849696,135.075,123.65,124.54411188213068,121.9,146.0,0,294.0,1.79951187167092,32647.844917879578
2013-09-19,135.1,140.4,141.2,131.1,21020.0,230.0,0.1,138.2,53.14504076343476,-0.7196453340248965,149.01399291693176,124.16600708306825,134.6955241047753,56.097560975609724,7.378667994917189,12328820.0,3.763440860215059,-0.037749287749287874,5.461634341167423,5.461634341167423,135.35,124.7,124.97122964448806,121.9,146.0,0,295.0,1.8007757611870014,32991.470102722604
2013-09-20,133.8,135.1,137.3,131.0,11050.0,230.0,0.1,136.43333333333334,51.612383847618815,-1.0232237821668324,148.53871236157423,123.92128763842575,134.6102360947967,50.813008130081336,7.301620280994533,12317770.0,9.762100082034458,-0.009622501850480969,5.457115307170802,5.457115307170802,136.35000000000002,124.95,125.3898050515983,121.9,146.0,0,296.0,1.802026453110335,33335.635156183824
2013-09-21,134.4,133.8,136.0,132.0,5090.0,230.0,0.1,134.4333333333333,52.29618200400145,-1.1641961851847737,147.1277175431342,124.1722824568658,134.59021360957797,47.488584474885855,7.065790260923495,12322860.0,4.186046511627911,0.004484304932735439,5.257284420329982,5.257284420329982,136.375,124.95,125.80000895056634,121.9,146.0,0,297.0,1.8032764510789676,33683.25308274969
2013-09-22,134.0,134.4,135.0,131.0,5890.0,230.0,0.1,134.06666666666663,51.77092356861838,-1.2570244882284864,145.98226661414733,124.31773338585268,134.53400278961817,45.66210045662099,6.846805242286102,12316970.0,6.096595407759306,-0.0029761904761904656,5.1095561509597776,5.1095561509597776,135.85,124.95,126.20200877155501,121.9,146.0,0,298.0,1.8045191972230425,34032.78153141036
2013-09-23,133.4,134.0,135.0,132.0,6000.0,230.0,0.1,133.93333333333334,50.944362161532716,-1.3247093087624466,144.6779520778323,124.56204792216771,134.42600252394024,32.065217391304365,6.572033439265667,12310970.0,0.22539444027048186,-0.004477611940298498,4.926561798549975,4.926561798549975,135.85,124.95,126.59596859612391,121.9,146.0,0,299.0,1.8057533919355835,34383.888808480806
2013-09-24,134.8,133.4,136.6,132.5,8580.0,230.0,0.1,134.06666666666666,52.83651648575122,-1.242431923322087,144.7458491148339,124.72415088516607,134.46162133118403,39.67391304347831,6.395459622175261,12319550.0,1.659125188536966,0.010494752623688264,4.744406247904496,4.744406247904496,135.85,124.95,126.98204922420143,121.9,146.0,0,300.0,1.806992179000405,34739.77212683353
2013-09-25,135.0,134.8,138.0,134.7,9520.0,230.0,0.1,134.4,53.11473794158553,-1.1442236918392954,144.76721629662921,125.18278370337077,134.5128954901189,27.397260273972613,6.174355363448457,12329070.0,-4.99648135116115,0.0014836795252224366,4.573596565517376,4.573596565517376,135.8,124.95,127.3604082397174,121.9,146.0,0,301.0,1.8082276804951185,35098.5525420315
2013-09-26,137.1,135.0,139.0,134.7,6540.0,230.0,0.1,135.63333333333333,56.04664853273323,-0.9173170739646777,143.49960559204206,127.97039440795797,134.75928639582185,41.7808219178082,6.0404728374878545,12335610.0,-1.6499282639885304,0.015555555555555545,4.405888284090339,4.405888284090339,135.8,124.95,127.73120007492305,121.9,146.0,0,302.0,1.809472144407448,35463.310858578596
2013-09-27,138.9,137.1,142.7,134.8,27140.0,230.0,0.1,137.0,58.44532752684553,-0.638694168635717,143.45775207100868,129.0022479289913,135.15364007241024,67.52136752136764,6.17329620623872,12362750.0,-1.279317697228133,0.013129102844638973,4.444417715074672,4.444417715074672,135.975,124.95,128.0945760734246,121.9,146.0,0,303.0,1.810723443861626,35833.61870020617
2013-09-28,142.5,138.9,143.0,138.0,13660.0,230.0,0.1,139.5,62.816023942101886,-0.22593486126455176,143.18472131182287,130.89527868817711,135.85329339884737,95.83333333333333,6.089489334364525,12376410.0,4.242867593269943,0.02591792656587466,4.273325848676859,4.273325848676859,136.05,124.95,128.4506845519561,121.9,146.0,0,304.0,1.8119925368244476,36212.37412413428
2013-09-29,143.9,142.5,145.8,141.4,18100.0,230.0,0.1,141.76666666666665,64.38485339079278,0.10937711015979801,144.12968701542067,131.0303129845793,136.61964640848095,87.16216216216213,5.96881152476706,12394510.0,4.04916847433116,0.009824561403508847,4.147888481422557,4.147888481422557,136.0,125.4,128.799670860917,121.9,143.9,0,305.0,1.81326553232837,36596.17282527753
2013-09-30,141.9,143.9,145.8,138.1,14630.0,230.0,0.1,142.76666666666668,60.4604136605424,0.16133963465923662,144.43294959278566,131.65705040721437,137.12253722672085,73.64864864864862,6.092467844426557,12379880.0,1.7934002869440457,-0.013898540653231373,4.293493900230132,4.293493900230132,136.0,125.65,129.14167744369865,121.9,143.9,0,306.0,1.8145216419112726,36979.65844284831
2013-10-01,140.3,141.9,144.4,139.4,9570.0,230.0,0.1,142.03333333333333,57.44385219391062,0.0581395936829221,144.15998992746728,131.75001007253275,137.42515272893792,62.83783783783787,6.014434426967518,12370310.0,0.8626887131560151,-0.01127554615926707,4.286838508173569,4.286838508173569,136.25,125.80000000000001,129.47684389482467,121.9,143.9,0,307.0,1.8157632436335187,37363.36260317968
2013-10-02,123.0,140.3,141.9,109.7,111320.0,230.0,0.1,135.06666666666666,36.33461833168822,-1.138973254488941,146.08626248078843,128.1837375192116,136.05132865951526,36.84210526315788,7.88483196789841,12258990.0,-12.393162393162397,-0.12330719885958663,6.41043249422635,6.41043249422635,127.775,126.2,145.9,123.0,143.9,1,308.0,1.8168854745575873,37719.24362085578
2013-10-03,131.0,123.0,132.0,120.1,35270.0,230.0,0.1,131.4333333333333,46.18323186897606,-1.341791978937382,145.8244209626532,127.47557903734682,135.57024973956143,59.00277008310247,8.171629684477095,12294260.0,-3.034789045151735,0.06504065040650397,6.2378852553260264,6.2378852553260264,127.775,126.7,145.17600000000002,123.0,143.9,1,309.0,1.818058378056911,38092.17768225393
2013-10-04,136.8,131.0,139.8,128.5,18510.0,230.0,0.1,130.26666666666665,51.98274776365691,-1.0481149616987542,145.82963350766505,127.48036649233495,135.68736881198416,75.06925207756234,8.395084707014446,12312770.0,2.242152466367713,0.04427480916030535,6.136757826764945,6.136757826764945,127.775,128.45,144.46648000000002,123.0,143.9,0,310.0,1.8192646316355783,38477.89529404771
2013-10-05,136.7,136.8,138.0,135.3,5000.0,230.0,0.1,134.83333333333334,51.8789418897096,-0.8327744173281841,145.7187136875544,127.43128631244556,135.78380987750947,74.79224376731297,7.988292942227699,12307770.0,1.711309523809511,-0.0007309941520469154,5.84366711209049,5.84366711209049,127.775,128.55,143.7711504,123.0,143.9,0,311.0,1.8204657878777903,38866.14656561208
2013-10-06,137.8,136.7,138.0,134.1,4890.0,230.0,0.1,137.1,52.99098398202592,-0.5993429057596609,145.56615758875185,127.42384241124816,135.9758279844133,77.83933518005541,7.6962720177828645,12312660.0,2.8358208955223967,0.008046817849305166,5.5851030608003365,5.5851030608003365,127.775,128.55,143.08972739200001,123.0,143.9,0,312.0,1.8216694680539742,39259.04451763735
2013-10-07,135.8,137.8,139.0,135.1,7360.0,230.0,0.1,136.76666666666665,50.69700034657235,-0.5632779261134075,145.32535435655373,127.33464564344625,135.95908246208825,72.29916897506926,7.425109730798375,12305300.0,1.7991004497751164,-0.014513788098693747,5.467680214137242,5.467680214137242,127.75,128.55,142.42193284416,123.0,143.9,0,313.0,1.8228560025080396,39651.13535720663
2013-10-08,136.5,135.8,137.8,135.6,5230.0,230.0,0.1,136.70000000000002,51.48856282608698,-0.4792175342377676,144.93597153727762,127.33402846272243,136.01059841807984,74.23822714681438,7.051887607169921,12310530.0,1.2611275964391606,0.005154639175257714,5.166218027230712,5.166218027230712,127.75,129.3,141.7674941872768,123.0,143.9,0,314.0,1.8240426010660906,40047.188340486035
2013-10-09,139.5,136.5,142.1,135.8,17490.0,230.0,0.1,137.26666666666665,54.83528046676286,-0.22160827197085853,145.26083516577586,127.44916483422412,136.3429223782627,82.54847645429359,6.998181349514925,12328020.0,3.3333333333333335,0.0219780219780219,5.016617454849408,5.016617454849408,127.4,129.3,109.7,123.0,143.9,0,315.0,1.8252436569127333,40451.36197222713
2013-10-10,140.4,139.5,141.7,138.5,11080.0,230.0,0.1,138.79999999999998,55.81998675598087,-0.0022382470887070127,145.67639032630495,127.69360967369505,136.72931072319005,85.0415512465374,6.726882681692429,12339100.0,2.407002188183816,0.006451612903225934,4.791226981262414,4.791226981262414,126.825,129.3,110.348,123.0,143.9,0,316.0,1.8264458570906303,40859.975081666285
2013-10-11,140.1,140.4,141.9,138.9,7250.0,230.0,0.1,140.0,55.38650107819689,0.10508833025838138,146.01479961082447,127.92520038917554,137.0503287495529,84.21052631578942,6.460676775857256,12331850.0,0.8639308855291494,-0.00213675213675224,4.611475214744652,4.611475214744652,129.425,129.3,110.98304,123.0,143.9,0,317.0,1.8276417794342767,41270.91260625441
2013-10-12,142.9,140.1,143.1,139.4,11020.0,230.0,0.1,141.13333333333333,58.61671611340475,0.33415724907238076,146.7039773387586,128.12602266124145,137.60744029721454,91.96675900277008,6.263485577581737,12342870.0,0.2807017543859689,0.019985724482512568,4.383124966817171,4.383124966817171,131.775,129.3,111.6053792,123.0,143.9,0,318.0,1.8288504108346721,41689.76170087455
2013-10-13,147.5,142.9,147.6,141.5,16170.000000000002,230.0,0.1,143.5,63.31594854755064,0.7416339206421787,148.19047168706462,128.0495283129354,138.54958884033695,99.73614775725595,6.251808036325898,12359040.0,2.5017373175816497,0.03219034289713085,4.238513922932812,4.238513922932812,134.75,129.3,112.865164032,123.0,143.9,0,319.0,1.8300819866448617,42119.73102774687
2013-10-14,151.4,147.5,153.7,146.0,29990.0,230.0,0.1,147.26666666666665,66.7620471709402,1.1932098164652123,150.427194779212,127.47280522078806,139.77343752220963,94.77272727272731,6.355250319445476,12389030.0,6.694855532064834,0.026440677966101722,4.197655428960024,4.197655428960024,137.79999999999998,131.7,114.94925419008,123.0,143.9,0,320.0,1.8313316056454223,42559.60238019362
2013-10-15,158.1,151.4,158.1,150.6,15730.0,230.0,0.1,152.33333333333334,71.68341825770237,1.8247237892096102,154.1269078587748,126.08309214122522,141.51882442485635,100.0,6.4370181537708,12404760.0,12.6870990734141,0.04425363276089822,4.071485233251613,4.071485233251613,140.25,133.9,118.0493138548736,123.0,143.9,0,321.0,1.832614048835882,43014.09484948385
2013-10-16,152.8,158.1,163.0,144.2,42780.0,230.0,0.1,154.1,63.654341228583526,1.765943576178583,155.8758466560942,125.90415334390576,142.59322209867955,76.22377622377626,7.3200882856443155,12361980.0,24.227642276422774,-0.033523086654016376,4.790633694793399,4.790633694793399,142.825,136.35,122.05438246938624,123.0,143.9,1,322.0,1.8338624905149254,43463.01526851238
2013-10-17,157.6,152.8,159.9,150.8,15880.0,230.0,0.1,156.16666666666666,67.23384222055067,1.918115158555631,158.44220493945872,125.20779506054132,144.02243904166247,84.3478260869565,7.4472248366697205,12377860.0,20.305343511450378,0.03141361256544495,4.725396469968097,4.725396469968097,142.875,136.35,126.96785657305989,123.0,143.9,0,323.0,1.8351330487776245,43923.53337664067
2013-10-18,168.3,157.6,168.3,156.5,25890.0,230.0,0.1,159.56666666666663,73.49931988003881,2.566682597762299,163.35281361708746,122.87718638291256,146.3345877043613,100.0,7.75813734833617,12403750.0,23.026315789473685,0.06789340101522856,4.6097072776804335,4.6097072776804335,146.2,139.0,131.2917137842927,123.0,143.9,0,324.0,1.8364555558957478,44405.29936863879
2013-10-19,183.1,168.3,195.8,167.1,55280.0,230.0,0.1,169.66666666666666,79.37423244803202,3.7481847991994677,171.79277498220932,118.35722501779067,149.83605554204118,79.41653160453806,9.253984680597872,12459030.0,33.94294074615948,0.08793820558526422,5.054060448169237,5.054060448169237,160.05,152.75,136.47287385449172,123.0,143.9,1,325.0,1.8378458228625556,44913.93808930469
2013-10-20,186.1,183.1,186.1,177.2,11420.0,230.0,0.1,179.16666666666666,80.32631440975094,4.44019258281585,179.36142592309767,115.2085740769024,153.28976453803728,84.01976935749586,9.228700060555168,12470450.0,35.05079825834541,0.016384489350081965,4.959000569884561,4.959000569884561,160.175,152.75,145.96521403777305,123.0,143.9,0,326.0,1.8392451799012794,45431.37499864314
2013-10-21,192.8,186.1,197.4,183.2,24100.0,230.0,0.1,187.33333333333334,82.2922359283107,5.015123815989611,187.40532770892887,112.41467229107113,157.05264410584323,92.55663430420714,9.583792913372658,12494550.0,41.97349042709867,0.03600214938205282,4.970846946770051,4.970846946770051,161.5,153.55,153.93877979172936,123.0,143.9,0,327.0,1.8406700039076787,45963.112158596574
2013-10-22,203.0,192.8,205.5,192.8,33870.0,230.0,0.1,193.96666666666667,84.78490769025886,5.69846623195375,195.87164439103844,111.94835560896155,161.42858276242958,96.41319942611192,9.80637913384604,12528420.0,48.717948717948715,0.05290456431535273,4.830728637362581,4.830728637362581,166.225,157.6,161.7617994292181,123.0,143.9,0,328.0,1.842134086081018,46514.0581954739
2013-10-23,228.0,203.0,228.0,200.7,39900.0,230.0,0.1,207.9333333333333,88.90670373929254,7.345450205680258,210.33113145937335,107.18886854062664,167.7687177374363,100.0,11.055923481428465,12568320.0,63.44086021505376,0.12315270935960587,4.849089246240554,4.849089246240554,177.475,168.85,170.50943954337447,123.0,228.0,1,329.0,1.843692631052428,47103.17729863088
2013-10-24,207.0,228.0,233.4,175.3,96750.0,230.0,0.1,212.66666666666666,71.40745412729439,6.5577341150950765,216.85271154862104,107.68728845137898,171.50503033387096,72.06349206349205,14.416214661326432,12471570.0,47.43589743589743,-0.09210526315789469,6.964354908853348,6.964354908853348,180.175,171.55,228.0,123.0,228.0,1,330.0,1.8451631763282959,47670.086375508654
2013-10-25,197.9,207.0,209.0,176.6,36750.0,230.0,0.1,210.96666666666667,65.40026625487195,5.02977236817409,220.6920122466657,109.96798775333426,174.0188369687404,62.234042553191486,15.700770756945973,12434820.0,41.25624553890079,-0.04396135265700485,7.93368911417179,7.93368911417179,181.82500000000002,171.55,228.0,123.0,228.0,0,331.0,1.8465902153397855,48229.00273388021
2013-10-26,188.6,197.9,198.4,187.0,12090.0,230.0,0.1,197.83333333333334,59.858131741456724,3.0937098630050244,222.6044900405582,113.1355099594418,175.4075191621937,51.251360174102274,15.393572845735546,12422730.0,31.980405878236517,-0.04699343102577069,8.16202165733592,8.16202165733592,183.25,171.55,233.4,188.6,228.0,0,332.0,1.8479711807273989,48778.59439472167
2013-10-27,206.9,188.6,207.8,188.9,13160.0,230.0,0.1,197.79999999999998,65.9692643516222,2.75766563530072,226.60002605345977,116.24997394654024,178.40680305150858,70.29147982062781,15.66546049961158,12435890.0,40.27118644067797,0.09703075291622487,7.5715130495947705,7.5715130495947705,185.9,171.55,232.238,188.6,228.0,0,333.0,1.8494264049885223,49360.47450299151
2013-10-28,206.9,206.9,209.8,200.4,11070.0,230.0,0.1,200.79999999999998,65.9692643516222,2.2679493344447277,229.739761610942,120.15023838905799,181.1204408561268,70.29147982062781,15.217927606782181,12446960.0,36.65785997357992,0.0,7.355209089793224,7.355209089793224,190.55,171.55,231.09924,188.6,228.0,0,334.0,1.8508766281955689,49947.58198727484
2013-10-29,216.0,206.9,216.5,204.2,10020.0,230.0,0.1,209.9333333333333,68.7159372614414,2.283157718417309,233.81340469120678,123.72659530879324,184.44230363173375,80.49327354260089,15.00950420629774,12456980.0,36.62239089184061,0.04398260028999523,6.948844539952657,6.948844539952657,192.65,171.55,229.9832552,188.6,228.0,0,335.0,1.8523585586781326,50553.09329932379
2013-10-30,208.0,216.0,216.5,204.0,13470.0,230.0,0.1,210.29999999999998,63.837875337873626,1.5175600346475946,235.633698451023,128.666301548977,186.68589376204483,69.24939467312348,14.8302539058479,12443510.0,36.12565445026177,-0.03703703703703709,7.129929762426876,7.129929762426876,194.05,171.55,228.889590096,188.6,228.0,0,336.0,1.8538032850148796,51152.50935484114
2013-10-31,211.2,208.0,215.0,205.4,5290.0,230.0,0.1,211.73333333333332,64.91089289078332,1.014001138485714,236.9406701917713,134.46932980822868,189.02057054661196,71.13133940182053,14.456664341144478,12448800.0,34.01015228426395,0.01538461538461533,6.845011525163105,6.845011525163105,194.05,171.55,227.81779829408,188.6,228.0,0,337.0,1.855256042182495,51762.0386833964
2013-11-01,213.4,211.2,214.9,209.7,5880.0,230.0,0.1,210.86666666666665,65.66519421208736,0.6349516897662966,237.83391342268604,140.62608657731394,191.34242097074417,69.83408748114631,13.79547403106273,12454680.0,26.797385620915026,0.01041666666666674,6.4646082619787855,6.4646082619787855,194.3,171.55,226.7674423281984,188.6,228.0,0,338.0,1.856712632819864,52380.314626682455
2013-11-02,211.7,213.4,214.9,211.0,4880.0,230.0,0.1,212.1,64.51116093329726,0.1034766767789499,237.97927535655305,146.90072464344695,193.2812380211495,62.65060240963852,13.088654457415391,12449800.0,15.619879847078098,-0.007966260543580184,6.182642634584503,6.182642634584503,190.525,171.55,225.73809348163442,188.6,228.0,0,339.0,1.8581574453261653,53001.607659644986
2013-11-03,224.0,211.7,226.9,212.1,12270.0,230.0,0.1,216.36666666666665,68.78559856288784,0.39753652065376954,239.46894468762986,152.67105531237013,196.20683440008767,83.82099827882959,13.239464853314292,12462070.0,20.365394948952183,0.058101086443079986,5.910475380943881,5.910475380943881,195.775,171.55,175.3,188.6,228.0,0,340.0,1.8596452477281737,53646.6886331317
2013-11-04,238.2,224.0,239.0,221.9,18060.0,238.2,0.1,224.63333333333333,72.85104485535325,1.3139580117247256,243.50254310342638,156.6474568965736,200.20618350484122,98.7441130298273,13.515217363791843,12480130.0,23.54771784232364,0.06339285714285703,5.673894779089775,5.673894779089775,201.35,174.35,176.33200000000002,188.6,228.0,0,341.0,1.8611801266738763,54317.825138745444
2013-11-05,251.3,238.2,258.9,229.0,45100.0,251.3,0.1,237.83333333333334,75.96152709594524,2.4992291909383226,248.20583293954596,161.79416706045404,205.07226126628493,90.90909090909095,14.685558980663853,12525230.0,23.79310344827587,0.05499580184718744,5.843835646901653,5.843835646901653,214.27499999999998,184.29999999999998,178.83872000000002,188.6,228.0,0,342.0,1.8627552059531276,55013.11803444613
2013-11-06,264.1,251.3,272.5,251.4,38820.0,264.1,0.1,251.19999999999996,78.54777582434755,3.766034724400093,255.0746536299439,165.57534637005608,210.69395066949588,91.35802469135805,15.150876196330719,12564050.0,15.833333333333343,0.05093513728611221,5.736795227690541,5.736795227690541,222.1,191.1,183.64239680000003,188.6,228.0,0,343.0,1.8643670854392274,55731.93826965507
2013-11-07,309.6,264.1,324.2,263.6,86130.0,309.6,0.1,275.0,84.80569924559855,7.09579042407087,275.87726015124963,158.9027398487504,220.11357441525817,90.10840108401086,18.397242182307092,12650180.0,49.56521739130436,0.17228322605073831,5.942261686791696,5.942261686791696,248.47500000000002,216.95,190.75100505600003,188.6,228.0,1,344.0,1.8661080853958982,56511.99546021895
2013-11-08,355.0,309.6,358.0,308.0,44630.0,355.0,0.1,309.56666666666666,88.431882502627,11.521457517909163,307.70039083918,144.26960916081998,232.95990066142406,98.24561403508773,20.654582026428013,12694810.0,79.38352703385547,0.14664082687338498,5.818192120120567,5.818192120120567,266.4,233.85,204.0959045504,188.6,228.0,0,345.0,1.86795907851299,57347.820813064565
2013-11-09,367.8,355.0,395.0,340.0,49910.0,367.8,0.1,344.1333333333334,89.21349010706659,14.295304287462265,335.32663269829055,134.8133673017095,245.80181488414559,86.80252304706454,23.10782616739744,12744720.0,95.01590668080595,0.0360563380281691,6.282715108047156,6.282715108047156,285.975,252.35,222.564396004352,188.6,228.0,0,346.0,1.8698340444890948,58206.017147986546
2013-11-10,336.3,367.8,372.5,290.0,74250.0,367.8,0.1,353.0333333333333,75.66459013793549,13.028708050370089,349.65832273046925,134.83167726953081,254.4206896570841,69.83556012332991,27.350124298297626,12670470.0,62.5422909618173,-0.08564437194127239,8.13265664534571,8.13265664534571,286.3,252.35,246.70538056374272,188.6,228.0,1,347.0,1.8716274565098092,59042.96593475404
2013-11-11,363.0,336.3,376.0,321.4,18000.0,367.8,0.1,355.7,78.62747473850843,12.98053045390541,368.1005976608661,132.389402339134,264.7615763564094,83.24607329842932,29.29654399127637,12688470.0,75.44707588206863,0.07939339875111506,8.07067327583371,8.07067327583371,288.225,252.35,267.46662728481874,188.6,228.0,0,348.0,1.873479495295482,59916.98845761239
2013-11-12,380.0,363.0,391.8,359.0,22030.0,380.0,0.1,359.76666666666665,80.27424161991375,13.049943012283627,387.94959599875756,127.74040400124247,275.7366643224657,92.14659685863874,29.546790849042342,12710500.0,75.92592592592592,0.04683195592286493,7.775471276063774,7.775471276063774,292.1,252.35,285.3212994649441,188.6,228.0,0,349.0,1.875364160102168,60818.14742720081
2013-11-13,434.9,380.0,445.0,372.2,36020.0,434.9,0.1,392.63333333333327,84.44302663996758,15.578366079440961,418.1039432502039,120.37605674979613,290.8950772441356,95.7846410684474,32.63630578839646,12746520.0,109.08653846153844,0.1444736842105263,7.5043241638069595,7.5043241638069595,321.525,277.35,300.67631753985194,188.6,434.9,0,350.0,1.877356405422629,61780.16066571029
2013-11-14,433.4,434.9,447.5,402.5,31410.0,434.9,0.1,416.09999999999997,83.92117035262288,15.880682692558814,442.1909693626811,119.8390306373189,304.46697464945606,94.07064760302775,33.519426803511,12715110.0,105.20833333333333,-0.0034490687514371343,7.7340624835050775,7.7340624835050775,330.42499999999995,278.6,323.76810673347563,188.6,434.9,0,351.0,1.8793394728075787,62753.42562743454
2013-11-15,433.9,433.4,457.9,413.0,28130.0,434.9,0.1,434.0666666666666,83.95676154977602,14.863311010166392,461.63269644410184,124.92730355589819,316.79392944474597,90.27946537059537,34.3323248889745,12743240.0,103.32708528584816,0.0011536686663591311,7.9124970935640695,7.9124970935640695,338.675,283.8,346.03984752145004,188.6,434.9,0,352.0,1.8813172647741045,63739.761142129755
2013-11-16,462.0,433.9,476.9,428.0,19140.0,462.0,0.1,443.09999999999997,85.85215530359615,14.79960760451371,484.6207135943407,127.44928640565931,330.6230790214368,94.37311178247735,35.3728731111906,12762380.0,118.23334907888523,0.06476146577552444,7.656466041383246,7.656466041383246,354.775,293.3,368.41187801716,188.6,434.9,0,353.0,1.883341518180816,64763.10293194638
2013-11-17,528.3,462.0,536.8,457.0,26720.0,528.3,0.1,474.7333333333333,89.11865069869623,17.741087895337202,519.0178586456453,125.19214135435473,349.4494524479666,97.30073039060018,38.54623931753412,12789100.0,135.84821428571428,0.14350649350649336,7.296278500385032,7.296278500385032,384.72499999999997,323.25,390.109502413728,188.6,434.9,0,354.0,1.8854719350445452,65852.66851997611
2013-11-18,785.4,528.3,787.9,522.0,72070.0,785.4,0.1,591.9,94.46014892192353,34.54793657806192,626.635333079564,74.51466692043596,390.96855221482696,99.55269278940777,54.785793651995974,12861170.0,229.72292191435773,0.4866553094832482,6.975527584924366,6.975527584924366,510.27500000000003,448.8,419.4476019309824,188.6,434.9,1,355.0,1.8879281400073866,67115.92414291883
2013-11-19,645.7,785.4,900.9,502.6,99100.0,785.4,0.1,653.1333333333333,73.3813807074726,33.762696033418194,668.5135789346243,76.40642106537564,415.22869009912915,60.708237105465756,79.3225226768534,12762070.0,156.9438917628333,-0.17787114845938368,12.284733262637973,12.284733262637973,574.95,505.3,457.0,188.6,434.9,1,356.0,1.8902129048786516,68320.30266994132
2013-11-20,638.0,645.7,650.0,453.3,91590.0,785.4,0.1,689.6999999999999,72.42209780197066,30.339217993542803,701.5782968306892,86.0217031693108,436.4450053277835,58.74784246037973,87.7066281999353,12670480.0,141.57516092389244,-0.01192504258943794,13.74712040751337,13.74712040751337,586.95,505.3,900.9,638.0,434.9,1,357.0,1.8924806603393993,69538.0574172832
2013-11-21,764.9,638.0,784.3,595.2,38730.0,785.4,0.1,682.8666666666667,77.61561499476159,33.9623165137468,757.1132425342693,85.63675746573074,467.72643339180416,77.73776395482076,94.94901189993992,12709210.0,147.06072351421187,0.1989028213166144,12.413258190605298,12.413258190605298,590.7249999999999,505.3,900.9,638.0,434.9,0,358.0,1.8948931757174687,70850.56599118446
2013-11-22,802.0,764.9,822.0,682.3,30150.0,802.0,0.1,734.9666666666667,78.86854475187303,36.003910695588246,810.63711062078,91.14288937921992,499.56201116401326,83.81077099361598,98.1455110499442,12739360.0,125.9154929577465,0.048503072297032324,12.237594894008005,12.237594894008005,601.175,505.3,891.948,638.0,434.9,0,359.0,1.8973379845456808,72204.6175508803
2013-11-23,832.5,802.0,890.0,799.5,21310.0,832.5,0.1,799.8000000000001,79.8662819246616,36.4439680798738,861.5053274677036,101.1246725322963,531.2703910531549,88.80340481257161,97.59940311780532,12760670.0,126.34584013050569,0.03802992518703241,11.723652026162803,11.723652026162803,604.7,510.5,453.3,638.0,434.9,0,360.0,1.8998065993211546,73597.2049084509
2013-11-24,795.0,832.5,855.0,745.2,25950.0,832.5,0.1,809.8333333333334,75.16701450846364,31.434480376418364,895.5525904427973,122.75740955720272,556.3874966671401,81.72562553925798,98.47087432367637,12734720.0,136.39607493309543,-0.04504504504504503,12.386273499833505,12.386273499833505,608.45,514.7,462.034,638.0,434.9,0,361.0,1.902229366492362,74992.40308373631
2013-11-25,830.0,795.0,850.0,759.0,26380.0,832.5,0.1,819.1666666666666,76.55365326942663,27.82706409786168,929.5547156513594,146.62528434864043,582.4458303178887,86.91640524081934,97.93724044341377,12761100.0,128.65013774104682,0.04402515723270439,11.799667523302864,11.799667523302864,615.125,517.5,470.59332,638.0,434.9,0,362.0,1.9046807527793326,76429.81123144043
2013-11-26,970.0,830.0,975.0,825.1,31610.0,970.0,0.1,865.0,81.09981710325609,31.92497694102829,986.3702553058035,160.3997446941965,619.3557512399946,99.17053749170537,101.64886612602709,12792710.0,155.26315789473685,0.16867469879518082,10.479264549074957,10.479264549074957,653.25,554.55,478.9814536,638.0,434.9,0,363.0,1.9072545790008275,77962.85426916993
2013-11-27,1079.9,970.0,1094.8,914.3,37860.0,1079.9,0.1,959.9666666666667,83.76157285295427,38.643946276821794,1061.364330064133,162.43566993586717,663.2171082647569,97.84775386393184,107.28108997416801,12830570.0,148.30995631179584,0.11329896907216508,9.934354104469675,9.934354104469675,713.4749999999999,614.9499999999999,498.82219545600003,638.0,434.9,0,364.0,1.9099100534068718,79573.0860859975
2013-11-28,1101.4,1079.9,1224.5,1032.1,37400.0,1101.4,0.1,1050.4333333333334,84.22949462771118,40.92396471682568,1130.0209800322787,168.41901996772128,704.948812239542,84.83056069008012,113.3610121188703,12867970.0,154.13013382556534,0.01990925085656081,10.292447078161459,10.292447078161459,778.5999999999999,680.05,534.58086372864,638.0,434.9,0,365.0,1.9125740719492228,81221.76091805748
2013-11-29,1206.9,1101.4,1241.9,1050.0,38710.0,1206.9,0.1,1129.4,86.31358972554776,45.569622164968564,1211.2621537540604,171.08784624593955,752.7536872643476,95.69971741000124,118.9709398246653,12906680.0,178.15164784512564,0.0957871799527874,9.857563992432288,9.857563992432288,825.2250000000001,688.85,589.7743946303488,638.0,434.9,0,366.0,1.9153062106537535,82945.04389263969
2013-11-30,1205.7,1206.9,1232.9,1150.2,15100.0,1206.9,0.1,1171.3333333333333,86.17409360967692,44.54127615730721,1273.8036277710853,195.4863722289149,795.8914313344097,95.40958660918083,116.38015840861779,12891580.0,160.974025974026,-0.000994282873477581,9.65249717248219,9.65249717248219,848.7750000000001,690.2,654.9869551673139,638.0,434.9,0,367.0,1.9180295021955893,84699.82585604764
2013-12-01,1004.4,1205.7,1216.8,840.3,79920.0,1206.9,0.1,1139.0,66.70004410863422,27.139049196193582,1289.6945761786492,243.73542382135076,815.7493902549421,69.8833375602333,134.96014709371653,12811660.0,90.11925042589439,-0.16695695446628522,13.43689238288695,13.43689238288695,870.1000000000001,690.4000000000001,713.6782596505825,638.0,434.9,0,368.0,1.9205933200423961,86393.89164609973
2013-12-02,1096.6,1004.4,1117.7,975.0,37050.0,1206.9,0.1,1102.2333333333333,70.0396710256008,19.054873309062884,1312.670088483207,292.41991151679315,842.497067373519,81.57494293685009,135.51299372987964,12848710.0,39.623121976063146,0.0917960971724412,12.357559158296521,12.357559158296521,873.1500000000001,690.6500000000001,766.5004336855243,638.0,434.9,0,369.0,1.9232223104664388,88162.98455820298
2013-12-03,1154.9,1096.6,1185.6,1064.9,19340.0,1206.9,0.1,1085.3,71.95495325765847,15.028008458833057,1341.3788153903333,335.7111846096669,872.2497276236601,88.96779102206442,134.45492274917393,12868050.0,78.86015177326932,0.053164326098851244,11.642126829091168,11.642126829091168,883.2,691.7,814.0403903169719,638.0,434.9,0,370.0,1.9258864343403326,89991.07776921333
2013-12-04,1237.6,1154.9,1239.7,1131.3,16300.0,1237.6,0.1,1163.0333333333333,74.4501049871487,15.278181598903387,1374.1285498590933,383.38145014090657,907.044991659502,99.33508582031851,132.59385683851866,12884350.0,93.98119122257052,0.07160793142263389,10.713789337307585,10.713789337307585,899.725,693.0500000000001,856.8263512852747,638.0,1237.6,0,371.0,1.9285999368628424,91889.65637599163
2013-12-05,1106.3,1237.6,1239.9,870.0,58440.0,1237.6,0.1,1166.2666666666667,64.62012790876605,4.504202678602155,1372.429222347757,452.32077765224284,926.0216591205018,75.76840600428876,149.54429563576736,12825910.0,44.63328539678389,-0.10609243697478987,13.517517457811387,13.517517457811387,903.525,693.0500000000001,1241.9,638.0,1237.6,0,372.0,1.9312127950488718,93761.36708638683
2013-12-06,845.0,1106.3,1118.9,800.1,53520.0,1237.6,0.1,1062.9666666666665,50.367448699692076,-20.921273686972768,1344.4697269308563,518.5802730691436,918.305310632835,20.09261123414535,161.63398880464112,12772390.0,5.361596009975062,-0.23619271445358403,19.128282698774097,19.128282698774097,901.325,693.0500000000001,1239.7,638.0,1237.6,0,373.0,1.9335954421974673,95514.77182825052
2013-12-07,697.0,845.0,896.0,576.0,97660.0,1237.6,0.1,882.7666666666668,44.394790074112976,-46.918954194667464,1325.6037029176016,554.316297082398,897.2286143820888,18.17089653101066,172.94584674716677,12674730.0,-16.276276276276278,-0.17514792899408282,24.81289049457199,24.81289049457199,854.7,696.35,1239.9,638.0,1237.6,1,374.0,1.9358120767593014,97186.24200448043
2013-12-08,804.0,697.0,829.0,653.0,31210.0,1237.6,0.1,782.0,49.094679712140874,-55.53199774102035,1325.1254377201556,556.6545622798444,888.3496987266518,34.23937528157381,173.16400055094056,12705940.0,1.1320754716981132,0.15351506456241037,21.537811013798578,21.537811013798578,857.5,699.2,1200.066,638.0,1237.6,0,375.0,1.9381397478087397,98965.43199540251
2013-12-09,919.0,804.0,980.0,787.7,27630.0,1237.6,0.1,806.6666666666666,53.63095186579492,-52.160067694949106,1314.4971479904784,594.6128520095215,891.2687750383992,51.5092356209641,174.5308576544448,12733570.0,10.72289156626506,0.14303482587064686,18.991388210494538,18.991388210494538,865.075,704.5,1162.62204,638.0,1237.6,0,376.0,1.9405705733099028,100851.52733239891
2013-12-10,1033.7,919.0,1067.7,912.0,22100.0,1237.6,0.1,918.9,57.68152261539646,-41.35321248750577,1304.8001906432899,643.87980935671,904.8336536061707,68.73404415077339,173.185796393413,12755670.0,6.567010309278356,0.12480957562568018,16.75397082261904,16.75397082261904,867.7,708.6,1127.4247176,638.0,1237.6,0,377.0,1.9430909856611196,102839.45855043967
2013-12-11,919.9,1033.7,1056.8,856.1,24360.0,1237.6,0.1,957.5333333333333,52.75733679635392,-40.940887280988704,1299.5540256785002,664.6259743214997,906.2685437389164,51.64439104970715,175.15109665102634,12731310.0,-14.816186683952226,-0.11008996807584415,19.040232269923507,19.040232269923507,871.45,708.6,1094.339234544,638.0,1237.6,0,378.0,1.9455080288367848,104789.65867920118
2013-12-12,900.0,919.9,941.0,839.5,9910.0,1237.6,0.1,951.1999999999999,51.92259983330177,-40.97947567612093,1296.0994298141022,677.8805701858977,905.6715395733053,48.655954347499616,169.89030403309587,12721400.0,-18.285818049754866,-0.021632786172410046,18.876700448121763,18.876700448121763,877.7750000000001,708.6,1067.7,638.0,1237.6,0,379.0,1.9478999166651716,106757.98324744728
2013-12-13,936.8,900.0,989.9,882.1,17370.0,1237.6,0.1,918.9,53.39123460241843,-37.586803060858514,1294.1490840619326,690.2609159380673,908.6361548520381,54.34553396595871,165.45528231644616,12738770.0,-22.37965034385617,0.04088888888888875,17.661750887750443,17.661750887750443,877.7750000000001,708.6,1056.8,638.0,1237.6,0,380.0,1.9503175955856162,108783.55503654377
2013-12-14,908.9,936.8,947.9,875.1,11590.0,1237.6,0.1,915.2333333333332,52.0920077282988,-36.264666945269624,1288.847555411623,706.952444588377,908.6612829613678,50.14309383943364,158.83704786527142,12727180.0,-24.616405407647015,-0.02978223740392827,17.475745171665906,17.475745171665906,847.5250000000001,708.6,1027.952,638.0,1237.6,0,381.0,1.9527032946856024,110822.58599382579
2013-12-15,919.9,908.9,927.9,838.0,15170.0,1237.6,0.1,921.8666666666667,52.58193545738617,-33.744449920560186,1285.4998885130726,719.290111486927,909.7316369650471,51.799969874981166,153.91297301775202,12742350.0,-8.412982875348467,0.012102541533722144,16.731489620366567,16.731489620366567,834.725,709.25,1000.83488,638.0,1237.6,0,382.0,1.9550917655108273,112902.35746067333
2013-12-16,759.9,919.9,924.9,714.0,41330.0,1237.6,0.1,862.9,45.32182223588792,-41.441323019246084,1293.9791186388536,689.8008813611464,895.4619572540903,27.69995481247175,157.98347494505543,12701020.0,-30.703994163778948,-0.17393194912490484,20.79003486577911,20.79003486577911,884.6500000000001,714.45,975.3447872,638.0,1237.6,0,383.0,1.957316627596637,114887.37074508668
2013-12-17,715.0,759.9,780.0,678.9,31710.0,1237.6,0.1,798.2666666666668,43.50642662232652,-47.69872119974309,1295.68657790571,651.6034220942902,878.2751041822721,20.93688808555505,153.9203695918372,12669310.0,-38.0898779115075,-0.059086721937096964,21.527324418438766,21.527324418438766,891.125,715.4000000000001,951.384099968,638.0,1237.6,0,384.0,1.9594849530180558,116860.43647584305
2013-12-18,541.0,715.0,717.0,454.9,110500.0,1237.6,0.1,671.9666666666666,37.275225257310844,-60.856006601087756,1312.6977005648873,578.5522994351126,846.1536656887224,10.96815286624204,161.64748604956313,12558810.0,-56.28636069812541,-0.2433566433566433,29.879387439845313,29.879387439845313,804.85,721.1500000000001,928.86105396992,541.0,1237.6,1,385.0,1.961418679175129,118668.96299464379
2013-12-19,732.0,541.0,746.0,522.4,45760.0,1237.6,0.1,662.6666666666666,46.357527696482535,-54.21613055491362,1279.5967460435693,564.1632539564305,835.2818880040821,41.73192771084337,166.0726656174515,12604570.0,-33.83349905089035,0.35304990757855825,22.687522625334903,22.687522625334903,802.125,722.95,890.9441696523264,541.0,1237.6,0,386.0,1.9635935008997523,120713.07800422539
2013-12-20,650.0,732.0,774.4,621.3,34770.0,1237.6,0.1,641.0,43.448820476869415,-52.8145032162936,1245.5864421433325,542.6035578566676,817.6359939084552,31.837467362924283,165.14604664477636,12569800.0,-23.076923076923077,-0.11202185792349728,25.407084099196364,25.407084099196364,785.4000000000001,722.95,856.0606360801403,541.0,1237.6,0,387.0,1.965664767266738,122702.01428689556
2013-12-21,640.5,650.0,690.0,610.0,14730.0,1237.6,0.1,674.1666666666666,43.11132685616429,-50.022428744110954,1240.112366621453,511.68763337854705,800.7658992505071,30.28720626631854,159.06418617014947,12555070.0,-8.106169296987087,-0.014615384615384586,24.834377231873454,24.834377231873454,785.4000000000001,723.6500000000001,823.967785193729,541.0,1237.6,0,388.0,1.9677177255582647,124707.69016686821
2013-12-22,639.5,640.5,699.9,615.0,11630.0,1237.6,0.1,643.3333333333334,43.0733990432703,-45.84875272750972,1216.3582779021428,489.73172209785724,785.4072421790303,30.124020887728463,153.7667443008531,12543440.0,-20.460199004975124,-0.0015612802498048417,24.044838827342158,24.044838827342158,774.9000000000001,725.8000000000001,794.4423623782307,541.0,1237.6,0,389.0,1.969763162449965,126739.60629544339
2013-12-23,713.2,639.5,724.9,631.0,15070.0,1237.6,0.1,664.4,46.78892751728344,-36.15622855350486,1171.156392691045,490.76360730895505,778.5303619715036,42.15078328981724,149.4905482793636,12558510.0,-22.393906420021757,0.11524628616106347,20.960536775008915,20.960536775008915,769.9000000000001,726.45,767.2789733879722,541.0,1237.6,0,390.0,1.9718912144181573,128880.8345252342
2013-12-24,702.8,713.2,729.9,666.0,10950.0,1237.6,0.1,685.1666666666666,46.329398922422264,-28.797353574172735,1092.4685982619858,515.9714017380142,771.317946545646,41.18624356205349,143.37693768798047,12547560.0,-32.01122182451389,-0.014582164890633909,20.400816404095117,20.400816404095117,769.1500000000001,727.0,742.2886555169345,541.0,1237.6,0,391.0,1.974000891899971,131041.33599524712
2013-12-25,707.3,702.8,710.0,673.9,5340.0,1237.6,0.1,707.7666666666668,46.5739033646164,-22.270410901360208,1039.463017929566,529.076982070434,765.2209992555845,47.17757009345794,135.71429928169616,12552900.0,-23.11120773997174,0.006402959590210644,19.18765718672362,19.18765718672362,732.4250000000001,731.9000000000001,724.9,541.0,1237.6,0,392.0,1.97610938881951,133237.21349392034
2013-12-26,802.0,707.3,829.6,707.2,23530.0,1237.6,0.1,737.3666666666667,51.57371452055431,-10.799948353598893,1035.9511060528237,528.2888939471765,768.7237612312432,64.8785046728972,134.76327790443216,12576430.0,-10.888888888888888,0.13388943871058956,16.803401234966604,16.803401234966604,744.825,735.45,454.9,541.0,1237.6,0,393.0,1.9783136174883686,135562.7662009601
2013-12-27,803.0,802.0,836.8,767.9,13890.0,1237.6,0.1,770.7666666666668,51.62519636231869,-2.7873837537213113,1038.330307480581,536.5096925194189,771.9881649235058,70.60851926977688,130.05875805411557,12590320.0,-14.282664389410757,0.0012468827930174342,16.19660747871925,16.19660747871925,763.5,746.6500000000001,462.394,541.0,1237.6,0,394.0,1.9805122687457704,137923.7294398555
2013-12-28,762.0,803.0,806.0,715.6,13340.0,1237.6,0.1,789.0,49.31056702132954,-0.036183342359887405,1036.343103319196,534.2968966808039,771.0369111212672,64.92600422832982,127.22598962167874,12576980.0,-16.162394102761578,-0.05105853051058529,16.696324097333168,16.696324097333168,785.4000000000001,752.75,477.37024,541.0,1237.6,0,395.0,1.9826618358223083,140276.9636098554
2013-12-29,785.0,762.0,804.0,735.0,7040.0,1237.6,0.1,783.3333333333334,50.64734391731334,3.3574864069823036,1022.0516955533928,535.1883044466072,772.3667291097179,70.23404255319149,123.0669903629874,12584020.0,-14.664637460593541,0.030183727034120755,15.677323613119414,15.677323613119414,785.4000000000001,765.95,491.74743040000004,541.0,1237.6,0,396.0,1.9848290584542205,142688.64236783228
2013-12-30,804.8,785.0,818.8,781.0,10480.0,1237.6,0.1,783.9333333333334,51.82517677367386,6.764072799749854,981.3220417727028,553.0279582272971,775.4556120516495,91.62084315265777,116.97649105134543,12594500.0,5.9086721937096955,0.025222929936305594,14.534852267811313,14.534852267811313,786.6500000000001,765.95,505.54953318400004,541.0,1237.6,0,397.0,1.987009970143007,145156.28883737017
2013-12-31,805.9,804.8,813.9,777.0,9170.0,1237.6,0.1,798.5666666666666,51.89386554901885,8.791369203021407,964.8562565110162,558.0937434889838,778.35507757054,91.90887666928516,111.25674169053504,12603670.0,12.71328671328671,0.0013667992047714517,13.805278780312078,13.805278780312078,760.4000000000001,765.95,518.79955185664,541.0,1237.6,0,398.0,1.9891854736248868,147661.23375864158
2014-01-01,815.9,805.9,829.9,771.0,10760.0,1237.6,0.1,808.8666666666667,52.556139483072805,10.395819034008666,952.3284230429431,562.2115769570569,781.9307844685837,93.35241730279898,107.51697442692537,12614430.0,50.813308687615525,0.01240848740538536,13.177714723241252,13.177714723241252,756.3499999999999,781.6500000000001,531.5195697823744,541.0,1237.6,0,399.0,1.9913644530289076,150213.4654022961
2014-01-02,856.9,815.9,886.2,810.5,12810.0,1237.6,0.1,826.2333333333332,55.27481801630979,13.605782317930585,936.3677947790403,570.1822052209596,789.07070975729,89.39174511223749,105.24433339643072,12627240.0,17.062841530054644,0.05025125628140703,12.28198545879691,12.28198545879691,770.675,800.45,543.7307869910794,541.0,1237.6,0,400.0,1.993576546046198,152846.29482317535
2014-01-03,884.3,856.9,888.2,839.4,9710.0,1237.6,0.1,852.3666666666667,57.04627283992514,16.75484819264222,931.2281518307449,572.861848169255,798.1401659708815,98.59813084112146,101.21259529668568,12636950.0,36.04615384615384,0.031975726455829134,11.445504387276454,11.445504387276454,779.5,807.0500000000001,564.2789397716147,541.0,1237.6,0,401.0,1.9958074748548544,155546.54895337182
2014-01-04,924.7,884.3,932.2,848.3,14240.0,1237.6,0.1,888.6333333333333,59.58786160555815,20.492107455743785,932.3773682447421,572.192631755258,810.1934834974643,97.63556116015133,99.97598134692241,12651190.0,44.37158469945356,0.045685853217234174,10.81172070367929,10.81172070367929,792.6,822.2,590.1926245898854,541.0,1237.6,0,402.0,1.9980678247614152,158328.14430483332
2014-01-05,1014.7,924.7,1029.9,911.4,21370.0,1237.6,0.1,941.2333333333332,64.61143962300403,27.52077210072616,978.4371821733703,551.6128178266297,829.670294592944,96.18952118325394,101.29912553642797,12672560.0,58.6708365910868,0.09732886341516167,9.983160100170291,9.983160100170291,814.3,827.45,624.3933621308969,541.0,1014.7,0,403.0,2.0003963552297446,161238.38690262
2014-01-06,1012.7,1014.7,1093.4,964.7,23080.0,1237.6,0.1,984.0333333333334,64.41979667667306,30.310021181222595,1017.4528121413059,542.367187858694,847.1016951079016,81.11839026672907,103.25633085525455,12649480.0,41.99383062254627,-0.0019710259189907875,10.196142081095541,10.196142081095541,844.1750000000001,834.95,673.0541586751892,541.0,1014.7,0,404.0,2.0027164588452684,164192.63401361057
2014-01-07,879.9,1012.7,1044.0,879.8,22670.0,1237.6,0.1,969.1,53.147358364960404,21.879436574502662,1011.0092852711562,582.7007147288436,850.2253431928633,49.10607866507746,107.60945007987922,12626810.0,25.199203187251,-0.1311345906981337,12.229736342752497,12.229736342752497,853.1750000000001,847.6,731.9025764606628,879.9,1014.7,0,405.0,2.004916634077357,167058.16589874588
2014-01-08,938.8,879.9,966.9,858.9,14100.0,1237.6,0.1,943.8000000000001,56.76123790649746,19.042401245037524,1027.7008681758825,586.6891318241173,858.661024793543,59.968928016571695,107.63734650274499,12640910.0,32.73010038173336,0.06693942493465155,11.465418246990307,11.465418246990307,853.1750000000001,847.6,782.51221575617,879.9,1014.7,0,406.0,2.0071623866193398,170029.4663137743
2014-01-09,937.0,938.8,964.6,866.5,14420.0,1237.6,0.1,918.5666666666666,56.61751292154553,15.942882639396387,1036.5495625097283,606.5404374902714,866.1218795751103,58.60243515087346,106.95610746683464,12626490.0,16.83291770573566,-0.0019173412867490303,11.414739324101882,11.414739324101882,853.1750000000001,847.6,826.0365055503062,879.9,1014.7,0,407.0,2.00939997178997,173043.90772282353
2014-01-10,957.8,937.0,964.8,905.9,6350.0,1237.6,0.1,944.5333333333333,57.94275952651913,14.247268636243788,1043.268678709448,631.5513212905521,874.8531291393855,64.10799364743248,103.52352836206072,12632840.0,19.277708592777078,0.022198505869797103,10.808470282111163,10.808470282111163,863.0500000000001,847.6,858.9,879.9,1014.7,0,408.0,2.011648581462506,176126.07379015413
2014-01-11,1005.3,957.8,1010.8,935.0,11180.0,1237.6,0.1,966.6999999999999,60.8816143704759,15.19194094447738,1052.7873816356584,658.6126183643415,887.2766406499202,75.41852678571426,101.54327633619924,12644020.0,31.92913385826771,0.049592816871998346,10.100793428449144,10.100793428449144,870.2750000000001,848.4000000000001,866.5,879.9,1014.7,0,409.0,2.013929394055747,179304.8283904687
2014-01-12,939.8,1005.3,1022.7,922.1,9930.0,1237.6,0.1,967.6333333333332,55.1579058983522,10.4959507606251,1055.930165166682,678.1298348333181,892.2788653499279,52.35732009925556,101.47589945504215,12634090.0,19.71974522292993,-0.06515468019496673,10.797605815603548,10.797605815603548,872.5,848.4000000000001,898.266,879.9,1014.7,0,410.0,2.0161495116016734,182462.1728270889
2014-01-13,922.9,939.8,949.2,879.9,10130.0,1237.6,0.1,956.0,53.75370313878081,5.588290236361097,1052.47359979947,703.5964002005301,895.19516388803,47.1153846153846,99.17762092253916,12623960.0,14.674453280318096,-0.017982549478612442,10.746301974486853,10.746301974486853,892.0250000000001,848.4000000000001,1093.4,879.9,1014.7,0,411.0,2.0183485512863473,185647.54442707283
2014-01-14,919.3,922.9,942.5,904.2,4310.0,1237.6,0.1,927.3333333333334,53.44159725077021,1.6412646026007636,1045.1273547653354,732.1426452346644,897.4908625653605,45.998759305210896,94.82921942807208,12619650.0,14.07122471770691,-0.0039007476432982857,10.315372503869474,10.315372503869474,913.9250000000001,848.4000000000001,1089.13,879.9,1014.7,0,412.0,2.020537973040931,188875.94899399515
2014-01-15,941.2,919.3,973.1,915.1,6830.0,1237.6,0.1,927.8000000000001,55.147697753230666,0.12686556681751426,1048.3941554296018,742.7958445703981,901.6536375591357,46.200070696359134,92.19856089749551,12626480.0,15.35727417575684,0.023822473621233575,9.795852199053922,9.795852199053922,901.575,848.4000000000001,1084.9454,879.9,1014.7,0,413.0,2.0227397569346257,192177.9092023163
2014-01-16,913.5,941.2,955.5,910.5,5100.0,1237.6,0.1,924.6666666666666,52.5258931506269,-2.949068222926144,1048.0037308894339,754.2362691105662,902.7818625535037,29.173228346456686,88.82723511910298,12621380.0,6.605204808028945,-0.029430514237144156,9.723835262080238,9.723835262080238,897.5,848.4000000000001,1080.8444920000002,879.9,1014.7,0,414.0,2.024911186807478,195495.5704066598
2014-01-17,894.2,913.5,929.8,867.2,10310.0,1237.6,0.1,916.3000000000001,50.716695130255346,-6.299706313415392,1040.164000166119,775.2959998338808,901.9645423103129,18.727050183598557,86.95386118202418,12611070.0,1.119529571412427,-0.021127531472359018,9.724207244690692,9.724207244690692,903.4000000000001,848.4000000000001,1076.8256021600002,879.9,1014.7,0,415.0,2.0270591587067224,198837.56085520925
2014-01-18,905.7,894.2,924.7,884.7,6040.0,1237.6,0.1,904.4666666666667,51.78241563482438,-7.666935401762821,1033.6873628019378,793.8426371980622,902.3203001855212,19.957356076759083,83.60001395473674,12617110.0,-2.054720449875635,0.01286065757101329,9.230431042810725,9.230431042810725,912.325,848.4000000000001,1068.4405780736001,879.9,1014.7,0,416.0,2.0292109735952657,202242.67227487266
2014-01-19,954.8,905.7,958.1,901.9,7570.0,1237.6,0.1,918.2333333333332,56.14305535362096,-5.302311088349278,1031.3489366120216,811.1810633879785,907.3183668345191,40.895522388059675,81.64287010082697,12624680.0,-5.903222627377558,0.05421221154907796,8.550782373358501,8.550782373358501,914.3000000000001,848.4000000000001,1060.3909549506561,879.9,1014.7,0,417.0,2.0313985132670345,205759.1294372429
2014-01-20,956.0,954.8,980.5,926.0,10410.0,1237.6,0.1,938.8333333333334,56.247199544535604,-3.767371931940417,1026.0975932097344,831.4424067902654,911.9547128502792,52.45813074014047,79.70409366505362,12635090.0,-5.598894045620622,0.0012568077084207374,8.3372482913236,8.3372482913236,922.625,847.4000000000001,1052.66331675263,879.9,1014.7,0,418.0,2.033580618547452,209329.04227339342
2014-01-21,962.2,956.0,974.3,943.2,6590.0,1237.6,0.1,957.6666666666666,56.81775390989994,-2.5052524834330505,1019.3568986213209,852.8131013786792,916.7399782931097,63.06471306471308,76.23237268897836,12641680.0,9.353335606318907,0.0064853556485355845,7.9227159310931565,7.9227159310931565,914.175,847.4000000000001,1045.2447840825248,879.9,1014.7,0,419.0,2.0357614509951683,212959.4140697342
2014-01-22,951.0,962.2,973.9,935.0,4780.0,1237.6,0.1,956.4000000000001,55.41201035834539,-2.5850109027436474,1015.8639608652661,865.7160391347338,920.0028375032898,54.097311139564646,73.56577463976562,12636900.0,1.2995313165743552,-0.011639991685720275,7.735622990511633,7.735622990511633,914.175,847.4000000000001,1038.1229927192237,879.9,1014.7,0,420.0,2.0379265639104975,216628.8371712259
2014-01-23,944.2,951.0,958.1,936.3,1970.0,1237.6,0.1,952.4666666666667,54.529881228404115,-3.214961821434553,1014.2429385165328,873.3270614834673,922.3073291696431,49.51768488745981,69.8682193083538,12634930.0,0.7684098185699089,-0.0071503680336487685,7.399726679554522,7.399726679554522,919.0250000000001,847.4000000000001,1031.2860730104549,879.9,1014.7,0,421.0,2.0400796074245386,220342.91703204133
2014-01-24,916.5,944.2,949.5,902.9,6200.0,1237.6,0.1,937.2333333333332,50.97028407506098,-5.483201297112792,1014.3658127858776,872.3841872141224,921.7542502011056,31.70418006430865,68.2062036434714,12628730.0,-4.311964919607429,-0.029337004871849204,7.442029857443688,7.442029857443688,928.0250000000001,847.4000000000001,1024.7226300900368,879.9,1014.7,0,422.0,2.042202676830249,224073.053429278
2014-01-25,961.0,916.5,978.4,915.9,8180.0,1237.6,0.1,940.5666666666666,55.94559847724617,-4.0392507874549395,1004.3730872367186,877.0069127632813,925.4919406581432,60.32154340836011,67.79861766893772,12636910.0,-4.406644782651941,0.048554282596835696,7.05500704151277,7.05500704151277,928.0250000000001,847.4000000000001,1018.4217248864353,879.9,1014.7,0,423.0,2.0443570983294728,227917.9708753065
2014-01-26,1007.0,961.0,1038.1,950.7,13070.0,1237.6,0.1,961.5,60.41708041894583,-0.23933301846341948,1002.8351681881405,877.9748318118594,933.2546129764153,81.80222352252784,69.19871640687073,12649980.0,7.1504575441583365,0.04786680541103028,6.871769255895803,6.871769255895803,946.8,786.9000000000001,867.2,879.9,1007.0,0,424.0,2.046542253165681,231880.38533116912
2014-01-27,943.5,1007.0,1021.5,937.2,8330.0,1237.6,0.1,970.5,52.49592800429927,-2.149427282181847,999.5029854787305,887.6670145212696,934.2303641215186,44.6459918080749,70.27737952066568,12641650.0,2.232094484776251,-0.06305858987090363,7.448582885073203,7.448582885073203,960.975,774.1500000000001,870.618,879.9,1007.0,0,425.0,2.0486694227751614,235814.23957006482
2014-01-28,932.7,943.5,972.6,911.7,10410.0,1237.6,0.1,961.0666666666667,51.26485700944551,-4.170226306350493,999.3653492455874,887.1946507544128,934.0846151575645,38.326506729081366,69.60756669776099,12631240.0,1.45763080604809,-0.0114467408585055,7.463017765386618,7.463017765386618,968.45,774.1500000000001,873.9676400000001,879.9,1007.0,0,426.0,2.0507812256312166,239788.93121661653
2014-01-29,925.7,932.7,950.6,918.9,5680.0,1237.6,0.1,933.9666666666667,50.43922811901854,-5.902467393793437,999.2677461755795,886.1622538244208,933.2860803806536,34.23054417788183,66.89988336220664,12625560.0,-1.646833829154271,-0.007505092741503128,7.226950779108419,7.226950779108419,970.675,774.1500000000001,877.2502872000001,925.7,1007.0,0,427.0,2.052880856389543,243809.853487971
2014-01-30,941.4,925.7,953.2,909.5,5430.0,1237.6,0.1,933.2666666666668,52.294961901281695,-5.9009251307986865,998.0230491376593,885.7669508623404,934.0588346301151,43.41720304271503,65.24274883633474,12630990.0,3.054187192118224,0.016960138273738767,6.930396094788054,6.930396094788054,973.325,774.1500000000001,880.4672814560001,925.7,1007.0,0,428.0,2.0549875944880465,247911.32565313813
2014-01-31,938.8,941.4,954.7,924.6,4310.0,1237.6,0.1,935.2999999999998,51.94806107556668,-5.967175746545141,986.5701291664878,890.569870833512,934.5103741891518,35.267275097783546,62.73255249088226,12626680.0,4.987698501453803,-0.002761844062035279,6.682206272995554,6.682206272995554,973.325,774.1500000000001,883.6199358268801,925.7,1007.0,0,429.0,2.0570859551415945,252067.17444073167
2014-02-01,940.4,938.8,969.2,927.8,4370.0,1237.6,0.1,940.1999999999999,52.15838208570856,-5.790810069972807,986.6039165068802,890.5960834931199,935.0712909330421,28.267254038179164,61.208798741533535,12631050.0,3.831290714364572,0.001704303365999138,6.508804630107777,6.508804630107777,960.975,774.1500000000001,886.7095371103425,925.7,1007.0,0,430.0,2.059179489552102,256284.34189771092
2014-02-02,953.3,940.4,959.4,934.4,1580.0,1237.6,0.1,944.1666666666666,53.909974679798594,-4.737284553180565,987.9640633725805,892.2759366274192,936.8073584632285,37.278106508875744,58.62245597428114,12632630.0,-0.15710096355257647,0.013717566992768937,6.149423683444995,6.149423683444995,961.15,774.1500000000001,889.7373463681356,925.7,1007.0,0,431.0,2.0612776102979073,260581.1517883572
2014-02-03,931.7,953.3,959.6,931.7,2790.0,1237.6,0.1,941.8000000000001,50.57125687054925,-5.380111962365692,987.8038035011995,893.6761964988006,936.3209433714925,21.301775147929057,56.42799483326105,12629840.0,-2.5418410041840955,-0.022658134899821603,6.056455386203826,6.056455386203826,963.05,774.1500000000001,892.7045994407729,925.7,1007.0,0,432.0,2.0633515179455704,264904.5543454675
2014-02-04,926.6,931.7,949.1,900.8,4610.0,1237.6,0.1,937.1999999999999,49.78723229072063,-5.987228630286214,987.4738346533389,892.5461653466608,935.3951392408742,18.79096868171892,55.84742377374241,12625230.0,-3.699854500103931,-0.005473864977997178,6.027134014001987,6.027134014001987,956.9,774.1500000000001,895.6125074519574,925.7,1007.0,0,433.0,2.06541500637048,269280.10549213365
2014-02-05,904.5,926.6,939.8,890.0,7560.0,1237.6,0.1,920.9333333333334,46.42819726148525,-7.611390618228919,988.1772973333514,890.9427026666483,932.4527450274576,9.790681971640788,55.41546493276081,12617670.0,-4.889589905362776,-0.023850636736455932,6.12664067802773,6.12664067802773,941.9749999999999,774.1500000000001,1038.1,925.7,1007.0,0,434.0,2.0674534396229154,273679.2991558727
2014-02-06,828.9,904.5,908.8,800.9,18600.0,1237.6,0.1,886.6666666666666,37.185744580901265,-13.18477276951124,1002.31485989079,870.2751401092102,922.5905788343664,11.804384485666107,59.16436029470647,12599070.0,-12.21139589070113,-0.08358208955223878,7.137695776897873,7.137695776897873,902.275,774.1500000000001,1035.138,925.7,1007.0,1,435.0,2.069417274604841,278002.1568796008
2014-02-07,695.7,828.9,833.1,651.7,49910.0,1237.6,0.1,809.6999999999999,26.990741807577535,-24.58713037986898,1049.518893811986,802.0711061880143,900.9819522787125,11.387163561076608,67.89547741651315,12549160.0,-24.091653027823234,-0.1606948968512486,9.759303926478818,9.759303926478818,827.675,774.1500000000001,1025.76848,925.7,1007.0,1,436.0,2.0712377226245757,282103.59156347375
2014-02-08,648.8,695.7,719.3,632.1,22880.0,1237.6,0.1,724.4666666666667,24.44903267944865,-33.481743023452225,1082.3909857006545,738.5990142993458,876.9646234902636,4.113300492610822,69.27437188676221,12526280.0,-32.48699271592092,-0.06741411527957464,10.67730762742944,10.67730762742944,817.875,807.9000000000001,1003.3243712,925.7,1007.0,1,437.0,2.072997918316092,286142.3151572778
2014-02-09,659.6,648.8,694.1,622.5,19890.0,1237.6,0.1,668.0333333333333,26.173127297452922,-36.579688545237374,1097.7770027115012,693.5729972884988,856.2632307769052,9.298245614035093,69.44048818056491,12546170.0,-34.49851042701092,0.016646115906288728,10.527666491898865,10.527666491898865,813.075,851.7,973.626421504,925.7,1007.0,0,438.0,2.074765711269955,290255.10459453275
2014-02-10,582.6,659.6,700.0,500.0,40130.0,1237.6,0.1,630.3333333333334,22.270915862909703,-41.40181436550514,1117.7807397275908,635.6092602724093,830.2000659410095,17.477782479898437,78.76616759623884,12506040.0,-38.251192368839426,-0.11673741661613102,13.519767867531554,13.519767867531554,749.425,796.7,938.5137793536,925.7,1007.0,1,439.0,2.0764308991160334,294210.82653550355
2014-02-11,579.0,582.6,609.7,550.2,16730.0,1237.6,0.1,607.0666666666666,22.104979428530527,-42.273259556373674,1128.943130693198,587.246869306802,806.2762501371038,16.83716965046888,77.39001276793608,12489310.0,-37.92216146670956,-0.006179196704428458,13.366150737121949,13.366150737121949,749.425,796.7,885.892125831168,925.7,1007.0,0,440.0,2.0780861179141996,298199.52898597234
2014-02-12,531.1,579.0,585.1,511.9,21300.0,1237.6,0.1,564.2333333333333,19.972637740785927,-43.35358526682931,1140.0197838587364,534.8602161412634,780.0689882192844,6.628303495311172,77.09072614165494,12468010.0,-42.62720103705304,-0.08272884283246973,14.515293944954799,14.515293944954799,746.8,796.7,839.5850707314278,925.7,1007.0,0,441.0,2.0796687038038653,302085.241331085
2014-02-13,451.4,531.1,549.2,451.3,28940.0,1237.6,0.1,520.5,17.029121606495252,-46.43879090042827,1157.6185817883857,470.7514182116145,748.7671798174479,0.019308746862322045,78.57710284582244,12439070.0,-52.0501380922031,-0.15006590096027117,17.407421986225618,17.407421986225618,720.125,772.35,798.8348622436564,925.7,1007.0,0,442.0,2.0811192913461802,305732.24296413397
2014-02-14,427.7,451.4,500.0,302.2,65820.0,1237.6,0.1,470.06666666666666,16.26163650647534,-46.93925227964833,1162.5743139333285,412.4656860666715,718.1893531681671,18.81559220389805,87.09302407112084,12373250.0,-54.441840647635274,-0.05250332299512628,20.363110608164796,20.363110608164796,637.825,697.8000000000001,750.1799815295445,925.7,1007.0,1,443.0,2.0825231525660763,309319.845314031
2014-02-15,371.1,427.7,447.9,310.1,50620.0,1237.6,0.1,416.73333333333335,14.572500730820735,-47.78602811139049,1157.8056877978595,353.64431220214055,685.1332242950084,10.4806814724673,90.71495092318364,12322630.0,-60.53806890684814,-0.13233574935702586,24.44488033499963,24.44488033499963,618.9,697.8000000000001,678.5031844848174,925.7,1007.0,1,444.0,2.0838117459454653,312691.0471625888
2014-02-16,299.8,371.1,540.0,220.4,86180.0,1237.6,0.1,366.2,12.772640496915088,-49.63468337835113,1161.771689406414,285.3083105935859,648.4348219811981,10.741341991341992,107.0638830000991,12236450.0,-68.551347949229,-0.19213150094314202,35.71176884593032,35.71176884593032,549.55,656.9000000000001,618.2946749672467,925.7,1007.0,1,445.0,2.084929749155104,315712.41513008036
2014-02-17,272.3,299.8,411.2,263.4,51440.0,1237.6,0.1,314.40000000000003,12.149356714580449,-49.106046543127434,1159.1986301934405,221.84136980655944,612.6124579829886,7.122272540139976,109.97360564294915,12185010.0,-70.77385424492863,-0.09172781854569712,40.38692825668349,40.38692825668349,544.725,656.9000000000001,546.6736334731423,925.7,1007.0,1,446.0,2.0859689627778697,318582.8940504614
2014-02-18,294.0,272.3,370.1,248.3,48880.0,1237.6,0.1,288.70000000000005,15.64732386776079,-43.863329417456626,1144.7877607207763,173.08223927922387,582.2684143655612,10.230747845426743,110.81834809702421,12233890.0,-68.27109864018995,0.07969151670951158,37.69331567925994,37.69331567925994,544.725,656.9000000000001,540.0,925.7,1007.0,0,447.0,2.087064230651525,321608.99035792204
2014-02-19,261.5,294.0,308.6,257.2,31500.0,1237.6,0.1,275.93333333333334,14.703073383188467,-39.29969396608777,1121.995213834439,127.88478616556108,551.7190415688411,5.970366066240556,106.5741803758082,12202390.0,-71.0889994472084,-0.11054421768707479,40.75494469438172,40.75494469438172,522.15,656.9000000000001,482.472,925.7,1007.0,0,448.0,2.088064598214858,324442.8310960199
2014-02-20,111.9,261.5,271.6,109.2,102180.0,1237.6,0.1,222.4666666666667,11.317510008233342,-42.78440354457305,1106.2484587085405,60.94154129145966,509.83151380038004,0.3729796933278081,110.56173892039332,12100210.0,-86.50018096272169,-0.5720841300191204,98.80405622912718,98.80405622912718,460.4,601.3000000000001,435.29904,925.7,1007.0,1,449.0,2.088401588892991,325746.31828872196
2014-02-21,111.6,111.9,160.1,91.7,82590.0,1237.6,0.1,161.66666666666666,11.311884883663652,-41.50549411305286,1076.3754019877938,7.934598012206266,471.9047029622486,3.1708094327597185,107.55018614036523,12017620.0,-83.95860284605433,-0.002680965147453196,96.37113453437745,96.37113453437745,438.52500000000003,592.5500000000001,370.079232,111.6,1007.0,1,450.0,2.088734482915109,327045.19258111715
2014-02-22,255.6,111.6,290.6,96.7,72170.0,1237.6,0.1,159.70000000000002,29.440435038433392,-28.004394812724513,1020.2400735910429,-5.700073591042724,451.3042550610821,26.943942133815547,113.71802998748201,12089790.0,-60.604192355117135,1.2903225806451615,44.49062206083021,44.49062206083021,424.0,592.5500000000001,314.4033856,111.6,1007.0,0,451.0,2.0897085620149274,329864.6212444501
2014-02-23,310.2,255.6,349.1,220.3,38550.0,1237.6,0.1,225.79999999999998,34.87610233307193,-13.19188508543914,956.8350169565575,-4.445016956557538,437.86575457907423,35.91977642610554,114.79531355980473,12128340.0,-52.97149787750152,0.2136150234741785,37.00687090902796,37.00687090902796,423.15000000000003,592.5500000000001,91.7,111.6,1007.0,0,452.0,2.0908293147682047,333059.164471101
2014-02-24,174.0,310.2,316.9,131.9,95120.0,1237.6,0.1,246.6,28.896054381962458,-10.480248227051646,889.1670296225927,-12.037029622592797,412.73568271440047,15.888030888030888,119.80993401981867,12033220.0,-70.13388259526262,-0.4390715667311412,68.85628391943601,68.85628391943601,423.15000000000003,592.5500000000001,96.7,111.6,1007.0,1,453.0,2.091498212882337,335194.97926007817
2014-02-25,135.8,174.0,174.6,102.3,30430.0,1237.6,0.1,206.66666666666666,27.4732110459274,-9.217334875131911,814.9160127824948,-14.656012782494827,386.3608557892195,8.9379813538711,116.41636730411733,12002790.0,-76.54576856649396,-0.2195402298850574,85.7263382209995,85.7263382209995,390.95000000000005,592.5500000000001,101.748,111.6,1007.0,0,454.0,2.0919724043022425,336872.84703558136
2014-02-26,593.1,135.8,650.0,522.8,600.0,1237.6,0.1,300.96666666666664,55.635845141795535,22.71400323690699,765.3945870295174,11.285412970482582,406.0502980950081,89.80834676697117,144.82948392525182,12003390.0,11.673884390886839,3.367452135493372,24.419066586621447,24.419066586621447,450.65000000000003,592.5500000000001,102.3,111.6,1007.0,0,455.0,2.093584933739658,341339.5149360423
2014-02-27,596.5,593.1,629.9,580.5,500.0,1237.6,0.1,441.8,55.77335101748454,43.17521491981543,746.4830685631835,20.276931436816483,424.18836494310256,90.41733834855813,138.01309221630527,12003890.0,32.14443952148871,0.005732591468555093,23.137148737016812,23.137148737016812,448.25,567.85,102.3,111.6,1007.0,0,456.0,2.0951969540645705,345864.5714104396
2014-02-28,573.9,596.5,599.0,570.0,510.0,1237.6,0.1,587.8333333333334,54.56275418482898,53.616898735743575,733.1286450631043,26.14135493689571,438.4466159009023,86.3693354827154,130.22644277228346,12003380.0,34.18283843815759,-0.037887678122380586,22.691486804719197,22.691486804719197,448.25,564.9,124.208,111.6,1007.0,0,457.0,2.0967742109685332,350362.5040709243
2014-03-01,557.4,573.9,564.1,262.8,400.0,1237.6,0.1,575.9333333333333,53.64720831044282,57.498250266949995,714.3739480636948,34.67605193630516,449.7755096246259,83.41393516030809,143.1459825742632,12002980.0,50.20210185933709,-0.028750653423941452,25.68101589061055,25.68101589061055,445.625,564.9,145.23968,111.6,1007.0,0,458.0,2.0983241075392467,354849.56255624007
2014-03-02,544.6,557.4,562.9,541.5,830.0,1237.6,0.1,558.6333333333333,52.90556364010729,57.169320969020944,708.1975368679623,37.052463132037644,458.8064134698996,81.12126097080423,134.44984096181582,12002150.0,81.65443629086057,-0.022963760315751647,24.687815086635297,24.687815086635297,444.55,564.9,165.43009279999998,111.6,1007.0,0,459.0,2.0998513098494507,359335.8722818912
2014-03-03,662.2,544.6,695.4,545.4,1260.0,1237.6,0.1,588.0666666666667,58.572169187378826,62.410235146581556,724.3368854789885,29.23311452101143,478.17723123467107,94.50057975815804,135.61770946454325,12003410.0,143.18766066838046,0.21593830334190245,20.47987155912764,20.47987155912764,449.54999999999995,564.9,184.812889088,111.6,662.2,0,460.0,2.101524495733645,364261.3972609769
2014-03-04,661.8,662.2,686.2,645.2,1370.0,1237.6,0.1,622.8666666666667,58.546364971435345,63.194752046715905,746.7833054381143,19.85669456188566,495.6651139742262,94.43432168295512,128.85930164564732,12002040.0,125.10204081632652,-0.0006040471156751881,19.47103379353994,19.47103379353994,430.625,564.9,215.44811574271998,111.6,662.2,0,461.0,2.1031921675714695,369240.28943365364
2014-03-05,658.3,661.8,666.0,636.8,1260.0,1237.6,0.1,660.7666666666667,58.304321794962455,60.803091415130304,775.5986606008955,11.73133939910457,511.1541507385856,93.8545635249296,121.74078009952966,12000780.0,151.7399617590822,-0.005288606829857989,18.493206759764494,18.493206759764494,402.17499999999995,564.9,244.24522879815677,111.6,662.2,0,462.0,2.1048507261707123,374263.2027424034
2014-03-06,648.3,658.3,661.8,636.2,2070.0,1237.6,0.1,656.1333333333333,57.57196852279792,55.99264168243579,802.3415741082149,7.048425891785257,524.2156601920536,92.19811164485671,114.87358152099182,11998710.0,479.35656836461123,-0.015190642564180457,17.71920122180963,17.71920122180963,437.475,564.9,271.31451507026736,111.6,662.2,0,463.0,2.106492505525026,379309.1666779341
2014-03-07,616.7,648.3,655.2,600.3,2340.0,1237.6,0.1,641.1,55.2119014355448,48.41223342977439,824.7532528531899,9.196747146810196,533.0236925547151,86.85485217972274,110.58975426949242,11996370.0,452.59856630824373,-0.04874286595711852,17.932504340764133,17.932504340764133,437.475,564.9,296.7596441660513,111.6,662.2,0,464.0,2.1080909199487596,384303.77501465403
2014-03-08,609.2,616.7,625.7,588.6,2170.0,1237.6,0.1,624.7333333333333,54.639398075842976,40.9207107916783,844.7190761920399,20.170923807960037,540.2785789780755,85.46619457089867,105.34048610738581,11994200.0,138.34115805946794,-0.012161504783525179,17.291609669629977,17.291609669629977,436.32500000000005,564.9,320.6780655160882,111.6,662.2,0,465.0,2.1096750760025373,389324.6914472546
2014-03-09,627.0,609.2,637.6,598.5,1950.0,1237.6,0.1,617.6333333333333,55.810534547378715,35.398938247918444,863.8862223365754,36.47377766342453,548.5377619325445,88.46737481031867,100.60902281400111,11996150.0,102.1276595744681,0.02921864740643465,16.04609614258391,16.04609614258391,436.32500000000005,564.9,343.1613815851229,111.6,662.2,0,466.0,2.1112765023729643,394460.6788187859
2014-03-10,613.0,627.0,633.7,594.7,2630.0,1237.6,0.1,616.4,54.61615452015932,29.29114429379054,879.1177242727682,53.14227572723178,554.6770227008736,86.10689597032541,96.20837832728674,11993520.0,252.29885057471267,-0.022328548644338087,15.69467835681676,15.69467835681676,506.0,564.9,364.2956986900155,111.6,662.2,0,467.0,2.1128557535169845,399601.14901603915
2014-03-11,608.7,613.0,619.7,599.9,2430.0,1237.6,0.1,616.2333333333333,54.232262419395376,23.68849502068812,889.7459976172661,77.23400238273405,559.8220681579332,79.95839112343967,90.75063701819484,11991090.0,348.23269513991164,-0.007014681892332675,14.908926732083922,14.908926732083922,506.975,564.9,384.1619567686146,111.6,662.2,0,468.0,2.1144248035380553,404779.3743215669
2014-03-12,619.4,608.7,640.8,608.2,3200.0,1237.6,0.1,613.6999999999999,55.07840438835282,19.599434865631675,881.0838242150041,136.646175784996,565.4961569047967,82.43180767452613,86.59702008832377,11994290.0,4.434328106558751,0.017578445868243753,13.980791102409393,13.980791102409393,515.475,564.9,402.8362393624977,111.6,662.2,0,469.0,2.1160024116762353,410050.4305668734
2014-03-13,625.0,619.4,636.1,616.1,3410.0,1237.6,0.1,617.6999999999999,55.54166557277494,16.303277174765114,861.7117551339798,207.35824486602036,571.1631895805303,83.72630605640315,81.84009008201494,11997700.0,4.777870913663034,0.009041007426541903,13.09441441312239,13.09441441312239,510.42499999999995,564.9,420.3900650007478,111.6,662.2,0,470.0,2.117582107181977,415396.85542453354
2014-03-14,614.0,625.0,631.2,610.6,4000.0,1237.6,0.1,619.4666666666667,54.355878797878866,12.580353734308607,854.8820389697327,250.02796103026742,575.2428858109561,81.18354137771614,77.46579793329958,11993700.0,6.987280013939714,-0.01759999999999995,12.616579467964101,12.616579467964101,509.375,564.9,436.89066110070297,111.6,662.2,0,471.0,2.119143432032185,420757.8483494278
2014-03-15,624.0,614.0,628.8,609.2,3460.0,1237.6,0.1,621.0,55.29038171929041,10.096601357690112,850.5695915284293,285.72040847157064,579.8864204956269,53.60623781676414,73.33252665234961,11997160.0,11.948331539289562,0.016286644951140072,11.752007476338079,11.752007476338079,507.725,564.9,452.4012214346608,111.6,662.2,0,472.0,2.120712342780552,426211.79137806746
2014-03-16,619.1,624.0,627.3,613.2,3300.0,1237.6,0.1,619.0333333333333,54.69942006902197,7.545844413231116,807.7286359410563,373.0713640589437,583.621047115091,49.13333333333336,69.10163189146749,11993860.0,13.67976496511201,-0.007852564102564075,11.161626860195039,11.161626860195039,504.125,564.9,466.98114814858116,111.6,662.2,0,473.0,2.1222704702441306,431703.41687276016
2014-03-17,606.4,619.1,622.5,602.7,3580.0,1237.6,0.1,616.5,53.11482680835995,4.571828914135445,675.0533212448427,552.8066787551575,585.790471199368,18.237704918032737,65.58008675636266,11990280.0,-8.426457263666576,-0.020513648845097765,10.814658106260334,10.814658106260334,505.65,564.9,480.68627925966626,111.6,662.2,0,474.0,2.1238080525426093,437201.62552005355
2014-03-18,598.9,606.4,611.7,585.7,3650.0,1237.6,0.1,608.1333333333333,52.153956944698955,1.8098576886354323,674.9993254322573,553.4406745677428,587.0389977518091,16.438356164383485,62.75293770233675,11986630.0,-9.504381988516165,-0.012368073878627928,10.478032676963894,10.478032676963894,503.4,564.9,493.5691025040863,111.6,662.2,0,475.0,2.125331462712984,442725.17182454676
2014-03-19,595.0,598.9,607.1,590.1,3580.0,1237.6,0.1,600.0999999999999,51.63090291794265,-0.4488026405987888,675.0152382121199,553.27476178788,587.797188442113,12.220762155059088,59.48487072359841,11983050.0,-9.615676743126228,-0.006511938554015662,9.997457264470322,9.997457264470322,504.65,556.6,505.6789563538411,111.6,662.2,0,476.0,2.1268452452309337,448287.90954140597
2014-03-20,566.0,595.0,598.4,560.3,4240.0,1237.6,0.1,586.6333333333333,47.79261005151258,-3.874395193910509,675.7517580395929,551.7482419604071,585.7212657333404,6.006322444678651,57.9573799576271,11978810.0,-12.694740089464748,-0.04873949579831938,10.239819780499488,10.239819780499488,499.69999999999993,532.15,517.0622189726106,111.6,662.2,0,477.0,2.1283163812090566,453781.63525689405
2014-03-21,549.6,566.0,587.4,540.2,3820.0,1237.6,0.1,570.1999999999999,45.722520717361114,-7.03888994141284,676.854799787071,549.865200212929,582.281145187308,9.343936381709728,57.18899567493945,11974990.0,-10.880492946327228,-0.028975265017667784,10.40556689864255,10.40556689864255,493.5,530.45,527.762485834254,549.6,662.2,0,478.0,2.1297606340624626,459254.21628935856
2014-03-22,564.3,549.6,570.0,537.2,3770.0,1237.6,0.1,559.9666666666667,47.900819269986656,-7.873073200068445,674.0400408325535,554.6499591674466,580.5686551694691,26.158301158301093,55.44692455530092,11978760.0,-7.370321733420894,0.02674672489082952,9.825788508825257,9.825788508825257,491.525,530.45,695.4,549.6,662.2,0,479.0,2.131220476501553,464845.44551432366
2014-03-23,551.2,564.3,564.3,538.6,4130.0,1237.6,0.1,555.0333333333333,46.124314800379935,-8.959119826058474,670.2744754369311,547.3155245630688,577.7716403914244,13.513513513513525,53.32214422992228,11974630.0,-12.089314194577346,-0.023214602161970466,9.673828779013476,9.673828779013476,531.05,530.45,692.236,549.6,662.2,0,480.0,2.1326579923974367,470429.54088291276
2014-03-24,567.6,551.2,572.5,531.3,3670.0,1237.6,0.1,561.0333333333333,48.68988322475481,-8.243056443599952,662.9788799876542,545.1911200123459,576.8029127350983,33.15068493150691,52.45627678492783,11978300.0,-7.406199021207175,0.029753265602322054,9.241768284871005,9.241768284871005,529.2,530.45,689.13528,549.6,567.6,0,481.0,2.134113307699187,476142.2311779605
2014-03-25,562.9,567.6,569.7,550.4,3870.0,1237.6,0.1,560.5666666666666,47.98465151158859,-7.762767759784241,655.2512592599846,543.3787407400155,575.4788258079461,28.858447488584495,50.08797130029013,11974430.0,-7.524231969771655,-0.008280479210711844,8.89820062183161,8.89820062183161,528.0,525.65,682.8218688,549.6,567.6,0,482.0,2.135557841953596,481887.3317949233
2014-03-26,562.5,562.9,575.4,546.3,3710.0,1237.6,0.1,564.3333333333334,47.921035547712954,-7.163326743420965,648.3767712920593,541.6732287079407,574.2427471595703,29.770992366412237,48.588830493126544,11970720.0,-9.186309331611234,-0.0007106057914371133,8.638014309889163,8.638014309889163,525.3,525.65,676.7609940479999,549.6,567.6,0,483.0,2.1369973872221624,487684.690616052
2014-03-27,460.5,562.5,567.8,460.5,3780.0,1237.6,0.1,528.6333333333333,35.13084042653061,-12.988175015222634,665.4956559757914,508.9343440242087,563.4101045729445,0.0,52.78248545790321,11966940.0,-26.32,-0.18133333333333335,11.461994670554445,11.461994670554445,555.875,520.4,670.9425542860799,549.6,567.6,0,484.0,2.1382810639078307,492998.14116831915
2014-03-28,482.6,460.5,515.0,453.8,4110.0,1237.6,0.1,501.8666666666666,38.93385727351585,-14.584920424297625,670.6612613389541,491.1087386610459,555.713904137426,16.457142857142866,53.383736496624415,11971050.0,-21.400651465798042,0.0479913137893595,11.061694259557484,11.061694259557484,550.35,515.75,658.3160010289151,549.6,567.6,0,485.0,2.1395961100138243,498482.54336585925
2014-03-29,477.1,482.6,494.3,473.8,4290.0,1237.6,0.1,473.3999999999999,38.33157273315021,-15.175994375634062,671.1858260868029,475.5941739131971,548.2268656481473,13.429394812680124,51.03489817543696,11966760.0,-23.541666666666664,-0.011396601740571888,10.696897542535517,10.696897542535517,545.3,500.25,641.9547209466019,549.6,567.6,0,486.0,2.140898344434448,503981.80047584686
2014-03-30,446.9,477.1,479.0,424.0,3860.0,1237.6,0.1,468.8666666666666,35.119051559969066,-16.647455002447316,675.4221428848881,454.74785711511197,538.5766879673713,11.536523929471022,51.318119734334324,11962900.0,-27.81456953642385,-0.06329909872144213,11.483132632431042,11.483132632431042,522.35,462.40000000000003,626.9023432708738,549.6,567.6,0,487.0,2.142147080383972,509345.623257941
2014-03-31,444.7,446.9,473.4,422.5,4150.0,1237.6,0.1,456.2333333333333,34.88965523328214,-16.768751039715287,676.9823817366565,436.78761826334346,529.6360510180979,11.733615221987307,51.28825403902473,11958750.0,-26.665567282321902,-0.00492280152159319,11.533225554086963,11.533225554086963,520.55,405.5,606.6121089437863,549.6,567.6,0,488.0,2.143388098132164,514738.2348655411
2014-04-01,463.5,444.7,487.4,438.0,3970.0,1237.6,0.1,451.7,38.58165481674157,-14.659041214825153,672.1463269401464,426.03367305985347,523.3373794925648,22.210184182015166,51.15337875052296,11962720.0,-22.608114877275,0.04227569147740051,11.03632767001574,11.03632767001574,518.9,395.85,584.5186558705319,549.6,567.6,0,489.0,2.1446563637398484,520290.50135436165
2014-04-02,424.4,463.5,480.3,409.3,4380.0,1237.6,0.1,444.2,34.23384161493455,-14.923206427346305,668.2788438270526,409.8411561729473,513.9147719218444,7.98519301956635,52.57099455405704,11958340.0,-28.67226890756303,-0.08435814455231938,12.387133495300905,12.387133495300905,508.7,395.85,565.076417166068,549.6,567.6,0,490.0,2.1458541948539844,525635.9672303799
2014-04-03,436.3,424.4,448.7,386.7,4019.9999999999995,1237.6,0.1,441.3999999999999,36.57642797915316,-13.372708685959278,661.9720390410961,398.3779609589038,506.5228888816687,24.71350274040858,53.24449494305296,11962360.0,-22.91519434628975,0.02803958529688977,12.203643122404987,12.203643122404987,497.4,393.55,543.2677187628185,549.6,567.6,0,491.0,2.14706897547656,531101.5911321768
2014-04-04,444.4,436.3,456.5,415.5,2570.0,1237.6,0.1,435.0333333333333,38.19031238953634,-10.978123028996627,650.6505595561666,391.7394404438332,500.6064232738907,30.5776364599894,52.36988816140632,11964930.0,-19.141193595342074,0.01856520742608292,11.784403276644086,11.784403276644086,495.5,393.55,518.2168837607676,549.6,567.6,0,492.0,2.148293689576157,536662.8328677
2014-04-05,456.6,444.4,461.2,439.4,1160.0,1237.6,0.1,445.76666666666665,40.64034893841418,-7.89333377157315,637.2154968977942,388.92450310220573,496.4153353430439,37.042925278219414,50.18632472130587,11966090.0,-19.085592769803288,0.027452745274527457,10.99131071425884,10.99131071425884,482.3,393.55,497.1741823590448,549.6,567.6,0,493.0,2.1495348389146955,542346.9502103723
2014-04-06,455.7,456.6,472.4,446.3,3590.0,1237.6,0.1,452.2333333333333,40.512771074439335,-5.355668910782001,624.2833267250543,386.7866732749457,492.5376843579921,36.56597774244833,48.46587295549831,11962500.0,-17.325834542815684,-0.001971090670170872,10.63547793625155,10.63547793625155,477.125,393.55,479.4983131815976,549.6,567.6,0,494.0,2.150770547687868,548070.1217415018
2014-04-07,462.4,455.7,485.1,448.0,3950.0,1237.6,0.1,458.2333333333333,41.973144467587744,-2.796738709731777,610.7080517687707,386.71194823122937,489.66742870485,40.1165871754107,47.65402488724844,11966450.0,-18.534178999295285,0.01470265525565062,10.305801229941272,10.305801229941272,474.22499999999997,393.55,386.7,549.6,567.6,0,495.0,2.1520132695589074,553882.0762321561
2014-04-08,466.6,462.4,480.7,457.6,3910.0,1237.6,0.1,461.5666666666666,42.91914164228806,-0.5117929812585942,595.8783951029276,388.70160489707234,487.4705307329595,42.34234234234236,45.9001659667307,11970360.0,-17.107834428850587,0.009083044982699073,9.83715515789342,9.83715515789342,473.0,393.55,388.668,549.6,567.6,0,496.0,2.153258818146864,559767.4524551125
2014-04-09,457.3,466.6,479.7,451.1,3880.0,1237.6,0.1,462.0999999999999,41.31306395241514,0.6212719751751372,585.7014764167152,388.00852358328484,484.59714685363,38.98398674765325,44.66443982624993,11966480.0,-18.70222222222222,-0.019931418774110643,9.766988809588877,9.766988809588877,472.4,393.55,390.59664,549.6,567.6,0,497.0,2.154485317769423,565637.9785799467
2014-04-10,384.6,457.3,463.5,384.6,3650.0,1237.6,0.1,436.1666666666667,31.41606621679051,-3.074492648525627,582.538661053579,374.6713389464211,475.0736090580462,0.0,47.109836981517795,11962830.0,-16.48208469055374,-0.15897660179313355,12.249047577097711,12.249047577097711,470.4,393.55,485.1,384.6,567.6,0,498.0,2.155578229767203,571019.6166474785
2014-04-11,435.1,384.6,450.4,355.7,5160.0,1237.6,0.1,425.6666666666667,41.83899191100885,-1.7337924415558987,569.8439759414102,374.44602405859,471.2665986715656,57.28715728715731,50.50913433998081,11967990.0,-9.842519685039369,0.13130525221008837,11.608626600777018,11.608626600777018,454.75,393.55,483.09000000000003,384.6,567.6,0,499.0,2.1567598623955564,576821.9919544822
2014-04-12,437.6,435.1,469.8,428.0,5190.0,1237.6,0.1,419.09999999999997,42.306434142261445,-0.36591157107475425,558.1425495963991,374.7874504036008,468.0602559409403,62.18678815489753,49.88705331569646,11973180.0,-8.279186753301195,0.00574580556193971,11.400149295177437,11.400149295177437,452.05,393.55,477.99440000000004,384.6,567.6,0,500.0,2.157941972436315,582685.6699364564
2014-04-13,427.6,437.6,454.1,409.9,4970.0,1237.6,0.1,433.43333333333334,40.890751876153885,0.1504122259377425,539.8715488626407,379.05845113735927,464.2068982322793,54.59377372817011,49.48083522171815,11968210.0,-4.318639516670386,-0.022851919561243106,11.571757535481327,11.571757535481327,450.9,393.55,473.10262400000005,384.6,567.6,0,501.0,2.1591030016036896,588519.7154768549
2014-04-14,478.4,427.6,497.8,420.1,7620.0,1237.6,0.1,447.8666666666666,50.03723665660073,3.9857011403038776,521.0104918637547,389.46950813624517,465.55862221015747,86.34764250527795,51.49648984873828,11975830.0,7.5781425680233845,0.11880261927034597,10.764316439953655,10.764316439953655,451.9,396.05,355.7,384.6,567.6,0,502.0,2.160344104591709,594756.2627240379
2014-04-15,526.4,478.4,526.6,466.4,8000.0,1237.6,0.1,477.46666666666664,56.83400875258655,9.512427230969791,508.4307552907516,398.4392447092485,471.3530391425234,99.88297249853714,52.11816914525697,11983830.0,13.570658036677449,0.10033444816053505,9.900867998719031,9.900867998719031,456.34999999999997,398.84999999999997,358.542,384.6,567.6,0,503.0,2.1616526243289083,601351.9762247092
2014-04-16,537.0,526.4,549.0,496.1,8060.000000000001,1237.6,0.1,513.9333333333333,58.18676436526806,13.401131888396208,523.2346132993612,391.285386700639,477.60513065275927,93.79203310915675,52.17401420631005,11991890.0,26.531573986804908,0.02013677811550152,9.715831323335204,9.715831323335204,458.95,398.84999999999997,365.26432,384.6,537.0,0,504.0,2.162971933306144,608068.6732836528
2014-04-17,502.0,537.0,537.0,486.9,8000.0,1237.6,0.1,521.7999999999998,52.35279237682402,13.118674760865133,526.2064400362377,390.25355996376214,479.92845154297265,75.68546301086394,52.025870334430756,11983890.0,15.058446023378405,-0.06517690875232773,10.363719190125648,10.363719190125648,458.95,398.84999999999997,376.2884608,384.6,537.0,0,505.0,2.164236927599525,614619.7094857433
2014-04-18,485.5,502.0,512.2,472.0,8360.0,1237.6,0.1,508.1666666666667,49.81697447682131,11.387347771930173,527.1890837405945,390.1109162594054,480.4590752055467,67.14950853595448,51.181165310542845,11975530.0,9.248424842484255,-0.03286852589641431,10.541949600523758,10.541949600523758,458.95,479.1,386.651153152,384.6,537.0,0,506.0,2.165473064993543,621112.2749423215
2014-04-19,506.0,485.5,516.9,473.2,8380.0,1237.6,0.1,497.8333333333333,52.871319493914115,11.173955737040917,532.9034565050339,390.30654349496587,482.8915442335899,77.7547853078117,50.64679635978978,11983910.0,10.819097678493206,0.04222451081359413,10.009248292448573,10.009248292448573,458.95,479.1,396.39208396288,384.6,537.0,0,507.0,2.166736064813528,627795.6486306385
2014-04-20,498.5,506.0,522.2,488.7,7690.0,1237.6,0.1,496.6666666666667,51.6331448242988,10.110799994864843,536.8871338713792,391.70286612862094,484.3780638303909,73.87480600103467,49.422025191233374,11976220.0,9.392143954355939,-0.014822134387351804,9.914147480688742,9.914147480688742,472.5,479.1,405.5485589251072,384.6,537.0,0,508.0,2.167983999615413,634482.3140293466
2014-04-21,495.2,498.5,524.7,490.7,7350.0,1237.6,0.1,499.8999999999999,51.066468651187954,8.81575083404799,539.7072740929816,392.05272590701844,485.4087244179727,72.16761510605276,48.32045196328813,11968870.0,7.093425605536336,-0.006619859578736231,9.757764936043644,9.757764936043644,470.6,479.1,414.1556453896008,384.6,537.0,0,509.0,2.169223073381661,641199.5731786153
2014-04-22,487.9,495.2,520.5,483.4,5680.0,1237.6,0.1,493.8666666666666,49.76532039807914,7.167880453261921,540.90903189801,397.2009681019901,485.6459887591181,68.39110191412311,47.518991108767544,11963190.0,4.564937848264028,-0.014741518578352153,9.739493975972033,9.739493975972033,468.45000000000005,525.55,422.24630666622477,384.6,537.0,0,510.0,2.170447218215625,647918.4711054789
2014-04-23,487.3,487.9,510.0,482.3,4740.0,1237.6,0.1,490.13333333333327,49.65333730120049,5.796493953531744,542.2377820491323,400.97221795086773,485.8035136392021,68.08070356958096,46.103348886712716,11958450.0,6.56024491581019,-0.0012297601967615757,9.460978634662983,9.460978634662983,480.025,525.55,429.8515282662513,384.6,537.0,0,511.0,2.17166658195562,654685.5665578229
2014-04-24,500.3,487.3,507.3,477.2,4230.0,1237.6,0.1,491.83333333333326,52.164928112224665,5.5250013861791505,544.9294264828534,403.87057351714657,487.1841313878495,74.80600103466115,44.96025253766181,11962680.0,30.083203328133116,0.026677611327724282,8.986658512424906,8.986658512424906,481.425,520.95,437.00043657027624,384.6,537.0,0,512.0,2.1729016064142948,661598.6360615238
2014-04-25,464.5,500.3,502.5,438.3,6450.0,1237.6,0.1,484.0333333333333,45.44197943357536,2.830238526101171,545.0090292249363,404.5809707750636,485.02373792234005,39.252336448598136,46.3345202135431,11956230.0,6.75706734084118,-0.07155706576054366,9.97513890496084,9.97513890496084,470.0,510.85,549.0,384.6,537.0,0,513.0,2.1740777504943165,668300.6402337318
2014-04-26,457.9,464.5,468.7,448.6,6890.0,1237.6,0.1,474.2333333333333,44.30824503482218,0.6149058124761515,545.0058266713041,404.8041733286959,482.4405247868791,34.50754852624011,44.46062591257573,11949340.0,4.638939670932348,-0.01420882669537138,9.70968026044458,9.70968026044458,466.925,508.75,546.786,384.6,537.0,0,514.0,2.175239548770388,675000.9090178072
2014-04-27,443.2,457.9,461.4,437.4,6960.0,1237.6,0.1,455.2,41.806429724668824,-1.7021225435979783,545.2205631335188,402.6694368664812,478.7033319500335,17.92086889061285,42.99915263310603,11942380.0,3.6482694106641644,-0.03210307927495082,9.70197487209071,9.70197487209071,466.70000000000005,505.45000000000005,544.61628,384.6,537.0,0,515.0,2.1763734946713256,681631.449765909
2014-04-28,441.9,443.2,451.1,420.8,4540.0,1237.6,0.1,447.6666666666667,41.58281761885912,-3.1023931263164837,545.295753423108,400.1242465768921,475.19825271669697,16.458658346333827,42.09207030216989,11937840.0,-7.629598662207358,-0.0029332129963899334,9.525247861998166,9.525247861998166,462.55,498.25,540.3276288,384.6,537.0,0,516.0,2.177501614496366,688298.4712090483
2014-04-29,446.1,441.9,453.8,430.7,3720.0,1237.6,0.1,443.7333333333333,42.65009077785844,-3.4965850669799217,545.3726877408923,398.9273122591076,472.426990553202,19.73478939157567,40.7354938520149,11941560.0,-15.25455927051671,0.00950441276306857,9.13147138579128,9.13147138579128,462.55,498.25,533.1559710719999,384.6,537.0,0,517.0,2.178633081036319,695047.8652940473
2014-04-30,445.6,446.1,452.6,430.9,4080.0,1237.6,0.1,444.5333333333333,42.55042540744222,-3.531495808173556,537.9083088593546,412.4916911406453,469.8720390719447,21.34251290877798,39.375815719728124,11937480.0,-17.020484171322156,-0.00112082492714638,8.836583420046706,8.836583420046706,461.5,498.25,526.41461280768,384.6,537.0,0,518.0,2.1797600761626064,701841.0959675437
2014-05-01,460.1,445.6,464.5,444.5,4200.0,1237.6,0.1,450.59999999999997,46.45795236378676,-2.3740720246724507,536.8659085009918,416.0340914990081,468.94136868414046,37.824831568816165,37.991828882604686,11941680.0,-8.346613545816728,0.03254039497307004,8.257298170529165,8.257298170529165,458.875,498.25,520.0777360392192,384.6,537.0,0,519.0,2.1809070545802287,708803.5080859091
2014-05-02,453.7,460.1,463.4,442.0,3380.0,1237.6,0.1,453.13333333333327,45.002985357311225,-1.8583683111537592,535.9843614812917,418.5256385187084,467.4898097618414,31.665062560153963,36.806698248132925,11938300.0,-6.5499485066941325,-0.013910019560965048,8.112562981735271,8.112562981735271,458.20000000000005,498.25,514.121071876866,384.6,537.0,0,520.0,2.182040038781264,715762.9023810101
2014-05-03,438.6,453.7,454.2,429.1,2580.0,1237.6,0.1,450.79999999999995,41.68584854620205,-2.3228944240623193,534.8457389503346,420.7642610496654,464.73839930833265,17.13185755534168,35.970505516123424,11935720.0,-13.320158102766793,-0.03328190434207623,8.201209647998956,8.201209647998956,457.0,495.9,508.52180756425406,384.6,537.0,0,521.0,2.183144459990427,722641.6532159755
2014-05-04,436.0,438.6,446.6,428.8,3370.0,1237.6,0.1,442.76666666666665,41.12377120558128,-2.5744432315498607,535.5609475916684,415.80905240833164,462.00140889801526,14.62945139557265,34.672612264971754,11932350.0,-12.537612838515546,-0.005927952576379458,7.952434005727467,7.952434005727467,448.55,493.45000000000005,503.2584991103988,384.6,537.0,0,522.0,2.1842409332013273,729544.8928170084
2014-05-05,430.9,436.0,443.9,426.4,3040.0,1237.6,0.1,435.1666666666666,39.984873624418746,-2.832991868565463,529.0534742684011,412.76652573159885,459.0393699553471,10.130391173520529,33.445997103188056,11929310.0,-12.984652665589664,-0.01169724770642211,7.761893038567662,7.761893038567662,447.5,492.25,498.3109891637749,430.9,537.0,0,523.0,2.1853252020435754,736449.3699307097
2014-05-06,432.2,430.9,435.0,420.2,4190.0,1237.6,0.1,433.0333333333333,40.43768896965654,-2.667484306379553,517.6021518907144,413.7378481092857,456.4832394834093,13.363028953229398,32.11414016724605,11933500.0,-11.416273826603812,0.003016941285681085,7.430388747627499,7.430388747627499,447.35,491.5,493.6603298139484,430.9,537.0,0,524.0,2.18640816082032,743412.4621824728
2014-05-07,446.5,432.2,458.8,423.5,5030.0,1237.6,0.1,436.5333333333333,45.32455161911042,-1.409153347825443,512.6511041481368,413.1388958518634,455.5324547707037,30.19517795637199,32.341701583871334,11938530.0,-8.372665709008826,0.03308653401203143,7.243382213632997,7.243382213632997,460.9,489.1,487.78350342883255,430.9,537.0,0,525.0,2.1875115010396677,750552.4094708395
2014-05-08,441.1,446.5,455.5,439.5,2540.0,1237.6,0.1,439.9333333333332,43.86109299475625,-0.7858218757617053,510.1599825704751,411.1900174295249,454.1579352687319,25.394896719319604,31.174437185023383,11935990.0,-11.832900259844092,-0.012094064949607963,7.067430783274401,7.067430783274401,460.9,483.70000000000005,482.37682315452594,430.9,537.0,0,526.0,2.1886023547266173,757692.7965190418
2014-05-09,445.5,441.1,455.8,438.5,2270.0,1237.6,0.1,444.3666666666666,45.407845285466045,0.03403230680551772,502.8976076715689,412.40239232843106,453.33337000504315,52.16494845360827,30.18340595752171,11938260.0,-4.090419806243272,0.009975062344139696,6.775175299107006,6.775175299107006,463.45000000000005,481.4,477.40267730216385,430.9,537.0,0,527.0,2.1896969559474435,764922.1975958449
2014-05-10,451.9,445.5,459.5,441.4,450.0,1237.6,0.1,446.1666666666667,47.66649367922674,1.0616427671679194,496.5328426585722,414.1071573414279,453.1968585759914,71.55756207674939,29.320305531984445,11938710.0,-1.310329766324525,0.014365881032547545,6.488228708117824,6.488228708117824,463.2,477.04999999999995,472.8264631179907,430.9,451.9,0,528.0,2.1907984721070783,772259.5759876417
2014-05-11,433.2,451.9,455.4,429.0,1890.0,1237.6,0.1,443.5333333333333,42.17579079679658,0.5613587387284351,490.1651498877026,414.2748501122973,451.29239585446845,29.345372460496606,29.11171227969984,11936820.0,-2.256317689530686,-0.0413808364682452,6.720155189219723,6.720155189219723,462.225,471.54999999999995,468.6163460685515,430.9,451.9,0,529.0,2.191865503072071,779473.0539368853
2014-05-12,438.2,433.2,441.1,430.2,1390.0,1237.6,0.1,441.0999999999999,44.0321683127822,0.6408449427558178,484.373607073614,415.09639292638605,450.04550101118576,40.632054176072224,27.810875688292715,11938210.0,-0.8372935053179428,0.011542012927054479,6.346616998697561,6.346616998697561,459.225,465.54999999999995,464.74303838306736,430.9,451.9,0,530.0,2.1929374599785065,786782.289822007
2014-05-13,433.9,438.2,442.3,432.7,2650.0,1237.6,0.1,435.0999999999999,42.76075971280263,0.4845882095593197,477.7120406401697,416.4179593598302,448.5078342482157,30.925507900677168,26.510098853414664,11935560.0,-2.734812822237177,-0.009812870835235077,6.109725479007759,6.109725479007759,456.15000000000003,465.54999999999995,461.17959531242195,430.9,451.9,0,531.0,2.193998731157467,794098.9419246189
2014-05-14,442.6,433.9,444.3,433.9,2200.0,1237.6,0.1,438.2333333333333,46.148780714380436,1.0172887616446147,462.7041032171658,425.6558967828342,447.9451833674333,50.56433408577885,25.35937750674219,11937760.0,-0.6732495511669658,0.020050702926941888,5.7296379364532735,5.7296379364532735,456.15000000000003,465.54999999999995,457.9012276874282,430.9,451.9,0,532.0,2.1950710528846757,801548.0957598083
2014-05-15,448.1,442.6,450.0,441.5,2170.0,1237.6,0.1,441.5333333333333,48.23479967746443,1.7473542185570121,459.5138106959384,427.20618930406164,447.95992780863014,64.58333333333343,24.155136256260608,11939930.0,-2.6081286676809388,0.01242657026660643,5.390568233934525,5.390568233934525,456.975,465.54999999999995,454.88512947243396,430.9,451.9,0,533.0,2.196148917131459,809099.9387960477
2014-05-16,453.6,448.1,455.1,441.9,1760.0,1237.6,0.1,448.09999999999997,50.30778281421254,2.5588703628765934,458.6191687983625,427.67083120163767,448.49707754114155,84.98727735368963,23.37262652367057,11941690.0,-0.02204099625302312,0.012274045971881309,5.1526954417263156,5.1526954417263156,458.35,465.54999999999995,420.2,430.9,451.9,0,534.0,2.1972321982127836,816755.3200407141
2014-05-17,452.8,453.6,455.9,452.2,1710.0,1237.6,0.1,451.5,49.99417329090825,2.971013737634454,459.6615675878666,427.5884324121334,448.90687968008046,82.95165394402039,21.967438914836954,11939980.0,3.237574099407202,-0.0017636684303351524,4.851466191439256,4.851466191439256,457.3,461.75,420.89799999999997,430.9,451.9,0,535.0,2.198310702150748,824454.9525211537
2014-05-18,450.1,452.8,454.0,449.0,1450.0,1237.6,0.1,452.1666666666667,48.88652547081019,2.983207658291807,460.2919708125535,427.7780291874466,449.0205101867395,76.08142493638684,20.7554789923486,11938530.0,3.2339449541284453,-0.005962897526501698,4.6113039307595205,4.6113039307595205,454.675,452.35,422.29807999999997,430.9,451.9,0,536.0,2.1993813725824283,832180.2886919165
2014-05-19,443.9,450.1,451.7,441.2,1350.0,1237.6,0.1,448.93333333333334,46.34719973562969,2.5139206269012018,460.1543407136647,427.69565928633534,448.5328425499072,60.30534351145034,20.02294477860941,11937180.0,3.0169412856811326,-0.013774716729615721,4.510688168193154,4.510688168193154,453.1,452.35,423.64215679999995,430.9,451.9,0,537.0,2.200438489990065,839895.8734292628
2014-05-20,484.6,443.9,486.2,437.3,1900.0,1237.6,0.1,459.5333333333333,60.757506852389795,4.754770163674486,469.9272660055184,421.8227339944816,451.9678099261065,97.44816586921854,22.085591580137308,11939080.0,12.124016658954197,0.09168731696328014,4.557488976503778,4.557488976503778,459.775,452.35,424.93247052799995,430.9,451.9,0,538.0,2.201555984096317,848054.275387077
2014-05-21,488.8,484.6,495.2,481.7,1400.0,1237.6,0.1,472.4333333333332,61.89488195925964,6.236629949417824,477.2819135191636,417.3380864808365,455.4756375521916,90.33232628398794,21.47233503869893,11940480.0,9.473684210526319,0.008666941807676354,4.392867233776377,4.392867233776377,460.825,452.35,428.60852229631996,430.9,451.9,0,539.0,2.202676196678454,856309.2010522664
2014-05-22,515.4,488.8,519.3,485.5,3120.0,1237.6,0.1,496.26666666666665,68.18424169643869,8.580389252985064,492.577104025288,408.21289597471196,461.1827196900781,95.68106312292362,22.352882535934718,11943600.0,16.84425300385399,0.05441898527004896,4.336996999599286,4.336996999599286,473.17499999999995,452.35,433.9358405126144,430.9,451.9,0,540.0,2.2038313369091242,864863.8045443418
2014-05-23,518.1,515.4,540.9,515.2,2760.0,1237.6,0.1,507.4333333333332,68.74809538500858,9.79670813300026,505.4101449841223,403.3298550158777,466.6034130529278,79.6246648793566,22.591962354796518,11946360.0,16.2962962962963,0.005238649592549605,4.360540890715406,4.360540890715406,484.825,452.35,442.47225646135297,430.9,451.9,0,541.0,2.20498664009557,873505.3621754827
2014-05-24,520.5,518.1,526.7,510.4,2860.0,1237.6,0.1,518.0,69.2694422314203,10.201133773471016,516.3949818339092,400.79501816609076,471.73642133360136,81.76943699731905,22.142536472311058,11949220.0,15.180349634874979,0.004632310364794501,4.254089620040549,4.254089620040549,484.825,452.35,454.2835856859906,430.9,451.9,0,542.0,2.20614166840801,882231.9724811142
2014-05-25,570.4,520.5,575.2,520.5,1870.0,1237.6,0.1,536.3333333333333,77.62656685610821,13.083568384018033,539.6841309063275,391.4558690936725,481.1329526351631,96.68965517241374,24.4680695814317,11951090.0,31.671283471837487,0.09586935638808836,4.2896335170812945,4.2896335170812945,501.975,465.45000000000005,464.6775554036717,430.9,451.9,0,543.0,2.2073594168348523,891451.4997490693
2014-05-26,582.0,570.4,586.4,564.7,2960.0,1237.6,0.1,557.6333333333333,79.05268936866733,14.894032401617752,561.1337282054089,384.98627179459095,490.7393380984809,97.1372804163956,24.270350325615144,11954050.0,32.81606572341397,0.020336605890603154,4.17016328618817,4.17016328618817,507.575,471.04999999999995,480.1506976471577,430.9,451.9,0,544.0,2.2085879892025995,900838.6238023528
2014-05-27,570.1,582.0,586.2,555.3,3350.0,1237.6,0.1,574.1666666666666,73.85200887116179,14.404036891315606,575.9171824165364,382.56281758346347,498.2974963748161,89.31147540983609,24.743896730928356,11950700.0,31.389721133901833,-0.02044673539518893,4.340273062783433,4.340273062783433,507.575,471.04999999999995,497.15058602361245,430.9,451.9,0,545.0,2.209797836468837,910201.572996575
2014-05-28,570.8,570.1,581.8,562.6,3570.0,1237.6,0.1,574.2999999999998,73.96052928444402,13.269117140951067,588.506182616276,382.943817383724,505.20249672007174,89.53722334004023,24.34790410729061,11954270.0,28.965205603253487,0.0012278547623223446,4.265575351662686,4.265575351662686,507.575,471.04999999999995,511.43049225983447,430.9,451.9,0,546.0,2.211004838510452,919643.4170147539
2014-05-29,564.4,570.8,573.8,557.7,3730.0,1237.6,0.1,568.4333333333333,71.05686906356557,11.306117324718272,598.1450693824629,385.1949306175372,510.840354175303,85.24480214621059,23.758768099626987,11950540.0,25.95402811872349,-0.011212333566923527,4.20956203040875,4.20956203040875,518.675,471.04999999999995,523.425613498261,564.4,451.9,0,547.0,2.2121999691670555,929103.7628345543
2014-05-30,612.3,564.4,613.3,564.0,6210.0,1237.6,0.1,582.4999999999999,78.01402499310439,12.36652687677,616.6243730474504,382.7556269525495,520.5031775871789,99.43181818181817,25.583141806796483,11956750.0,34.98677248677247,0.08486888731396158,4.178203790102317,4.178203790102317,533.075,484.5,533.5015153385392,564.4,451.9,1,548.0,2.2134502245476693,939037.3692988363
2014-05-31,627.9,612.3,629.0,604.7,4410.0,1237.6,0.1,601.5333333333333,79.72346454297114,13.176866069173435,634.7164342642797,384.13356573572037,530.7314463884,99.4261867501304,25.491488820596732,11961160.0,38.67049469964663,0.02547770700636942,4.05980073588099,4.05980073588099,547.1500000000001,492.35,547.8652425776021,564.4,451.9,0,549.0,2.2147148227033187,949176.5612528869
2014-06-01,649.8,627.9,675.0,622.0,3550.0,1237.6,0.1,629.9999999999999,81.85621528482409,14.160005224203069,654.8257176215893,385.18428237841067,542.0713086371237,89.39840134623472,27.456382476268395,11964710.0,44.367918240391006,0.03487816531294796,4.225358952949891,4.225358952949891,570.975,515.35,564.0,564.4,451.9,0,550.0,2.216000302387663,959571.2411971916
2014-06-02,655.5,649.8,662.6,625.5,4130.0,1237.6,0.1,644.4,82.37581722328427,14.133794599021478,672.0620374919276,390.1079625080725,552.8740411478739,91.79638199411023,28.14521229939208,11968840.0,47.668393782383426,0.00877192982456143,4.29370134239391,4.29370134239391,574.875,542.45,586.2,564.4,451.9,0,551.0,2.2172881945624194,970097.4253864713
2014-06-03,669.4,655.5,676.5,631.4,4360.0,1237.6,0.1,658.2333333333332,83.60859207137969,13.96740815668226,689.4638775120388,395.3861224879611,563.971751514743,96.35523613963038,29.35626856372122,11973200.0,38.1345439537763,0.021205186880244087,4.385459898972396,4.385459898972396,584.325,543.2,603.96,564.4,669.4,0,552.0,2.2185873124631703,980819.6694361704
2014-06-04,638.9,669.4,669.8,602.1,5600.0,1237.6,0.1,654.5999999999999,71.7492202620353,10.856545658043878,698.0417917911684,405.88820820883143,571.1077751800055,80.31413612565444,32.095106523455414,11967600.0,30.707855973813412,-0.04556319091723937,5.023494525505622,5.023494525505622,584.325,548.3,676.5,564.4,669.4,0,553.0,2.2198489737791967,991391.6271552906
2014-06-05,660.2,638.9,665.4,635.6,2760.0,1237.6,0.1,656.1666666666666,74.47245043559819,9.344229886079873,708.3067183653436,416.2832816346565,579.592748972386,90.18663455749551,31.931170343208596,11970360.0,28.09468374078387,0.03333855063390212,4.836590479128839,4.836590479128839,584.925,548.35,676.5,564.4,669.4,0,554.0,2.221130393236041,1002221.920820059
2014-06-06,650.4,660.2,663.8,647.1,6040.0,1237.6,0.1,649.8333333333333,71.0776210660611,6.907103590365537,713.8917297816331,430.45827021836675,586.3362966893017,84.2865743527995,30.843229604407977,11964320.0,25.53561088592935,-0.014843986670705966,4.742193973617463,4.742193973617463,585.225,548.35,675.012,564.4,669.4,0,555.0,2.222397207734282,1013063.8411122925
2014-06-07,651.7,650.4,659.8,641.0,1970.0,1237.6,0.1,654.1,71.2647492735613,4.710715544633516,716.2758562127569,448.2341437872429,592.5614112903206,84.10256410256413,29.982998918378833,11966290.0,25.20653218059559,0.0019987699876999887,4.600736369246407,4.600736369246407,587.425,548.35,673.5537599999999,564.4,669.4,0,556.0,2.22366162979157,1024005.9624365938
2014-06-08,651.0,651.7,658.9,648.7,3310.0,1237.6,0.1,651.0333333333333,70.99837454343577,2.641983859590674,713.644869355903,471.5751306440968,598.126991167433,78.96039603960396,28.569927567066056,11962980.0,14.1304347826087,-0.0010741138560688146,4.388621746093096,4.388621746093096,597.25,548.35,672.1246848,564.4,669.4,0,557.0,2.224921462754017,1035032.4882738296
2014-06-09,644.3,651.0,652.1,639.1,3260.0,1237.6,0.1,648.9999999999999,68.36441085935485,0.37278344311950207,712.8248440701071,488.3651559298929,602.5244205800584,73.43234323432341,27.457789883704198,11959720.0,10.704467353951882,-0.010291858678955546,4.26164673035918,4.26164673035918,598.0999999999999,548.35,670.7241911039999,564.4,669.4,0,558.0,2.226170073510028,1046093.2124910995
2014-06-10,655.6,644.3,661.4,641.7,3560.0,1237.6,0.1,650.2999999999998,70.36153649535036,-0.755243355134084,711.0271206558107,506.84287934418944,607.5792376676719,82.40740740740742,26.90366203486818,11963280.0,14.997368882652165,0.01753841378239951,4.103670231065921,4.103670231065921,598.0999999999999,548.35,669.35170728192,564.4,669.4,0,559.0,2.227427361539533,1057339.446950524
2014-06-11,643.0,655.6,663.0,642.3,3800.0,1237.6,0.1,647.6333333333332,65.40352636572115,-2.632392421821251,708.8153160422501,521.81468395775,610.9526436040841,71.8013468013468,26.460543318091883,11959480.0,12.648913805185714,-0.019219035997559475,4.115170033917867,4.115170033917867,598.0999999999999,548.35,668.0066731362816,564.4,669.4,0,560.0,2.2286669622350432,1068570.039190979
2014-06-12,597.1,643.0,643.8,591.1,4590.0,1237.6,0.1,631.9,51.2390636987684,-6.999802007855408,702.0666008299396,536.4633991700604,609.633344213219,29.422222222222242,28.33479022394246,11954890.0,5.793763288447917,-0.07138413685847589,4.745401142847506,4.745401142847506,593.675,548.35,666.688539673556,564.4,669.4,0,561.0,2.229849826465665,1079475.7154481593
2014-06-13,610.3,597.1,619.1,594.9,7550.0,1237.6,0.1,616.8,54.30401058895827,-8.911533919436948,693.3296642104773,554.1803357895227,609.6968352405314,22.48243559718962,28.03944806508943,11962440.0,-0.3266372693124286,0.0221068497739072,4.59437130347197,4.59437130347197,592.575,548.35,663.6649980866138,564.4,669.4,0,562.0,2.231044692061171,1090588.3691339272
2014-06-14,583.4,610.3,613.8,563.7,5000.0,1237.6,0.1,596.9333333333333,47.72101423409227,-11.722655623929242,692.1936266271907,556.6163733728092,607.1923747414332,17.464539007092146,29.615201774725897,11957440.0,-7.087115782767957,-0.04407668359823036,5.076311582914964,5.076311582914964,585.325,548.35,660.7623981631492,564.4,669.4,0,563.0,2.2322037017867955,1101529.120357778
2014-06-15,582.3,583.4,587.8,560.8,3940.0,1237.6,0.1,592.0,47.46760982812413,-13.276919751722417,692.1712095833032,556.6687904166968,604.8216723851062,18.58254105445116,29.42840164795976,11953500.0,-10.387811634349031,-0.0018854988001372197,5.05382133744801,5.05382133744801,595.5,548.35,654.9386542733603,564.4,669.4,0,564.0,2.2333577898800177,1112540.4381514112
2014-06-16,599.1,582.3,606.1,580.5,3990.0,1237.6,0.1,588.2666666666665,51.68717955787973,-12.789335837844476,690.0564814427515,561.6835185572485,604.2767512055723,33.10285220397584,29.154944387391204,11957490.0,-8.604118993135009,0.02885110767645549,4.8664570835238194,4.8664570835238194,596.45,548.35,647.4075619314915,564.4,669.4,0,565.0,2.2345286069722126,1123798.997461709
2014-06-17,605.1,599.1,608.4,594.9,3000.0,1237.6,0.1,595.5,53.13500509672288,-11.707602368916515,687.4838906408181,567.6861093591817,604.3551558526606,40.642201834862455,28.03673407400612,11960490.0,-9.605616970421266,0.01001502253380071,4.6334050692457645,4.6334050692457645,602.675,548.35,640.4789569769722,564.4,669.4,0,566.0,2.23570293397441,1135201.0594466017
2014-06-18,606.2,605.1,614.4,603.6,3310.0,1237.6,0.1,603.4666666666667,53.41066050198538,-10.596196284097136,683.1857419122618,576.1642580877381,604.5308552952644,43.40344168260046,26.80553878300568,11963800.0,-5.118171857880722,0.0018178813419269524,4.421896862917466,4.421896862917466,602.675,548.35,634.1046404188144,564.4,669.4,0,567.0,2.2368749561595322,1146700.2309265654
2014-06-19,600.2,606.2,612.6,598.7,5600.0,1237.6,0.1,603.8333333333334,51.62689725122309,-9.953408260352735,683.6164242641137,574.5235757358862,604.1183928861916,38.25242718446611,25.883714584219558,11958200.0,-9.088155104513783,-0.00989772352358953,4.312514925728016,4.312514925728016,605.2,548.35,628.2402691853092,564.4,669.4,0,568.0,2.238036306491462,1158226.6841483854
2014-06-20,590.8,600.2,602.0,587.1,2150.0,1237.6,0.1,599.0666666666666,48.87304912654428,-9.83233119519829,684.2605353204849,570.1694646795152,602.8499745160781,29.354207436399204,25.099163542489585,11956050.0,-9.163591635916363,-0.0156614461846053,4.248335061355719,4.248335061355719,609.0999999999999,548.35,622.8450476504845,564.4,669.4,0,569.0,2.2391828621561327,1169743.83027127
2014-06-21,597.0,590.8,599.2,584.8,2280.0,1237.6,0.1,596.0,50.73947818528799,-9.026634084267492,682.0805432110739,567.0694567889262,602.2928340859754,35.42074363992175,24.334937575168908,11958330.0,-8.393432560994329,0.010494245091401622,4.076203948939516,4.076203948939516,602.925,548.35,617.8814438384458,564.4,669.4,0,570.0,2.2403333069923583,1181409.5011053844
2014-06-22,603.6,597.0,610.1,592.0,2040.0,1237.6,0.1,597.1333333333333,52.71823404022144,-7.787965775339144,678.3419588020205,565.6180411979793,602.4173260777873,41.8786692759296,23.889584891228274,11960370.0,-7.281105990783407,0.011055276381909618,3.9578503795938165,3.9578503795938165,602.3499999999999,548.35,613.3149283313701,564.4,669.4,0,571.0,2.2414880245099367,1193229.1889007916
2014-06-23,591.2,603.6,604.7,582.9,2650.0,1237.6,0.1,597.2666666666667,48.75563225738651,-7.5376378102985075,671.5047115646809,564.635288435319,601.3490093084743,29.745596868884615,23.74032882756912,11957720.0,-8.241502405711612,-0.02054340622929085,4.0156171900489035,4.0156171900489035,602.3499999999999,548.35,610.1,564.4,669.4,0,572.0,2.242624463940897,1205007.6167382542
2014-06-24,588.8,591.2,595.7,585.4,3080.0,1237.6,0.1,594.5333333333333,48.003546880853726,-7.264548591593565,669.553305215117,561.5766947848829,600.1538655648101,27.39726027397259,22.780305339885615,11954640.0,-10.189139719341071,-0.004059539918809363,3.8689377275620953,3.8689377275620953,608.05,548.35,610.1,564.4,669.4,0,573.0,2.2437545155221383,1216846.3941182587
2014-06-25,568.5,588.8,589.6,566.9,3090.0,1237.6,0.1,582.8333333333334,42.08949003022382,-8.117287654782295,664.6010257268601,557.3589742731397,597.1392117014948,9.277108433734995,22.774569244179503,11951550.0,-11.586314152410575,-0.03447690217391297,4.00608078173782,4.00608078173782,604.65,548.35,606.1560000000001,568.5,669.4,0,574.0,2.244856210932457,1228548.7312976932
2014-06-26,582.7,568.5,582.7,565.8,4150.0,1237.6,0.1,579.9999999999999,47.00764674300583,-7.410761741134019,659.3496703206638,555.8403296793363,595.7640486823047,37.56432246998296,22.354957155309542,11955700.0,-2.4116563389716927,0.024978012313104703,3.8364436511600375,3.8364436511600375,604.375,548.35,602.5275200000001,568.5,669.4,0,575.0,2.2459719580885555,1240490.9228637263
2014-06-27,602.2,582.7,603.9,580.1,3390.0,1237.6,0.1,584.4666666666666,52.92062900004919,-5.408831760574136,652.773062860645,557.4669371393552,596.3769964268472,77.23880597014939,22.458174501358858,11959090.0,-1.3272161232180746,0.03346490475373254,3.729354782689946,3.729354782689946,603.925,550.0,560.8,568.5,669.4,0,576.0,2.2471075546103485,1252730.6226568373
2014-06-28,597.6,602.2,608.8,594.0,2940.0,1237.6,0.1,594.1666666666666,51.46185925861593,-4.225589960963696,645.2590411011572,559.6409588988429,596.4934729576237,68.65671641791054,21.911162036976076,11956150.0,2.434007541995208,-0.007638658253072084,3.666526445277121,3.666526445277121,603.3,552.75,561.6619999999999,568.5,669.4,0,577.0,2.2482342372742576,1265009.6915286772
2014-06-29,601.1,597.6,604.3,593.2,2890.0,1237.6,0.1,600.3,52.533969775856356,-3.090959491703593,638.552665876812,562.027334123188,596.9321898188024,72.63374485596718,21.13893617719206,11959040.0,3.2285763352224057,0.005856760374832737,3.516708730193322,3.516708730193322,601.625,552.75,563.54752,568.5,669.4,0,578.0,2.249361579143356,1277415.8585927694
2014-06-30,635.1,601.1,637.3,596.5,3830.0,1237.6,0.1,611.2666666666665,61.44341291228904,-0.09279319827851928,632.2852528760842,566.2447471239158,600.5672193598688,96.92307692307702,22.543297878821196,11962870.0,6.009013520280421,0.056562967892197724,3.5495666633319467,3.5495666633319467,607.3249999999999,552.75,565.3576191999999,568.5,669.4,0,579.0,2.250524318003995,1290276.5453513986
2014-07-01,643.2,635.1,652.5,634.1,4110.0,1237.6,0.1,626.4666666666667,63.21487036185684,2.2635664172999848,632.3483049452357,566.2016950547643,604.6274841827384,89.27335640138413,22.247348030333967,11966980.0,6.2964799206742725,0.012753897024090799,3.458853860437495,3.458853860437495,610.7249999999999,552.75,569.674162048,568.5,669.4,0,580.0,2.251692463404066,1303318.6702792435
2014-07-02,645.7,643.2,652.1,604.6,4780.0,1237.6,0.1,641.3333333333334,63.76817213009791,3.7315917332012543,640.4391438526859,562.9708561473142,608.5391523558109,92.1568627450981,24.05110888531011,11971760.0,6.5160013196964695,0.003886815920397968,3.724811659487395,3.724811659487395,610.525,553.35,576.3002290841599,568.5,645.7,0,581.0,2.2528597974735645,1316485.5617884074
2014-07-03,638.0,645.7,646.4,633.6,4010.0,1237.6,0.1,642.3000000000001,60.73787801720053,3.906424783780368,644.8195051492414,561.3604948507584,611.3449473695432,83.27566320645906,23.2474582506451,11967750.0,6.297900699766737,-0.01192504258943794,3.6438022336434326,3.6438022336434326,610.525,554.6,582.3962107574272,568.5,645.7,0,582.0,2.2540151322062547,1329670.072515729
2014-07-04,624.0,638.0,642.2,623.0,3600.0,1237.6,0.1,635.9,55.56748508587392,2.850590124021517,646.7706230445666,563.4693769554334,612.5501904772058,67.12802768166091,22.95835408988474,11964150.0,5.619498984427902,-0.021943573667711602,3.679223411840503,3.679223411840503,610.525,555.2,588.004513896833,568.5,645.7,0,583.0,2.2551513229165066,1342800.219952564
2014-07-05,623.0,624.0,627.8,619.7,3250.0,1237.6,0.1,628.3333333333334,55.20598637265647,1.9018779410889408,648.1183726638883,566.1916273361117,613.5454104317577,65.97462514417533,21.897043083464393,11960900.0,4.355108877721943,-0.0016025641025640969,3.5147741707005444,3.5147741707005444,614.0999999999999,556.9,593.1641527850863,568.5,645.7,0,584.0,2.2562829119418892,1356015.2746765665
2014-07-06,626.7,623.0,629.4,622.7,2700.0,1237.6,0.1,624.5666666666666,56.337807919379195,1.3656493670306862,650.1739853382693,566.8960146617309,614.798228485876,70.24221453287204,20.811540006074072,11963600.0,3.827037773359845,0.005939004815409321,3.320813787469933,3.320813787469933,617.375,556.9,597.9110205622794,568.5,645.7,0,585.0,2.257415205502523,1369368.0743212427
2014-07-07,613.6,626.7,627.9,607.3,2530.0,1237.6,0.1,621.1,51.38710999065782,0.04081817252048481,650.623576418745,567.2964235812551,614.6841114872212,55.1326412918109,20.79643000564021,11961070.0,3.7889039242219176,-0.020903143449816586,3.389248697138235,3.389248697138235,614.75,556.9,602.278138917297,568.5,645.7,0,586.0,2.258529191237121,1382668.7391868306
2014-07-08,615.3,613.6,619.7,609.3,3210.0,1237.6,0.1,618.5333333333333,51.97687527856206,-0.7644356346917718,651.1467756631635,567.6832243368365,614.7427675360574,57.093425605536304,20.0538278623802,11964280.0,4.500679347826087,0.0027705345501953804,3.259195166972241,3.259195166972241,615.575,556.9,606.2958878039133,568.5,645.7,0,587.0,2.2596417017709327,1396084.2446637712
2014-07-09,623.0,615.3,623.8,610.5,3070.0,1237.6,0.1,617.3,54.65997030642272,-0.8171673798927657,652.4628739618298,568.6471260381703,615.5291706278615,65.97462514417533,19.571411586495895,11967350.0,9.586631486367635,0.012514220705347023,3.141478585312343,3.141478585312343,617.5999999999999,556.9,607.3,568.5,645.7,0,588.0,2.26075952881588,1409685.1349988095
2014-07-10,618.4,623.0,625.0,611.7,3610.0,1237.6,0.1,618.9,52.76339470617279,-1.1785633653839565,652.9582751008572,570.9117248991427,615.8025829490176,52.9005524861878,19.1234536160319,11963740.0,6.126651793375653,-0.007383627608346766,3.0924084113893757,3.0924084113893757,617.5,556.9,609.3,568.5,645.7,0,589.0,2.261868736219812,1423329.8498156678
2014-07-11,632.9,618.4,633.6,616.1,3120.0,1237.6,0.1,624.7666666666667,57.74094239249225,-0.49287557890518663,655.1222263233161,572.3377736766839,617.4309083824445,66.94772344013484,19.007492643458193,11966860.0,5.097974094985043,0.023447606727037495,3.0032378959485215,3.0032378959485215,618.0,579.1,610.5,568.5,645.7,0,590.0,2.2629907882966913,1437241.7305653468
2014-07-12,635.9,632.9,638.6,625.9,3430.0,1237.6,0.1,629.0666666666666,58.71037064090489,0.08037937288785102,657.5428897576719,573.1471102423282,619.1898694888783,72.00674536256317,18.556957454639754,11970290.0,6.408969210174022,0.004740085321535803,2.9182194456109065,2.9182194456109065,616.95,581.0,611.7,568.5,645.7,0,591.0,2.264112727695814,1451289.0845074127
2014-07-13,628.0,635.9,638.6,627.5,1700.0,1237.6,0.1,632.2666666666665,55.12421758700265,-0.14268310620825275,658.2039358711394,576.1660641288607,620.0289295375567,56.25,18.0243176364512,11968590.0,4.475128930294456,-0.012423337002673396,2.870114273320255,2.870114273320255,616.05,593.45,614.964,568.5,645.7,0,592.0,2.2652224946235275,1465344.4963320503
2014-07-14,618.3,628.0,629.0,616.1,2550.0,1237.6,0.1,627.4,51.00463714662796,-0.9677152112170351,657.5567556487767,579.7632443512234,619.8642695815988,28.60125260960321,17.658294948133257,11966040.0,-2.64525271610771,-0.01544585987261149,2.8559428995848712,2.8559428995848712,616.05,593.45,652.5,568.5,645.7,0,593.0,2.2663179790133348,1479382.7753226983
2014-07-15,619.6,618.3,624.4,617.3,3690.0,1237.6,0.1,621.9666666666666,51.52746960582442,-1.4226007487034353,652.5808588277231,589.849141172277,619.8391010500179,31.57894736842105,16.904131023266597,11969730.0,-3.669154228855725,0.0021025392204432336,2.728232895943608,2.728232895943608,616.05,598.5,651.772,568.5,645.7,0,594.0,2.2674115694433548,1493535.5871589568
2014-07-16,614.8,619.6,622.4,614.2,3000.0,1237.6,0.1,617.5666666666666,49.430069185836125,-2.007685091478576,648.9936967201933,596.6463032798066,619.359186664302,19.18158567774935,16.28240737874755,11966730.0,-4.785504104073112,-0.007746933505487497,2.6484071858730562,2.6484071858730562,616.55,615.9,651.05856,614.8,645.7,0,595.0,2.2684963719982894,1507727.9058633747
2014-07-17,626.6,614.8,632.5,610.0,2920.0,1237.6,0.1,620.3333333333334,54.349486396521606,-1.579755295174686,648.4721427631852,599.6078572368148,620.0487879343685,55.30085959885392,16.72652113740844,11969650.0,-1.7868338557993695,0.019193233571893398,2.669409693170833,2.669409693170833,616.7249999999999,615.9,649.5842176000001,614.8,645.7,0,596.0,2.269591109942408,1522165.9267699665
2014-07-18,627.5,626.6,630.2,617.9,3350.0,1237.6,0.1,622.9666666666667,54.71135905460874,-1.2313326026272264,646.7616130129296,604.3083869870705,620.7584271787143,64.53674121405751,16.410341056164985,11973000.0,0.5608974358974359,0.0014363230130864935,2.615193793811153,2.615193793811153,616.7249999999999,617.1,647.2091645440001,614.8,645.7,0,597.0,2.2706834961613884,1536716.5383450463
2014-07-19,627.0,627.5,634.1,625.1,3960.0,1237.6,0.1,627.0333333333333,54.45310631333737,-1.0375465889606463,644.8543280041358,608.8056719958643,621.3528626855034,62.93929712460065,15.88103098072463,11969040.0,0.6420545746388443,-0.0007968127490040056,2.5328598055382185,2.5328598055382185,616.7249999999999,617.1,644.9766146713602,614.8,645.7,0,598.0,2.2717719812658723,1551362.8022526775
2014-07-20,621.0,627.0,627.9,620.0,2300.0,1237.6,0.1,625.1666666666666,51.322413624558465,-1.2994748053055858,643.9015997873798,608.3484002126202,621.3192567154555,43.76996805111826,15.310957339244297,11966740.0,-0.9095260890378243,-0.009569377990430672,2.4655325828090655,2.4655325828090655,616.7249999999999,618.65,642.8780177910785,614.8,645.7,0,599.0,2.2728504337272635,1566034.8021878402
2014-07-21,625.1,621.0,625.9,615.0,2530.0,1237.6,0.1,624.3666666666667,53.29832528396121,-1.185784991956968,641.1771426013767,609.2628573986234,621.6793275044597,53.92491467576802,14.9958889578697,11969270.0,1.874185136897001,0.006602254428341503,2.3989583999151654,2.3989583999151654,616.7249999999999,618.65,640.9053367236138,614.8,645.7,0,600.0,2.2739301551911866,1580860.838822997
2014-07-22,622.5,625.1,628.8,620.0,3280.0,1237.6,0.1,622.8666666666667,51.860682817130304,-1.2675005861283042,636.9767178493868,611.1432821506133,621.7574867897494,43.70629370629367,14.553325460879005,11965990.0,1.170160897123362,-0.004159334506478984,2.337883608173334,2.337883608173334,619.175,618.65,639.051016520197,614.8,645.7,0,601.0,2.2750036656826573,1595755.641550872
2014-07-23,621.7,622.5,625.0,621.0,2170.0,1237.6,0.1,623.1,51.40126015011345,-1.349648152529583,634.4892829918438,612.0007170081565,621.7520118573923,40.909090909091034,13.799516499387648,11963820.0,-0.20866773675761707,-0.001285140562248932,2.2196423515180386,2.2196423515180386,622.45,618.65,637.3079555289852,614.8,645.7,0,602.0,2.276072985903014,1610742.225631645
2014-07-24,601.9,621.7,622.0,599.4,4740.0,1237.6,0.1,615.3666666666667,41.58271911785489,-2.637219650972873,636.7193552669747,607.5606447330255,619.8613440614502,6.377551020408156,14.428122463717104,11959080.0,-2.668175937904269,-0.03184815827569576,2.39709627242351,2.39709627242351,619.8,618.65,635.6694781972461,614.8,645.7,0,603.0,2.2771165380304135,1625564.7479180768
2014-07-25,600.5,601.9,609.1,597.4,5920.0,1237.6,0.1,608.0333333333333,40.98655999881381,-3.4325751202342243,638.3644985518505,603.6655014481497,618.0174065317882,7.524271844660241,14.2332565734516,11953160.0,-5.119292147258648,-0.0023259677687322844,2.3702342337138385,2.3702342337138385,620.125,615.3,632.7679199414664,614.8,645.7,0,604.0,2.278155244128638,1640466.2970568903
2014-07-26,596.0,600.5,603.0,593.3,3480.0,1237.6,0.1,599.4666666666667,39.04868873399185,-4.067736495049307,639.7350339422242,599.2249660577759,615.9205106716179,5.960264900662343,13.909452532490775,11949680.0,-6.274571473502119,-0.007493755203996644,2.3338007604850293,2.3338007604850293,618.3,613.0999999999999,629.2311279473198,614.8,645.7,0,605.0,2.2791855152863167,1655403.204919862
2014-07-27,595.0,596.0,601.5,593.7,3530.0,1237.6,0.1,597.1666666666666,38.61179520018937,-4.336562088466147,641.3479385033088,595.7520614966911,613.9280810838447,4.166666666666771,13.473063065884288,11946150.0,-5.254777070063694,-0.001677852348993314,2.2643803472074433,2.2643803472074433,618.2,612.3,624.9193925936414,614.8,645.7,0,606.0,2.2802114251044774,1670423.5596704572
2014-07-28,587.9,595.0,597.5,578.1,2330.0,1237.6,0.1,592.9666666666666,35.56892818166395,-4.7410870764775455,643.5998864494277,590.7601135505724,611.4492162187167,17.49999999999992,13.896415704035409,11943820.0,-4.91670710011321,-0.011932773109243788,2.363738000346217,2.363738000346217,607.85,611.9,621.1250654824045,614.8,645.7,0,607.0,2.2812258332537443,1685439.3668917725
2014-07-29,585.8,587.9,591.3,579.5,6720.0,1237.6,0.1,589.5666666666666,34.69793992590546,-4.879565732210418,644.8892137196889,585.750786280311,609.0064337216961,13.749999999999877,13.746671725175734,11937100.0,-5.455132343447397,-0.003572036060554562,2.346649321470764,2.346649321470764,606.8000000000001,611.9,615.1015563148678,614.8,645.7,0,608.0,2.2822346044976634,1700520.7785199524
2014-07-30,564.6,585.8,586.1,564.2,4100.0,1237.6,0.1,579.4333333333333,27.402745811465834,-6.051828282665459,649.4810569726383,575.7789430273617,604.7772495577251,0.5722460658082652,14.329052316234609,11933000.0,-8.165256994144427,-0.03618982587913955,2.5379122062052084,2.5379122062052084,598.95,611.9,609.9213384307864,614.8,645.7,0,609.0,2.2832147307601645,1715379.1568025309
2014-07-31,589.5,564.6,593.7,564.0,3520.0,1237.6,0.1,579.9666666666666,42.65341475428875,-4.8548069678337615,647.3922298270849,573.527770172915,603.3222734093703,36.376604850213965,15.426977150789282,11936520.0,-5.920842642834347,0.04410201912858658,2.6169596523815577,2.6169596523815577,597.9,611.9,602.6059242818606,614.8,645.7,0,610.0,2.2842216068391834,1730705.6058404676
2014-08-01,598.8,589.5,604.0,586.4,8930.0,1237.6,0.1,584.3000000000001,47.12144934475381,-3.2200047306533017,643.9317306724046,573.2782693275952,602.891580703716,49.64336661911547,15.58219306859005,11945450.0,-4.573705179282875,0.01577608142493636,2.602236651401144,2.602236651401144,597.15,611.9,564.0,614.8,598.8,1,611.0,2.2852361592176385,1746267.357020239
2014-08-02,591.7,598.8,598.9,587.4,2120.0,1237.6,0.1,593.3333333333334,44.28468900328812,-2.43577957171458,641.671565331857,571.908434668143,601.8257158747907,42.74691358024701,15.290607849405045,11943330.0,-5.629984051036676,-0.011857047428189604,2.5841824994769382,2.5841824994769382,593.925,606.65,564.0,614.8,598.8,0,612.0,2.2862393268580057,1761823.222735481
2014-08-03,588.9,591.7,592.1,580.6,1260.0,1237.6,0.1,593.1333333333333,43.180667023892404,-1.945822436936342,640.6129794718526,570.0270205281473,600.5946953152868,38.42592592592592,15.019850145876115,11942070.0,-5.169082125603868,-0.004732127767449801,2.55049246830975,2.55049246830975,592.65,606.65,564.8,614.8,598.8,0,613.0,2.2872360975635058,1777435.2265942115
2014-08-04,592.8,588.9,595.1,586.5,3420.0,1237.6,0.1,591.1333333333333,45.22884312236348,-1.2339778908920858,639.0367882157024,568.9232117842977,599.8523433804975,44.44444444444441,14.561289421170681,11945490.0,-5.167173252279646,0.0066225165562914245,2.456357864569953,2.456357864569953,592.65,606.65,565.584,614.8,598.8,0,614.0,2.288234309622666,1793204.9794015458
2014-08-05,588.8,592.8,594.3,585.4,4090.0,1237.6,0.1,590.1666666666666,43.496992384762855,-0.9217217404488851,637.9630044072298,567.3969955927703,598.7997392490215,40.65573770491796,14.156911605372773,11941400.0,-5.413654618473903,-0.006747638326585648,2.4043667808038,2.4043667808038,592.65,606.65,566.35232,614.8,598.8,0,615.0,2.2892247476060574,1809012.5312049957
2014-08-06,589.8,588.8,593.8,587.2,3010.0,1237.6,0.1,590.4666666666666,44.07354239406297,-0.5550997290599158,634.7530299442647,566.9269700557352,597.9426212253052,44.48275862068958,13.617132204988996,11944410.0,-5.131092166639873,0.0016983695652172948,2.3087711436061373,2.3087711436061373,592.65,608.25,567.1052735999999,614.8,598.8,0,616.0,2.2902132624214917,1824934.3435044358
2014-08-07,592.8,589.8,595.1,587.9,2500.0,1237.6,0.1,590.4666666666666,45.85839549472423,-0.04472066872008096,630.8670827402831,567.342917259717,597.452847775276,63.858093126385675,13.158765618918355,11946910.0,-1.5118790496760297,0.0050864699898269805,2.219764780519291,2.219764780519291,592.65,608.25,567.8431681279999,614.8,598.8,0,617.0,2.291202182637711,1841002.2742413825
2014-08-08,595.8,592.8,608.2,592.1,3110.0,1237.6,0.1,592.8,47.65737152664621,0.5291095386109941,626.625128954332,568.4648710456679,597.2954337014402,71.9457013574659,13.368853788995619,11950020.0,-0.7826810990841041,0.005060728744939347,2.243849242865999,2.243849242865999,592.575,608.25,568.5663047654399,614.8,598.8,0,618.0,2.2921914897894076,1857217.4660838332
2014-08-09,589.5,595.8,595.6,587.4,1420.0,1237.6,0.1,592.6999999999999,44.326472948600475,0.5179183467747741,623.1480867612232,568.7919132387768,596.5530114441601,57.69230769230763,13.013935661210215,11948600.0,-1.0906040268456376,-0.010574018126888185,2.207622673657373,2.207622673657373,596.725,608.25,570.1516525748223,614.8,598.8,0,619.0,2.2931704114518,1873433.9385836595
2014-08-10,592.1,589.5,596.6,588.1,1340.0,1237.6,0.1,592.4666666666666,46.00377846657019,0.7074305037578688,618.006333612456,570.6336663875438,596.1289151161449,63.57466063348415,12.691511685409486,11949940.0,-0.4873949579831895,0.004410517387616553,2.1434743599745794,2.1434743599745794,596.725,608.25,571.6735864718294,614.8,598.8,0,620.0,2.2941492961148002,1889792.0215210363
2014-08-11,575.9,592.1,593.6,571.7,2570.0,1237.6,0.1,585.8333333333334,38.267680968190646,-0.18857936590086943,613.1645979891132,570.8154020108868,594.20235177175,26.923076923076845,13.349260850737378,11947370.0,-2.0411634631740094,-0.027360243202161905,2.3179824363148773,2.3179824363148773,594.5,608.25,608.2,614.8,598.8,0,621.0,2.2951060911999748,1905985.9324647812
2014-08-12,567.7,575.9,578.3,562.0,3330.0,1237.6,0.1,578.5666666666667,35.0543607671906,-1.2070319727868117,608.2812506170748,570.2987493829252,591.6783182696787,12.337662337662424,13.560027932827563,11944040.0,-3.089791737794454,-0.014238583087341383,2.3885904408715097,2.3885904408715097,591.575,607.25,607.47,614.8,598.8,0,622.0,2.2960500449597814,1922138.7845058932
2014-08-13,542.1,567.7,573.5,523.2,4820.0,1237.6,0.1,561.9,27.33679620838275,-3.3565166270946083,613.4750620974548,559.1249379025451,586.9565736725664,22.235294117647033,16.184311651911305,11939220.0,-3.9851222104144526,-0.045094239915448364,2.985484532726675,2.985484532726675,572.1750000000001,587.85,605.6512,614.8,598.8,0,623.0,2.2969594030898324,1937939.144385648
2014-08-14,504.8,542.1,544.9,495.9,10880.0,1237.6,0.1,538.1999999999999,20.317878772586184,-6.841247205880519,625.5038747298736,537.5261252701264,579.132138084703,7.925200356188806,18.528289391060497,11928340.0,-14.368108566581848,-0.0688064932669249,3.6704218286569925,3.6704218286569925,557.1999999999999,574.2,600.704128,614.8,598.8,1,624.0,2.2978170426864524,1953131.620484207
2014-08-15,496.5,504.8,515.2,483.2,4770.0,1237.6,0.1,514.4666666666667,19.140209995855415,-9.113903889996582,633.4571819400828,519.6228180599171,571.2624106480647,10.640000000000004,19.490554434556177,11923570.0,-17.08416833667334,-0.016442155309033257,3.9255900170304487,3.9255900170304487,550.85,567.85,592.3197977599999,614.8,598.8,0,625.0,2.2986605384714416,1968240.012739099
2014-08-16,522.0,496.5,524.3,483.2,3870.0,1237.6,0.1,507.76666666666665,32.151788127644465,-8.329910252382822,633.8247487071251,511.95525129287495,566.5707524911061,31.039999999999992,21.034086260659308,11927440.0,-11.779618049687349,0.051359516616314105,4.029518440739331,4.029518440739331,550.85,567.85,581.407817984,614.8,598.8,0,626.0,2.2995355111626345,1983921.7332007634
2014-08-17,485.5,522.0,524.7,478.2,3140.0,1237.6,0.1,501.3333333333333,25.761671670223464,-9.608875258500248,639.1179390031728,496.4220609968272,558.849728444334,5.615384615384622,22.853080099183646,11924300.0,-17.558159280013584,-0.06992337164750961,4.707122574497147,4.707122574497147,544.5,565.35,571.5870361855999,614.8,598.8,0,627.0,2.300358121509933,1998963.6099646841
2014-08-18,462.2,485.5,493.3,450.0,6380.0,1237.6,0.1,489.90000000000003,22.66492507080619,-11.249523584564951,645.8618671918479,477.3181328081522,549.6449924020164,7.711757269279384,24.313574377813385,11917920.0,-22.03103913630229,-0.047991761071060735,5.260401206796492,5.260401206796492,529.65,551.25,560.3805918433279,462.2,598.8,0,628.0,2.3011444264461276,2013585.3172911135
2014-08-19,485.1,462.2,487.0,455.8,5120.0,1237.6,0.1,477.59999999999997,31.393817249123188,-10.056846504137237,648.2068158555198,467.0231841444801,543.4978502684911,22.187104930467772,24.805461922255287,11923040.0,-17.612092391304337,0.0495456512332324,5.113473906875961,5.113473906875961,525.675,551.25,544.927308985262,462.2,598.8,0,629.0,2.301961082855773,2028764.0417332158
2014-08-20,516.8,485.1,521.8,468.5,5890.0,1237.6,0.1,488.0333333333333,41.275100794419025,-6.566301023847014,644.9957480879019,462.9642519120982,540.9551978619681,42.225031605562535,26.84078607066562,11928930.0,-12.377076975245847,0.0653473510616367,5.193650555469354,5.193650555469354,521.625,551.25,531.6374857273254,462.2,598.8,0,630.0,2.3028181991391117,2044661.9457925672
2014-08-21,517.9,516.8,537.2,511.4,5650.0,1237.6,0.1,506.5999999999999,41.589483940270455,-3.756330894122307,639.8071597604085,460.0628402395914,538.7594647322569,42.92035398230086,26.766444208475225,11934580.0,-12.634952766531713,0.002128482972136192,5.168264956260905,5.168264956260905,520.425,551.25,450.0,462.2,517.9,0,631.0,2.3036739786679674,2060664.531740034
2014-08-22,516.1,517.9,524.4,500.6,6030.0,1237.6,0.1,516.9333333333333,41.20079066315593,-1.696745273787979,635.036662338192,457.27333766180794,536.601420472042,45.088676671214195,26.554555336441275,11928550.0,-13.376972138301433,-0.0034755744352190643,5.145234515877014,5.145234515877014,513.275,551.05,451.744,462.2,517.9,0,632.0,2.3045246064727265,2076714.3788416611
2014-08-23,497.7,516.1,516.8,494.0,3130.0,1237.6,0.1,510.56666666666666,37.35727473494612,-1.2709590017757186,630.5945837068937,452.5954162931064,532.8965232842285,32.53751705320599,26.286372812409752,11925420.0,-15.57251908396947,-0.03565200542530522,5.2815697834859865,5.2815697834859865,511.35,548.2,453.45312,462.2,517.9,0,633.0,2.3053477608634556,2092469.0766440353
2014-08-24,509.7,497.7,514.8,496.8,2530.0,1237.6,0.1,507.8333333333333,41.209222963778906,0.05142682341476501,624.2209748735305,450.6590251264694,530.6873305904924,41.573816155988844,25.694489040094766,11927950.0,-13.916568147272427,0.024110910186859513,5.041100459112177,5.041100459112177,511.35,546.1,455.12805760000003,462.2,517.9,0,634.0,2.3061844073206426,2108551.4688167837
2014-08-25,502.9,509.7,511.3,499.7,2740.0,1237.6,0.1,503.43333333333334,39.71877111126452,0.6665729365167827,617.8101161931544,448.4798838068456,528.0409181533026,41.231488698363215,24.68773982294514,11925210.0,-12.675811772877235,-0.013341181086913845,4.909075327688436,4.909075327688436,511.35,544.3,456.76949644800004,462.2,517.9,0,635.0,2.307009190437699,2124573.324521804
2014-08-26,512.6,502.9,516.0,501.8,3530.0,1237.6,0.1,508.3999999999999,42.89176868800627,1.8576601222976947,610.2235266730272,448.346473326973,526.5703545196548,50.68825910931176,23.93861554987763,11928740.0,-9.70583054430157,0.01928812885265474,4.670038148630049,4.670038148630049,511.35,544.3,458.37810651904005,462.2,517.9,0,636.0,2.3078442388980465,2140877.811846033
2014-08-27,515.2,512.6,527.4,512.7,3790.0,1237.6,0.1,510.23333333333335,43.74648812575752,2.8899578598538795,601.0599661291333,449.7500338708667,525.487463613021,68.7038988408852,23.285857296314937,11932530.0,-4.962184098874742,0.005072181037846235,4.519770437949328,4.519770437949328,512.8,544.3,459.95454438865926,462.2,517.9,0,637.0,2.308679993092768,2157318.750586453
2014-08-28,510.8,515.2,521.6,503.3,4470.0,1237.6,0.1,512.8666666666667,42.584919916264475,3.3153042490672178,589.7333777877568,452.5766222122432,524.088657554638,69.7247706422018,22.929724632292444,11928060.0,1.1885895404120443,-0.008540372670807539,4.4889828959069,4.4889828959069,515.975,544.3,461.4994535008861,462.2,517.9,0,638.0,2.3095072027811563,2173750.2682559616
2014-08-29,512.6,510.8,515.2,506.7,3640.0,1237.6,0.1,512.8666666666667,43.248787072205516,3.726041197835521,578.3369415914012,456.28305840859895,522.9944996922915,71.78899082568806,21.89903001570013,11931700.0,3.2426988922457247,0.0035238841033673474,4.272147876648484,4.272147876648484,522.35,544.3,463.0134644308684,462.2,517.9,0,639.0,2.3103340887615977,2190301.9234594125
2014-08-30,506.0,512.6,512.9,503.1,2630.0,1237.6,0.1,509.8,41.360379069254485,3.5615289451407612,563.5720831668218,462.43791683317824,521.3759759120733,64.2201834862385,21.03481358600726,11929070.0,-3.065134099616858,-0.012875536480686733,4.157077783795901,4.157077783795901,519.9,544.3,464.49719514225103,462.2,517.9,0,640.0,2.311149492161608,2206794.374207327
2014-08-31,481.8,506.0,508.3,478.3,6100.0,1237.6,0.1,500.1333333333334,35.27789861721122,1.9137773134477811,551.5674935719676,465.0325064280325,517.6068353490186,36.46788990825687,21.6751840441496,11922970.0,-0.7621009268795033,-0.047826086956521685,4.498792869271399,4.498792869271399,515.975,544.3,465.951251239406,462.2,517.9,0,641.0,2.311929044331347,2222827.9564356296
2014-09-01,477.2,481.8,487.5,471.8,6790.0,1237.6,0.1,488.3333333333333,34.24693101151277,0.6692021626458882,539.5233356255957,468.0266643744043,513.7585653157788,26.28992628992625,21.2483851838532,11916180.0,3.245348334054522,-0.009547530095475376,4.452721119835122,4.452721119835122,514.35,544.3,467.3762262146179,462.2,517.9,0,642.0,2.312699501817974,2238829.0596686886
2014-09-02,478.9,477.2,487.0,470.5,6750.0,1237.6,0.1,479.3,35.00291391092797,0.14309894016496472,533.2951637082836,467.9348362917163,510.43870195237133,15.13828238719064,20.909214813577968,11922930.0,-1.2780869923727158,0.003562447611064501,4.366092047103355,4.366092047103355,514.025,544.3,468.7727016903255,462.2,517.9,0,643.0,2.3134697777824296,2254942.3611424468
2014-09-03,480.0,478.9,487.3,476.8,6140.0,1237.6,0.1,478.7,35.51951189504136,0.05628245378710872,533.1882444465215,465.5617555534786,507.5397779569074,14.24287856071963,20.16569946975097,11929070.0,-7.120743034055719,0.002296930465650604,4.2011873895314515,4.2011873895314515,511.125,542.05,470.141247656519,462.2,517.9,0,644.0,2.3142390206900965,2271154.4703379734
2014-09-04,491.0,480.0,498.5,476.3,8810.0,1237.6,0.1,483.3,40.60349819024252,0.8810200395715171,533.0912930027707,465.10870699722926,505.96456100863054,36.02811950790863,20.311006650483044,11937880.0,-5.194052905966399,0.022916666666666696,4.136661232277606,4.136661232277606,511.125,542.05,470.5,462.2,517.9,0,645.0,2.3150209800395016,2287696.080178613
2014-09-05,483.6,491.0,495.0,483.1,6040.0,1237.6,0.1,484.8666666666666,38.40948967043067,1.0576149138619222,530.1015795489858,464.25842045101416,503.83460281733244,23.022847100175795,19.710220461162827,11931840.0,-6.297229219143577,-0.01507128309572292,4.075727969636647,4.075727969636647,508.92499999999995,542.05,471.834,462.2,517.9,0,646.0,2.3157900929075685,2304141.516721725
2014-09-06,484.5,483.6,491.4,480.8,3790.0,1237.6,0.1,486.3666666666666,38.84232361004149,1.3459851894438977,530.1253390647861,464.13466093521384,501.9932120728246,24.60456942003516,19.059490428222624,11935630.0,-2.6522001205545487,0.0018610421836227076,3.9338473536063208,3.9338473536063208,503.5,542.05,473.14132,462.2,517.9,0,647.0,2.316557884885131,2320682.7400452956
2014-09-07,485.8,484.5,490.7,478.5,3560.0,1237.6,0.1,484.6333333333334,39.50365956569343,1.7117565677661162,527.7170671778096,468.90293282219034,500.4510013992222,26.889279437609872,18.569526826206722,11939190.0,-4.689032764371195,0.002683178534571784,3.822463323632508,3.822463323632508,501.725,542.05,474.4224936,462.2,517.9,0,648.0,2.317324912442476,2337329.6346754204
2014-09-08,475.7,485.8,487.0,469.5,8140.000000000001,1237.6,0.1,482.0,36.22606642160894,1.3754443107251753,528.3561203300847,467.32387966991536,498.09376317072486,10.708117443868725,18.493132052906244,11931050.0,-5.408629946311392,-0.02079044874433933,3.8875619198877955,3.8875619198877955,493.17499999999995,542.05,537.2,462.2,517.9,0,649.0,2.3180752295680986,2353807.9108610214
2014-09-09,474.9,475.7,478.6,467.5,7290.0,1237.6,0.1,478.8,35.97148344650459,1.2070790345989657,526.5188509127505,464.97114908724944,495.8848333449415,12.353923205342204,17.96505119198437,11923760.0,-7.354662504877106,-0.0016817321841496868,3.7829124430373486,3.7829124430373486,488.3,539.4,535.846,474.9,517.9,0,650.0,2.3188218837463923,2370338.7281861533
2014-09-10,479.7,474.9,491.0,471.6,8290.0,1237.6,0.1,476.76666666666665,38.752677057165236,1.50743339851347,523.5966716600427,464.07332833995736,494.3434206454233,22.55083179297594,18.067547535414054,11932050.0,-6.890527950310569,0.010107391029690493,3.7664264197235884,3.7664264197235884,488.3,539.4,533.11216,474.9,479.7,0,651.0,2.3195727781552944,2387059.711240466
2014-09-11,478.5,479.7,488.9,474.6,6290.0,1237.6,0.1,477.7,38.30472164732682,1.6994853515850217,520.582013466308,463.327986533692,492.83452344109725,23.060796645702283,17.79843699717019,11925760.0,-6.323414252153486,-0.00250156347717323,3.7196315563574065,3.7196315563574065,488.3,539.4,530.4876736,474.9,479.7,0,652.0,2.320319462053655,2403824.4688963154
2014-09-12,477.7,478.5,479.7,471.1,5150.0,1237.6,0.1,478.6333333333334,37.98944669465313,1.8352413656159783,520.1019706830775,461.80802931692256,491.3931402562309,22.466960352422895,17.1414057830866,11920610.0,-6.808427623878274,-0.0016718913270638014,3.588320239289638,3.588320239289638,488.3,537.5,527.968166656,474.9,479.7,0,653.0,2.3210625052352514,2420642.354318153
2014-09-13,478.2,477.7,480.6,474.6,5280.0,1237.6,0.1,478.13333333333327,38.33108625775505,2.007375697767813,517.6975987682601,461.06240123173984,490.1366507080184,26.225490196078397,16.3455910842947,11925890.0,-5.494071146245061,0.0010466820180028424,3.418149536657194,3.418149536657194,488.875,536.0,525.54943998976,474.9,479.7,0,654.0,2.321803742433498,2437545.5841772966
2014-09-14,477.7,478.2,480.3,472.0,4210.0,1237.6,0.1,477.8666666666666,38.10500256926366,2.1248948097395335,516.160370896266,460.0796291037339,488.95220778344526,32.90322580645157,15.77090600684508,11921680.0,-0.8509755085097598,-0.0010455876202425385,3.30142474499583,3.30142474499583,490.9,529.55,523.2274623901696,474.9,479.7,0,655.0,2.3225417758450635,2454509.1601183275
2014-09-15,477.7,477.7,479.3,473.7,5630.0,1237.6,0.1,477.8666666666666,38.10500256926365,2.2290873805497,512.3739134388373,460.37608656116265,487.8805689469267,32.90322580645157,15.04441272064186,11927310.0,0.10477787091366303,0.0,3.149343253222077,3.149343253222077,490.8,529.1,520.9983638945629,474.9,479.7,0,656.0,2.323277315337098,2471545.542406293
2014-09-16,466.8,477.7,478.8,464.0,6520.0,1237.6,0.1,474.0666666666666,33.16007962760183,1.6187721101550903,507.6821553288662,460.22784467113365,485.87289571388607,8.11594202898554,15.026954669167441,11920790.0,-2.5266235122154868,-0.022817667992463875,3.2191419599758873,3.2191419599758873,486.6,529.1,518.8584293387804,474.9,479.7,0,657.0,2.323994911096908,2488372.867405195
2014-09-17,461.1,466.8,469.4,458.3,7510.0,1237.6,0.1,468.5333333333333,30.90171939047157,0.9207732449515902,503.7997201057276,459.14027989427234,483.5135723125636,6.965174129353264,14.74645790708405,11913280.0,-3.937499999999995,-0.012210796915167021,3.1981040787430164,3.1981040787430164,483.75,529.1,515.5669235784536,474.9,479.7,0,658.0,2.3247018358463096,2505118.696387643
2014-09-18,424.3,461.1,462.3,408.8,8930.0,1237.6,0.1,450.73333333333335,20.97140764867359,-1.7824217180700987,506.72845446691565,447.38154553308436,477.87418447327184,17.98143851508121,17.514568056578046,11904350.0,-13.584521384928713,-0.07980915202775973,4.127873687621505,4.127873687621505,459.0,508.5,510.9855696921773,474.9,479.7,0,659.0,2.3253507114171748,2520904.2906906735
2014-09-19,397.7,424.3,429.2,386.1,14970.0,1237.6,0.1,427.7,16.775126769343032,-4.945726130738365,514.7109368368056,428.5690631631944,470.23854785676974,11.016144349477655,19.34209890967961,11889380.0,-17.76261373035567,-0.06269149186896072,4.863489793733873,4.863489793733873,447.125,497.15000000000003,500.7670127229596,474.9,479.7,1,660.0,2.3259540100146068,2535941.6576988786
2014-09-20,411.5,397.7,427.7,387.5,14290.0,1237.6,0.1,411.1666666666667,25.143631316660432,-5.642086659715822,518.2089644996288,418.04103550037115,464.6444004418393,24.213536701620576,20.831948987559638,11903670.0,-15.067079463364294,0.03469952225295447,5.062442038289098,5.062442038289098,445.05,497.15000000000003,487.0069711962044,474.9,479.7,0,661.0,2.3265778739584038,2551452.799080589
2014-09-21,401.6,411.5,415.1,394.5,10420.0,1237.6,0.1,403.6000000000001,23.331157307244382,-6.255329361135107,521.9635204600054,406.7264795399945,458.6401718283308,14.775977121067687,20.815381202733953,11893250.0,-17.332235487855083,-0.024058323207776344,5.183112849286343,5.183112849286343,445.05,497.15000000000003,474.8981346526599,474.9,479.7,0,662.0,2.327183229306074,2566710.0544451936
2014-09-22,404.1,401.6,410.8,398.6,13520.0,1237.6,0.1,405.73333333333335,24.805236722436305,-5.97873203048087,523.4338619982891,397.77613800171093,453.4458697494421,17.159199237368927,20.1999968311101,11906770.0,-15.051503048139578,0.0062250996015935645,4.9987618983197475,4.9987618983197475,443.52500000000003,497.15000000000003,464.2423584943407,474.9,479.7,0,663.0,2.327790507169902,2582094.4110635384
2014-09-23,436.9,404.1,445.5,394.8,17940.0,1237.6,0.1,414.2,40.86866319217691,-3.211597942571572,521.4265194338337,395.4734805661662,451.8700726304476,48.42707340324115,22.378568486030805,11924710.0,-8.001684565171615,0.0811680277159117,5.122125998175968,5.122125998175968,441.67500000000007,497.15000000000003,454.8652754750198,474.9,479.7,1,664.0,2.3284475843266486,2598519.1211636607
2014-09-24,423.8,436.9,439.2,422.1,21370.0,1237.6,0.1,421.59999999999997,37.429543732161406,-1.9504122941704587,517.9319254956437,392.2480745043563,449.19673237992885,36.67315175097277,22.001527879885746,11903340.0,-11.653116531165306,-0.029983978027008362,5.191488409600223,5.191488409600223,440.975,497.15000000000003,446.6134424180174,474.9,479.7,1,665.0,2.329082068391492,2614614.73803382
2014-09-25,412.3,423.8,427.5,409.6,14630.0,1237.6,0.1,424.3333333333333,34.67126738831665,-1.5926857420286034,515.5711044873145,387.4788955126854,445.68275786755464,27.724867724867714,21.708561602751047,11888710.0,-13.834900731452453,-0.02713544124587064,5.265234441608306,5.265234441608306,437.475,497.15000000000003,445.5,474.9,479.7,0,666.0,2.329695971311664,2630412.5655273832
2014-09-26,404.5,412.3,416.4,399.7,12120.0,1237.6,0.1,413.5333333333333,32.9003232883572,-1.5802270563906369,512.8143827509496,382.2356172490504,441.76059045159707,19.470899470899447,21.35080720255454,11876590.0,-15.323424743562903,-0.018918263400436564,5.278320692844138,5.278320692844138,433.25,497.15000000000003,439.2,474.9,479.7,0,667.0,2.3302949428521162,2646015.552085614
2014-09-27,399.0,404.5,407.1,394.7,9740.0,1237.6,0.1,405.2666666666667,31.671861927204887,-1.6344464015260627,509.2554253051241,377.114574694876,437.6881532657307,13.694267515923544,20.711463830943504,11866850.0,-16.562107904642406,-0.013597033374536438,5.190843065399375,5.190843065399375,429.05,497.15000000000003,432.828,474.9,479.7,0,668.0,2.33088261867911,2661490.006617386
2014-09-28,379.1,399.0,402.3,374.1,13940.0,1237.6,0.1,394.2,27.649156004775705,-2.6428651019277254,508.22572276712157,368.48427723287847,432.10832914518494,4.752851711026617,21.246359271590396,11852910.0,-20.64056939501779,-0.04987468671679196,5.60442080495658,5.60442080495658,423.05,491.15000000000003,427.22064,474.9,479.7,0,669.0,2.33143413565739,2676344.366970238
2014-09-29,376.8,379.1,389.3,372.6,20690.0,1237.6,0.1,384.9666666666667,27.218853415713724,-3.067279990334054,506.08868115542805,360.81131884457193,426.84086922659594,3.9548022598869954,20.921619323619655,11832220.0,-21.122043123299136,-0.006067000791347921,5.552446741937276,5.552446741937276,422.3,484.6,419.78375040000003,474.9,479.7,0,670.0,2.3319795151492873,2691159.725681487
2014-09-30,388.2,376.8,395.2,374.7,16920.0,1237.6,0.1,381.3666666666666,32.8011822000322,-2.2221111278061088,500.8079931255465,356.9420068744535,423.1607864431106,16.115702479338815,20.891503657646826,11849140.0,-16.838046272493578,0.030254777070063632,5.381634120980635,5.381634120980635,421.425,484.6,412.23435033600003,474.9,479.7,0,671.0,2.3325425862669142,2706407.617265747
2014-10-01,382.8,388.2,395.1,381.1,17730.0,1237.6,0.1,382.59999999999997,31.56611320302251,-1.6925690258557573,494.905419224911,353.27458077508896,419.31690201995724,11.371237458193969,20.39925339638634,11831410.0,-16.9811320754717,-0.013910355486862369,5.328958567499043,5.328958567499043,420.525,483.1,405.89285428224,474.9,479.7,0,672.0,2.333094253250927,2721513.4641752895
2014-10-02,375.1,382.8,385.6,371.2,14300.0,1237.6,0.1,382.03333333333336,29.840702772406118,-1.5315380543392365,488.3484255477805,349.5715744522196,415.105768494247,5.248990578734904,19.97073529664446,11817110.0,-11.595569172755123,-0.02011494252873558,5.324109649865225,5.324109649865225,418.15,474.75,400.5659975970816,474.9,479.7,0,673.0,2.3336303642861265,2736390.5005844203
2014-10-03,363.5,375.1,378.2,362.8,16810.0,1237.6,0.1,373.8,27.40999775791248,-1.8553224336143899,481.02234139330136,345.4276586066987,410.1909333995568,0.8464328899637107,19.644254204026996,11800300.0,-8.599446819210458,-0.03092508664356175,5.404196479787345,5.404196479787345,411.025,468.15,395.2801180296069,474.9,479.7,0,674.0,2.3341436152483253,2750886.517321084
2014-10-04,335.3,363.5,369.9,327.1,23040.0,1237.6,0.1,357.9666666666667,22.592117969748898,-3.5211509343955143,475.2190933529466,336.99090664705335,403.05846355197997,6.925675675675667,21.298236046596493,11777260.0,-18.517618469015794,-0.07757909215955983,6.351994049089321,6.351994049089321,390.4,436.0,388.78409442368553,474.9,479.7,0,675.0,2.334601417654922,2764333.225168342
2014-10-05,322.9,335.3,344.3,294.9,29850.0,1237.6,0.1,340.56666666666666,20.856162347919053,-4.924476704605244,468.3405178616049,328.3894821383951,395.42432416607716,18.592297476759626,23.30550490041103,11747410.0,-19.596613545816744,-0.036981807336713524,7.217561133605151,7.217561133605151,371.975,416.05,378.2,322.9,479.7,0,676.0,2.3350323989865633,2777297.754249783
2014-10-06,331.5,322.9,347.9,303.0,41170.0,1237.6,0.1,329.90000000000003,25.15177045142103,-4.73831137435559,459.94491934298964,323.2550806570104,389.3362932931174,24.302788844621524,24.847968836095955,11788580.0,-17.96585003711953,0.0266336327036234,7.495616541808735,7.495616541808735,370.25,416.05,369.9,322.9,479.7,1,677.0,2.3354789026853155,2790639.8704322577
2014-10-07,331.6,331.5,345.5,321.7,30170.0,1237.6,0.1,328.6666666666667,25.20260748937551,-4.097293482499161,450.3728007292179,319.8771992707821,383.8375986937729,25.43312543312546,24.773113919231957,11818750.0,-24.10162508583199,0.0003016591251885359,7.47078224343545,7.47078224343545,366.4,416.05,354.9,322.9,479.7,0,678.0,2.335923728876168,2804010.419026287
2014-10-08,350.9,331.6,351.6,325.4,21770.0,1237.6,0.1,338.0,34.45548947640336,-1.9701483281660934,445.72578574282187,317.1842142571782,380.7006845324612,42.232277526395166,24.875034353572534,11840520.0,-17.20151014629543,0.05820265379975864,7.088924010707477,7.088924010707477,366.4,416.05,294.9,322.9,479.7,0,679.0,2.3364040191576114,2818177.5962038944
2014-10-09,360.9,350.9,384.6,347.6,35590.0,1237.6,0.1,347.8,38.687684361764795,0.38795023234269976,444.02705710113366,315.20294289886635,378.8149050531792,54.32098765432099,25.741103328317354,11876110.0,-12.466650497210777,0.0284981476204047,7.132475291858508,7.132475291858508,366.3,416.05,296.034,322.9,479.7,0,680.0,2.3369009026185217,2832760.461481858
2014-10-10,361.7,360.9,378.1,353.3,28410.0,1237.6,0.1,357.8333333333333,39.02687391325525,2.1791837662401683,440.2516306720048,313.9983693279952,377.1849140957336,59.53654188948305,25.673881662008974,11904520.0,-10.580964153275652,0.0022166805209200557,7.098114918996122,7.098114918996122,363.675,416.05,299.57664,322.9,479.7,0,681.0,2.337397275069844,2847407.1456436827
2014-10-11,361.2,361.7,370.1,350.5,13930.0,1237.6,0.1,361.26666666666665,38.88209374050529,3.4332880981684966,437.551504305683,312.658495694317,375.6625413247113,61.731843575418985,25.240032971865478,11890590.0,-9.473684210526319,-0.0013823610727121682,6.987827511590663,6.987827511590663,363.3,416.05,302.9775744,322.9,479.7,0,682.0,2.337890768667536,2862068.086885689
2014-10-12,373.2,361.2,374.6,352.3,11230.0,1237.6,0.1,365.3666666666666,44.22952930545836,5.074883670497748,434.57312645652314,312.54687354347686,375.4280135795007,78.06580259222333,25.03003061673223,11901820.0,-1.5563175943023038,0.03322259136212624,6.706867796552045,6.706867796552045,360.95,411.15,306.242471424,322.9,479.7,0,683.0,2.3384038150181796,2877216.706484201
2014-10-13,387.3,373.2,391.2,366.0,23580.0,1237.6,0.1,373.8999999999999,49.78859741527873,6.995746500436653,425.24056129694077,316.9194387030593,376.5586789528816,92.12362911266204,25.04217128696564,11925400.0,2.786624203821656,0.037781350482315235,6.465833020130556,6.465833020130556,360.825,411.15,309.37677256703995,322.9,479.7,0,684.0,2.3389392594922063,2892920.5118448436
2014-10-14,397.1,387.3,407.7,385.7,28870.0,1237.6,0.1,385.8666666666666,53.27470946553724,8.700593157734183,419.80262579267685,319.68737420732316,378.5149952430834,90.60283687943264,24.824873337896666,11954270.0,2.2926326635754855,0.025303382390911455,6.251542014076218,6.251542014076218,362.775,411.15,314.28616621301757,322.9,397.1,0,685.0,2.339489092010912,2909016.6552989893
2014-10-15,393.2,397.1,397.9,388.2,22490.0,1237.6,0.1,392.5333333333333,51.7353171318123,9.286541777990198,416.223739047219,321.35626095278104,379.9135671246945,87.14539007092199,23.744525242332617,11931780.0,2.716823406478573,-0.009821203727021,6.038790753390797,6.038790753390797,367.45,411.15,321.75927291597617,322.9,397.1,0,686.0,2.34003037525612,2925017.8622198068
2014-10-16,379.8,393.2,398.8,371.6,20790.0,1237.6,0.1,390.0333333333333,46.738142230604765,8.513036676923608,412.4221583677823,322.6878416322176,379.90275120805694,75.26595744680854,23.991344867880287,11910990.0,1.2529992002132733,-0.03407934893184128,6.3168364581043415,6.3168364581043415,368.375,411.15,328.63453108269806,322.9,397.1,0,687.0,2.3405468476371434,2940570.1827612347
2014-10-17,380.5,379.8,384.8,372.4,16570.0,1237.6,0.1,384.5,47.02600011266886,7.808426863113759,409.58807723815926,323.67192276184073,379.95963204538486,75.88652482269504,23.163391663031696,11927560.0,4.676753782668501,0.0018430753027909308,6.087619359535268,6.087619359535268,373.92499999999995,411.15,334.9597685960822,322.9,397.1,0,688.0,2.3410625314057683,2956187.1597545273
2014-10-18,390.9,380.5,395.7,373.6,9450.0,1237.6,0.1,383.7333333333333,51.24224206063479,7.785170446113302,411.1598497949146,323.28015020508536,381.0015718505863,85.1063829787234,23.08743511567229,11937010.0,16.582165225171476,0.02733245729303535,5.90622540692563,5.90622540692563,374.65,408.25,340.7789871083956,322.9,397.1,0,689.0,2.341593902109244,2972228.7747072116
2014-10-19,387.3,390.9,394.5,383.9,5330.0,1237.6,0.1,386.23333333333335,49.765697035531915,7.279001006360719,412.37563857933986,323.11436142066015,381.6014221505305,80.51575931232094,22.19547546455284,11931680.0,19.944255187364522,-0.009209516500383597,5.730822479874216,5.730822479874216,373.075,405.05,346.13266813972393,322.9,397.1,0,690.0,2.342117188096442,2988179.032537277
2014-10-20,380.4,387.3,387.8,378.4,10560.0,1237.6,0.1,386.2,46.97194177507462,6.269496671681832,411.3962749588345,323.3137250411655,381.4870009933371,68.25581395348836,21.281512931370493,11921120.0,14.751131221719449,-0.017815646785437678,5.594509182799815,5.594509182799815,370.6,403.9,351.058054688546,322.9,397.1,0,691.0,2.3426266981700636,3003909.8334031804
2014-10-21,382.4,380.4,388.2,377.4,9660.0,1237.6,0.1,383.3666666666666,47.88518209977684,5.551119418304856,411.34855586634256,323.3214441336574,381.57395327968595,69.2588092345079,20.5328334362726,11930780.0,15.319662243667054,0.00525762355415349,5.369464810740743,5.369464810740743,371.25,401.6,355.58941031346234,322.9,397.1,0,692.0,2.34313766340129,3019754.8020191453
2014-10-22,378.9,382.4,383.7,377.0,10530.0,1237.6,0.1,380.56666666666666,46.379853006506565,4.689224227075753,411.703495900151,323.34650409984897,381.31929106257303,52.07986688851909,19.544773905110272,11920250.0,7.979481333713309,-0.00915271966527198,5.158293456086111,5.158293456086111,370.47499999999997,396.7,359.75825748838537,322.9,397.1,0,693.0,2.3436406381032877,3035504.098060087
2014-10-23,355.8,378.9,381.1,353.5,19120.0,1237.6,0.1,372.3666666666666,37.90941268486219,2.521042841571692,411.58549020991506,322.6945097900849,378.88888238994707,9.265734265734288,20.120147197602396,11901130.0,-1.4131338320864413,-0.060965954077592976,5.654903653064192,5.654903653064192,363.72499999999997,396.7,407.7,322.9,397.1,0,694.0,2.344100542997599,3050368.5339089604
2014-10-24,355.1,355.8,360.9,351.4,20030.0,1237.6,0.1,363.2666666666667,37.6848106430672,1.0715359303682543,410.5294858459352,325.7305141540648,376.62327454328545,8.041958041958083,19.36156525491651,11881100.0,-1.8247166159800845,-0.0019673974142776496,5.452426148948608,5.452426148948608,363.2,396.7,406.616,322.9,397.1,0,695.0,2.344557286817525,3065233.369175894
2014-10-25,346.7,355.1,356.6,341.5,14040.0,1237.6,0.1,352.5333333333333,35.00466440295543,-0.34537245443062936,407.7224790866379,330.91752091336207,373.77343887249634,7.854984894259803,19.057167736708188,11867060.0,-4.014396456256922,-0.02365530836384122,5.496731392185806,5.496731392185806,359.95,396.7,404.40736,322.9,397.1,0,696.0,2.344996538541602,3079773.330436555
2014-10-26,348.7,346.7,356.8,344.2,11580.0,1237.6,0.1,350.1666666666667,36.16868677306005,-1.0030811581672978,405.8276983829204,334.5323016170795,371.385492313211,10.87613293051358,18.59594146980046,11878640.0,-6.564844587352627,0.0057686760888375765,5.33293417545181,5.33293417545181,359.95,394.95,400.6329184,322.9,397.1,0,697.0,2.3454377106184854,3094424.7240496273
2014-10-27,350.1,348.7,356.4,344.9,10600.0,1237.6,0.1,348.5,37.01898546642395,-1.1864644063228464,403.51323815019373,338.6967618498063,369.35830256909566,12.990936555891276,18.089088507671857,11889240.0,-9.604957397366379,0.0040149125322628265,5.1668347636880485,5.1668347636880485,359.65,393.15,397.084943296,322.9,397.1,0,698.0,2.3458796609141683,3109162.380763216
2014-10-28,351.1,350.1,355.7,348.3,9430.0,1237.6,0.1,349.9666666666667,37.65780249834567,-1.0857592683844395,403.4984077885523,338.7315922114476,367.6194166101342,16.753926701570716,17.325582185695293,11898670.0,-11.583983883152857,0.00285632676378178,4.934657415464338,4.934657415464338,358.075,392.95,393.74984669824,322.9,397.1,0,699.0,2.3463216357177252,3123969.5577022107
2014-10-29,335.1,351.1,352.8,334.7,12260.0,1237.6,0.1,345.4333333333334,32.05541763539398,-1.894697783388212,405.6101295931657,334.03987040683427,364.5223293139309,0.6240249609984929,17.380897743859915,11886410.0,-14.776195320447602,-0.04557106237539166,5.186779392378369,5.186779392378369,356.375,392.95,390.6148558963456,322.9,397.1,0,700.0,2.346731414918947,3138102.7647484154
2014-10-30,344.9,335.1,350.4,333.4,16120.000000000002,1237.6,0.1,343.7,38.127102180130706,-1.5805632976640034,406.2516217948403,331.71837820515975,362.6535360459375,18.45906902086677,17.353690762155633,11902530.0,-9.189046866771994,0.02924500149209175,5.031513703147473,5.031513703147473,354.92499999999995,392.95,386.14166742463794,322.9,397.1,0,701.0,2.347158179197778,3152692.4373068423
2014-10-31,337.9,344.9,348.0,336.1,14000.0,1237.6,0.1,339.3,35.6748075201817,-1.6475101901137261,407.37384178559216,328.2661582144078,360.2960564225149,7.2231139646869975,16.964141422001656,11888530.0,-11.195795006570307,-0.02029573789504202,5.020462095886848,5.020462095886848,356.3,392.95,380.8675006821741,322.9,397.1,0,702.0,2.3475698131914498,3166996.089890153
2014-11-01,325.4,337.9,339.0,320.7,13770.0,1237.6,0.1,336.06666666666666,31.747901283209018,-2.297044182919892,408.9703307291027,321.8896692708972,356.9726224775135,6.36856368563684,17.05955989185868,11874760.0,-16.75620363264262,-0.03699319325244155,5.242642867811519,5.242642867811519,352.5,391.9,376.1207506139567,322.9,397.1,0,703.0,2.347955187318563,3180748.660638404
2014-11-02,322.5,325.4,329.8,319.8,11900.0,1237.6,0.1,328.59999999999997,30.89814579256297,-2.659797837448071,408.30624008957835,316.07375991042153,353.68951557489316,3.9473684210526163,16.555305613868775,11862860.0,-16.731216111541443,-0.008912108174554345,5.133428097323652,5.133428097323652,351.025,387.75,369.4702605402819,322.5,397.1,0,704.0,2.348333032677876,3194382.5032386803
2014-11-03,324.2,322.5,332.9,321.7,13430.0,1237.6,0.1,324.0333333333333,32.04637137165555,-2.5241635149550703,404.57183890948437,312.51816109051555,350.8809902820462,6.432748538011665,16.17278378430672,11876290.0,-14.773922187171395,0.005271317829457223,4.988520599724467,4.988520599724467,351.025,387.75,362.5164240646424,322.5,397.1,0,705.0,2.348712589561427,3208113.6756581506
2014-11-04,328.0,324.2,328.8,320.1,15120.0,1237.6,0.1,324.90000000000003,34.6599544406115,-1.9434892659016256,400.25571380353676,310.3142861964632,348.7018483504227,12.832550860719861,15.639013513999098,11891410.0,-14.225941422594138,0.011721159777914991,4.767991924999724,4.767991924999724,350.925,387.6,356.5361246955925,322.5,397.1,0,706.0,2.3490980013459155,3222041.1912235254
2014-11-05,338.0,328.0,342.0,326.5,15840.0,1237.6,0.1,330.06666666666666,41.081991416829894,-0.7142133955562198,397.2909170445474,309.09908295545256,347.6826246980015,29.690048939641084,15.629083977284877,11907250.0,-10.79440485616257,0.030487804878048808,4.623989342391975,4.623989342391975,350.75,387.1,351.39306723820954,322.5,397.1,0,707.0,2.3495011642062233,3236450.4924638397
2014-11-06,347.7,338.0,351.1,335.7,15650.0,1237.6,0.1,337.9,46.56793967595806,0.8396352707616153,393.87069330637985,309.23930669362016,347.68427948866804,67.88321167883211,15.612720836050245,11922900.0,-2.276559865092755,0.028698224852071075,4.490284968665588,4.490284968665588,350.025,386.85,319.8,322.5,397.1,0,708.0,2.3499209072747447,3251319.585522251
2014-11-07,341.9,347.7,351.6,340.2,15020.0,1237.6,0.1,342.5333333333333,43.93377390998443,1.5243770750767887,387.5191367207385,310.6908632792615,347.1333957278425,59.729729729729634,15.311812204903802,11907880.0,-3.7172627428893392,-0.0166810468794939,4.478447559199709,4.478447559199709,349.725,382.15,320.426,322.5,397.1,0,709.0,2.3503279885099664,3265951.2035433087
2014-11-08,343.5,341.9,346.3,339.8,8189.999999999999,1237.6,0.1,344.3666666666666,44.86038287185019,2.097260587368991,381.13448421586133,312.6955157841387,346.7873580394766,64.05405405405403,14.682397047410673,11916070.0,-0.9229881742140147,0.004679730915472469,4.2743513966261055,4.2743513966261055,349.725,378.6,321.67296,322.5,397.1,0,710.0,2.350736341018233,3280677.955696087
2014-11-09,362.0,343.5,362.2,341.8,12630.0,1237.6,0.1,349.1333333333334,54.2710934696412,3.6437404263246425,377.4409838453113,314.54901615468873,348.23618108333596,99.52830188679249,15.090797258309909,11928700.0,3.814166905649559,0.05385735080058218,4.168728524395003,4.168728524395003,350.15,370.2,322.8700416,322.5,397.1,0,711.0,2.351176851706676,3296250.0576525647
2014-11-10,367.1,362.0,374.7,356.6,22810.0,1237.6,0.1,357.5333333333333,56.4763886409547,4.8559210359017815,373.6997804698171,316.76021953018295,350.0327352658754,86.15664845173048,15.305740311287769,11951510.0,4.85575549842902,0.014088397790055218,4.1693653803562425,4.1693653803562425,353.275,370.2,325.229839104,322.5,397.1,0,712.0,2.35162458995377,3312071.0495396187
2014-11-11,365.4,367.1,371.0,361.9,15790.0,1237.6,0.1,364.8333333333333,55.51532483061315,5.349997114116441,370.31034701765003,318.79965298235,351.49628428817294,83.06010928961746,14.862473146195786,11935720.0,4.072913699800614,-0.004630890765459084,4.06745296830755,4.06745296830755,352.575,370.2,329.18745197568,322.5,397.1,0,713.0,2.352067509832832,3327848.639208586
2014-11-12,432.0,365.4,442.7,365.8,38530.0,1237.6,0.1,388.1666666666667,74.10598200745956,9.714631612757927,394.29221524324754,302.4377847567525,359.1633048321564,91.29373474369406,19.32229649289609,11974250.0,28.916741271262303,0.18226600985221686,4.472753817800021,4.472753817800021,381.325,370.2,332.8284558176256,322.5,432.0,1,714.0,2.3526166366590213,3346316.458471921
2014-11-13,428.7,432.0,480.5,390.9,58200.0,1237.6,0.1,408.7,72.48945287915399,11.793459480142133,409.81012702314086,294.27987297685905,365.7858472290939,67.76602364654636,24.342132457689225,11916050.0,24.29689765149319,-0.007638888888888862,5.678127468553586,5.678127468553586,401.825,387.7,343.815610235863,322.5,432.0,1,715.0,2.3531588063923894,3364713.5166258826
2014-11-14,396.5,428.7,430.2,382.0,35730.0,1237.6,0.1,419.06666666666666,58.97180057909318,10.45940227852184,415.37532462109,293.69467537890995,368.7110046358469,47.7286869943995,26.046265853568567,11880320.0,17.342408996744606,-0.07511080009330529,6.5690456125015295,6.5690456125015295,404.125,387.7,360.21773700755944,322.5,432.0,0,716.0,2.3536486689985257,3381907.6014901297
2014-11-15,374.9,396.5,407.3,368.0,13330.0,1237.6,0.1,400.0333333333333,51.970682072661496,7.708776460109529,417.25198575894785,294.4380142410522,369.30043276576623,34.28749222153078,26.99296114974224,11866990.0,15.212046711739399,-0.05447667087011354,7.200042984727191,7.200042984727191,405.15,387.7,480.5,322.5,432.0,0,717.0,2.354100566008151,3398237.932680909
2014-11-16,385.6,374.9,390.4,370.5,14350.0,1237.6,0.1,385.6666666666667,54.83139592894915,6.258205907214162,420.2992342008071,294.9407657991929,370.8527725023599,40.8354114713217,26.48632106761779,11881340.0,19.565891472868223,0.028540944251800537,6.868859198033659,6.868859198033659,405.15,387.7,478.25,322.5,432.0,0,718.0,2.354568749567112,3415055.5859549604
2014-11-17,384.7,385.6,412.3,378.3,27600.0,1237.6,0.1,381.7333333333333,54.53715445338434,4.943977496373543,422.9832788100583,295.6167211899416,372.17155607356375,40.27431421446382,27.023012419930804,11853740.0,18.661320172732882,-0.002334024896265663,7.024437852854382,7.024437852854382,405.65,387.7,476.045,322.5,432.0,0,719.0,2.355033578798481,3431870.458718613
2014-11-18,379.2,384.7,394.9,372.0,27090.0,1237.6,0.1,383.1666666666667,52.67678702018793,3.479270145403161,424.73620985715553,298.27379014284446,372.8409316856053,34.220779220779214,26.728511532792886,11826650.0,15.609756097560973,-0.01429685469196773,7.0486581046394745,7.0486581046394745,409.35,387.7,473.8841,322.5,432.0,0,720.0,2.3554873100006115,3448484.902613213
2014-11-19,381.4,379.2,389.3,374.3,19870.0,1237.6,0.1,381.76666666666665,53.3621014900937,2.480493940623534,426.6457200069592,300.0142799930409,373.656081048881,31.560773480662974,25.89076070902197,11846520.0,12.840236686390528,0.005801687763713037,6.788348376775557,6.788348376775557,410.67499999999995,387.7,471.766418,322.5,432.0,0,721.0,2.3559429357847437,3465226.8937485856
2014-11-20,357.3,381.4,383.0,355.1,21980.0,1237.6,0.1,372.6333333333334,45.57583355690687,0.14205374489637457,426.61413964743195,301.98586035256807,372.0983590442256,12.437810945273633,26.034277801234683,11824540.0,2.7610008628127765,-0.06318825380178283,7.286391771966046,7.286391771966046,408.975,387.7,469.69108964,322.5,432.0,0,722.0,2.3563548435838744,3480927.2245519585
2014-11-21,351.8,357.3,358.7,343.8,23470.0,1237.6,0.1,363.5,43.99800527134466,-1.7267922098136284,425.65907394355486,305.58092605644515,370.1651819923946,8.528784648187633,25.238972244003634,11801070.0,2.895583503948533,-0.015393226980128794,7.174238841388185,7.174238841388185,406.15,387.7,465.1074460544,322.5,432.0,0,723.0,2.356755062968766,3496396.0198538573
2014-11-22,352.0,351.8,364.2,350.5,12940.0,1237.6,0.1,353.70000000000005,44.07382674311592,-2.835641206237896,424.20210901454965,309.9878909854504,368.4351646597856,7.354001441961059,24.414759940860517,11814010.0,2.4745269286754,0.0005685048322909836,6.936011346835374,6.936011346835374,393.575,387.7,457.828999291136,322.5,432.0,0,724.0,2.357153932636691,3511897.106004024
2014-11-23,365.9,352.0,370.6,352.6,12410.0,1237.6,0.1,356.56666666666666,49.21963952441568,-2.529246141915622,422.809491886458,315.55050811354204,368.19372040647266,16.166788588149206,23.999419945084764,11826420.0,1.0773480662983363,0.0394886363636362,6.559010643641641,6.559010643641641,389.1,387.7,450.9872593336678,322.5,432.0,0,725.0,2.3575759027825978,3528066.118564829
2014-11-24,378.9,365.9,388.7,361.9,24570.0,1237.6,0.1,365.59999999999997,53.52646997285711,-1.403536487581233,422.02362324159253,321.4263767584075,369.2133660820467,25.67666422823699,24.199461377578707,11850990.0,3.2143830019068247,0.03552883301448473,6.386767320553894,6.386767320553894,389.1,387.7,444.5560237736477,322.5,432.0,0,726.0,2.3580184716722132,3544846.4170025587
2014-11-25,376.4,378.9,395.7,370.6,45320.0,1237.6,0.1,373.73333333333335,52.60251701411672,-0.8092827268281884,421.52090103590405,325.76909896409603,369.89780740756606,23.84784198975857,24.263785564894512,11805670.0,3.0103995621237,-0.006598046978094518,6.446276717559647,6.446276717559647,389.1,387.7,438.51066234722884,322.5,432.0,0,727.0,2.3584550150525794,3561546.9663884933
2014-11-26,365.4,376.4,378.3,364.0,23980.0,1237.6,0.1,373.5666666666666,48.6252862640024,-1.119892611671311,421.09110393879934,327.9688960612006,369.46944479732167,15.801024140453523,23.552086595973474,11781690.0,-15.416666666666673,-0.02922422954303927,6.4455628341470925,6.4455628341470925,384.95,391.75,432.8280226063951,365.4,432.0,0,728.0,2.358870817068056,3577777.6231951234
2014-11-27,368.8,365.4,374.4,364.8,13850.0,1237.6,0.1,370.2,49.886531789014846,-1.0598439952629009,420.08273122429694,331.66726877570306,369.4056881499577,28.935185185185194,22.55550898197537,11795540.0,-13.972474924189404,0.009304871373837065,6.115918921359915,6.115918921359915,384.95,400.15,427.4863412500114,365.4,432.0,0,729.0,2.3592908012020675,3594191.6209867117
2014-11-28,377.6,368.8,383.3,358.4,43020.0,1237.6,0.1,370.59999999999997,53.096106966747776,-0.4235906753512202,419.2172717646064,335.9427282353937,370.18609880234266,49.34306569343067,22.72297262611999,11838560.0,-4.766708701134926,0.02386117136659438,6.017736394629234,6.017736394629234,385.025,400.15,422.4651607750107,365.4,432.0,0,730.0,2.3597241011940686,3611034.0566700636
2014-11-29,376.3,377.6,389.3,372.2,83450.0,1237.6,0.1,374.23333333333335,52.5605589307965,-0.10312981633817286,419.32423226188473,337.2657677381152,370.7683751068814,47.44525547445255,22.321331724254275,11755110.0,0.37343291544412754,-0.0034427966101695517,5.931791582315778,5.931791582315778,385.025,400.15,417.74525112851006,365.4,432.0,1,731.0,2.3601534340196633,3627847.874009136
2014-11-30,374.9,376.3,381.1,372.6,11290.0,1237.6,0.1,376.26666666666665,51.952823891308284,-0.0035473543349140435,419.4284546890625,337.9415453109375,371.1618631919403,45.40145985401455,21.334093743950397,11743820.0,-2.7748962655601774,-0.00372043582248216,5.690609160829661,5.690609160829661,388.3,400.15,413.30853606079944,365.4,432.0,0,732.0,2.3605786324308182,3644627.4197998377
2014-12-01,378.6,374.9,383.6,373.0,19670.0,1237.6,0.1,376.59999999999997,53.48362420995211,0.2778507009459974,419.63134880452293,339.058651195477,371.8702571736603,67.05202312138734,20.567372762239653,11763490.0,-1.5856511567455072,0.009869298479594724,5.432480919767473,5.432480919767473,391.125,400.15,409.13802389715147,365.4,432.0,0,733.0,2.361008342536171,3661604.9934241795
2014-12-02,380.6,378.6,384.9,375.4,25290.0,1237.6,0.1,378.03333333333336,54.33063435155333,0.5493325902529875,409.06084054968494,344.489159450315,372.7016612523593,70.9055876685935,19.77684613636539,11788780.0,0.36919831223629596,0.00528262017960901,5.196228622271516,5.196228622271516,393.59999999999997,400.15,405.2177424633224,365.4,380.6,0,734.0,2.3614396537607183,3678703.6813610345
2014-12-03,377.0,380.6,384.7,373.6,23510.0,1237.6,0.1,378.73333333333335,52.47829874117182,0.44173673212487774,396.0169466485736,352.3630533514264,373.1110268473727,63.96917148362236,19.15707141233929,11765270.0,-1.1536444677503874,-0.009458749343142503,5.081451303007769,5.081451303007769,393.59999999999997,400.15,401.53267791552304,365.4,380.6,0,735.0,2.361863158907882,3695667.9511602414
2014-12-04,369.8,377.0,380.4,366.2,25330.0,1237.6,0.1,375.8,48.888298316313985,-0.12856775857266234,392.1835772885558,353.52642271144424,372.79569095714675,50.09633911368017,18.80299488288648,11739940.0,3.498460677301987,-0.019098143236074283,5.084638962381416,5.084638962381416,392.5,400.15,398.06871724059164,365.4,380.6,0,736.0,2.3622726570664034,3712325.306739245
2014-12-05,377.6,369.8,379.7,366.4,29990.0,1237.6,0.1,374.8,52.66605710504181,-0.0014347630295943326,392.41131818388425,353.56868181611566,373.25324419932326,59.95575221238945,18.40992381982316,11769930.0,7.333712336554863,0.02109248242293127,4.875509486181981,4.875509486181981,393.0,400.15,394.8125942061561,365.4,380.6,0,737.0,2.362693713327426,3729374.267128838
2014-12-06,376.3,377.6,380.3,372.0,11070.0,1237.6,0.1,374.56666666666666,51.976524897034714,-0.024563455049668725,391.1451906542246,353.90480934577533,373.5434114184353,54.98839907192578,17.687786404121507,11758860.0,6.903409090909094,-0.0034427966101695517,4.700448154164631,4.700448154164631,393.0,400.15,391.75183855378674,365.4,380.6,0,738.0,2.3631108460210983,3746391.56923135
2014-12-07,376.5,376.3,377.9,372.5,8810.0,1237.6,0.1,376.8,52.08047085831348,-0.04487833671843955,389.99104822100435,354.23895177899567,373.8249912833462,48.52546916890085,16.810087375255684,11767670.0,2.8969663842580005,0.0005314908317830547,4.464830644158216,4.464830644158216,394.95,400.15,388.87472824055953,365.4,380.6,0,739.0,2.3635265926091513,3763446.5201145955
2014-12-08,365.0,376.5,377.4,364.6,22920.0,1237.6,0.1,372.59999999999997,45.92506936748083,-0.8089290167650569,389.2269499494211,353.58305005057883,372.9845159230275,17.694369973190405,16.523652562737418,11744750.0,-3.6685141198205278,-0.030544488711819362,4.527028099380114,4.527028099380114,393.45,400.15,386.17024454612596,365.4,380.6,0,740.0,2.3639209356668034,3779980.401523447
2014-12-09,352.2,365.0,365.4,343.8,43830.0,1237.6,0.1,364.56666666666666,40.22621606137478,-2.0802053376004275,388.99445930990345,350.89554069009654,371.00503821607253,18.46153846153841,16.886248808256173,11700920.0,-6.429330499468648,-0.03506849315068494,4.794505624149964,4.794505624149964,375.675,400.15,383.6280298733584,365.4,380.6,0,741.0,2.364290963285782,3795903.935665466
2014-12-10,347.9,352.2,354.1,345.1,27130.0,1237.6,0.1,355.0333333333333,38.497920183679575,-3.055567106869053,390.14419204999723,348.8058079500028,368.8045583859704,9.010989010988936,16.32294532195216,11673790.0,-4.789272030651341,-0.01220897217490069,4.691849761986824,4.691849761986824,371.20000000000005,400.15,381.2383480809569,365.4,380.6,0,742.0,2.3646515756934177,3811627.877975741
2014-12-11,347.7,347.9,367.1,337.8,51080.0,1237.6,0.1,349.26666666666665,38.415248120102085,-3.5257086152125034,390.7035344728691,347.8364655271309,366.7946004444494,19.22330097087374,17.249877798955577,11622710.0,-5.7212581344902445,-0.0005748778384593312,4.961138279826165,4.961138279826165,368.15,400.15,378.99204719609946,365.4,380.6,0,743.0,2.3650102129293695,3827359.355709583
2014-12-12,353.4,347.7,356.4,346.0,26850.0,1237.6,0.1,349.6666666666667,42.22330765195411,-3.2699822373758556,390.55550376492783,348.1244962350721,365.5189242116447,30.291262135922263,16.760600813315893,11649560.0,-6.408898305084758,0.016393442622950838,4.742671424254639,4.742671424254639,367.07500000000005,400.15,375.6966834204115,365.4,380.6,0,744.0,2.365377536470416,3843400.445498034
2014-12-13,348.2,353.4,353.1,343.8,19540.0,1237.6,0.1,349.76666666666665,39.80515861916176,-3.2608611148174864,391.5629618313617,345.3470381686384,363.8695028581547,22.080679405520137,16.24912932665047,11630020.0,-7.467446186553288,-0.014714204867006142,4.666608077728452,4.666608077728452,362.9,400.15,372.6649487467786,365.4,380.6,0,745.0,2.3657338626542277,3859193.605899824
2014-12-14,349.4,348.2,351.6,344.6,12340.0,1237.6,0.1,350.3333333333333,40.64988289968475,-2.990920322528199,390.98154994994417,342.97845005005587,362.49145496690187,24.628450106157057,15.588477231889721,11642360.0,-6.801813817017872,0.003446295232624852,4.461498921548289,4.461498921548289,362.9,400.15,369.87575284703627,365.4,380.6,0,746.0,2.3660907651123937,3875066.3321376815
2014-12-15,345.4,349.4,351.2,343.6,22160.0,1237.6,0.1,347.6666666666667,38.70033523010491,-2.8966884959919197,390.7648850401903,340.0951149598096,360.86369735100646,16.13588110403391,15.017871715326168,11620200.0,-8.769149498151094,-0.011448196908986796,4.347965175253668,4.347965175253668,362.3,400.15,367.3096926192734,365.4,380.6,0,747.0,2.3664387951637185,3890747.5703293034
2014-12-16,330.2,345.4,346.5,328.9,38590.0,1237.6,0.1,341.6666666666667,32.35097198591693,-3.6256831289346074,393.29594133524967,334.04405866475025,357.9433452223392,2.3297491039426723,15.202309449945728,11581610.0,-13.242249080399377,-0.0440069484655472,4.6039701544354115,4.6039701544354115,357.72499999999997,400.15,364.9489172097315,365.4,380.6,0,748.0,2.366756830991405,3905625.0749042104
2014-12-17,320.0,330.2,335.7,314.3,61340.0,1237.6,0.1,331.8666666666666,28.921851070288028,-4.505093070527115,396.3018177458718,326.1581822541281,354.3296932964021,8.623298033282891,15.64500163209246,11520270.0,-15.119363395225463,-0.030890369473046575,4.889063010028894,4.889063010028894,347.85,397.4,361.34402548875835,365.4,380.6,1,749.0,2.3670535463652875,3919940.0757548646
2014-12-18,310.3,320.0,325.6,303.4,60520.0,1237.6,0.1,320.1666666666667,26.089674225796287,-5.390503440955005,398.48417158189767,317.24582841810235,350.13638917293525,8.972691807542303,16.113215801228716,11459750.0,-16.089778258518116,-0.030312499999999964,5.192786271746282,5.192786271746282,342.4,391.95,355.69874243010736,310.3,380.6,0,750.0,2.367329370995504,3933698.313655714
2014-12-19,317.8,310.3,320.2,306.4,41710.0,1237.6,0.1,316.0333333333333,31.661931912118987,-5.123310223847787,398.16922159835445,311.71077840164554,347.05673306122713,18.72561768530563,15.947986101140952,11501460.0,-15.836864406779663,0.02417015791169841,5.018246098533968,5.018246098533968,342.4,391.95,348.3769184898923,310.3,380.6,0,751.0,2.367618805377934,3947899.5269802767
2014-12-20,330.4,317.8,332.6,316.0,29920.0,1237.6,0.1,319.5,39.864518660249665,-3.810546971862907,396.1859684732193,309.24403152678065,345.47037753158645,36.241610738255034,15.99455852248803,11531380.0,-12.19771458942334,0.03964757709251088,4.840968075813568,4.840968075813568,339.72499999999997,391.95,342.0801499013074,310.3,380.6,0,752.0,2.367931262031817,3962823.839318275
2014-12-21,322.6,330.4,332.0,320.1,20670.0,1237.6,0.1,323.59999999999997,36.91091834042812,-3.204453231518949,393.56979469656943,306.2602053034306,343.292246338102,25.945945945946008,15.702090056596026,11510710.0,-14.316069057104908,-0.023607748184019228,4.867355876192196,4.867355876192196,337.3,391.95,336.66492891512434,310.3,380.6,0,753.0,2.368227175883535,3977316.312673496
2014-12-22,330.8,322.6,335.3,319.9,35360.0,1237.6,0.1,327.93333333333334,41.793407737454345,-2.04467246780775,389.4452748682064,305.4047251317936,342.10250859161613,43.01412872841447,15.680512195410598,11546070.0,-9.369863013698627,0.025418474891506504,4.740179019168863,4.740179019168863,336.925,391.95,303.4,310.3,380.6,0,754.0,2.368537403876854,3992281.897919279
2014-12-23,335.3,330.8,339.3,328.0,24070.0,1237.6,0.1,329.56666666666666,44.339182789455144,-0.830114162607293,385.37475490120573,305.30524509879433,341.45465063050983,50.078492935635815,15.367618467166986,11570140.0,-4.7984099943214025,0.013603385731559836,4.583244398200711,4.583244398200711,336.825,391.95,304.03799999999995,310.3,335.3,0,755.0,2.3688546258868084,4007508.840302547
2014-12-24,322.4,335.3,336.3,320.6,21520.0,1237.6,0.1,329.5,39.0645464932694,-0.753426861275651,382.5415099534957,303.39849004650426,339.6399219990327,29.827315541601234,15.391360005226487,11548620.0,-7.329692440356425,-0.03847300924545194,4.773995038841963,4.773995038841963,335.65,391.95,305.44847999999996,310.3,335.3,0,756.0,2.3691456908323074,4022014.18670932
2014-12-25,319.0,322.4,323.4,316.3,15390.0,1237.6,0.1,325.56666666666666,37.788579922824646,-0.7859701175127451,377.5450609918129,302.53493900818717,337.674215141982,29.433962264150985,14.799120004853163,11533230.0,-8.254242162784006,-0.010545905707195935,4.639222572054283,4.639222572054283,332.75,391.95,306.8025408,310.3,335.3,0,757.0,2.3694286389922636,4036327.681102621
2014-12-26,330.0,319.0,332.9,316.4,23010.0,1237.6,0.1,323.8,44.14505816519793,0.03549474403832065,371.5243417095599,303.92565829044014,336.94333750941234,53.52112676056338,14.920611433077937,11556240.0,-6.621392190152796,0.034482758620689724,4.521397403963012,4.521397403963012,332.75,391.95,308.102439168,310.3,335.3,0,758.0,2.369731413270658,4051283.5728305546
2014-12-27,315.3,330.0,330.7,312.0,21630.0,1237.6,0.1,321.43333333333334,38.48583640653638,-0.29102205633189016,364.74517785850986,304.5848221414902,334.8820672704207,24.688796680497973,15.190567759286655,11534610.0,-9.448592762780006,-0.044545454545454555,4.817814068914258,4.817814068914258,333.5,391.95,309.35034160128,310.3,335.3,0,759.0,2.3700041352629335,4065389.448473198
2014-12-28,316.5,315.3,322.8,310.5,20410.0,1237.6,0.1,320.59999999999997,39.17137391362955,-0.3045908192400084,359.86689993465757,304.61310006534245,333.1313941970473,27.405857740585816,14.984098633623322,11555020.0,-9.416141957641667,0.0038058991436726863,4.734312364493941,4.734312364493941,334.47499999999997,391.95,339.3,310.3,335.3,0,760.0,2.3702778151017747,4079571.0324007203
2014-12-29,314.1,316.5,321.6,308.3,20360.0,1237.6,0.1,315.3,38.25317192508407,-0.35034788375898174,357.44332160056354,303.22667839943654,331.3188804639952,24.8259860788864,14.863805874078801,11534660.0,-9.061957151129112,-0.00758293838862556,4.7321890716583255,4.7321890716583255,332.85,391.95,338.724,310.3,335.3,0,761.0,2.3705453050972274,4093612.4347717776
2014-12-30,311.3,314.1,316.2,309.3,22780.0,1237.6,0.1,313.9666666666667,37.158805789304715,-0.43860984303653083,355.56467294701787,301.4453270529821,329.41232041980516,22.00557103064074,14.294962597358886,11511880.0,-5.723803755299812,-0.008914358484559126,4.592021393305135,4.592021393305135,332.82500000000005,391.95,337.50704,310.3,335.3,0,762.0,2.3708057808789307,4107486.7877410236
2014-12-31,318.2,311.3,319.1,308.9,20500.0,1237.6,0.1,314.53333333333336,41.593200476658176,0.07114481044446919,352.9350651417743,301.12493485822574,328.3444803798237,41.22562674094707,14.002465268976112,11532380.0,-0.5625000000000036,0.022165114037905553,4.400523340344472,4.400523340344472,332.82500000000005,391.95,336.3387584,310.3,335.3,0,763.0,2.3710785730115957,4121781.190856035
2015-01-01,314.9,318.2,321.4,313.5,12820.0,1237.6,0.1,314.8,40.134528584718446,0.2779001856761081,348.48451881454287,301.72548118545717,327.06405367698335,25.83586626139815,13.566574892620674,11519560.0,1.4824363519174881,-0.010370835952231316,4.308216860152644,4.308216860152644,331.475,391.95,335.21720806400003,310.3,335.3,0,764.0,2.3713434314375963,4135880.3436736874
2015-01-02,315.2,314.9,316.4,313.1,14730.0,1237.6,0.1,316.09999999999997,40.33936874990351,0.5130132239628828,344.63654621361616,302.2734537863838,325.9341438029849,22.258064516128957,12.833248114576337,11534290.0,-0.8181246066708694,0.0009526833915529664,4.071461965284371,4.071461965284371,330.5,391.95,334.14051974144,310.3,335.3,0,765.0,2.37160748348089,4150000.6138302656
2015-01-03,287.1,315.2,315.8,284.9,47370.0,1237.6,0.1,305.73333333333335,29.988740951930296,-1.0600156312305131,343.5682930926823,297.11170690731774,322.2356539169864,4.044117647058904,14.1237303921066,11486920.0,-13.105326876513304,-0.08914974619289329,4.919446322572831,4.919446322572831,317.45,382.7,333.1068989517824,310.3,335.3,0,766.0,2.3718118421524146,4162328.4470318276
2015-01-04,264.7,287.1,289.9,255.9,88770.0,1237.6,0.1,289.0,24.575408276289195,-3.317715350028095,347.4175360586298,285.1924639413702,316.7560678296544,10.55155875299758,15.543463935527555,11398150.0,-17.947923124612533,-0.0780215952629747,5.872105755771649,5.872105755771649,302.4,343.05,330.21448501467546,310.3,335.3,1,767.0,2.37196423210941,4173085.607985428
2015-01-05,274.8,264.7,278.3,262.9,54990.0,1237.6,0.1,275.5333333333333,30.65378078088537,-3.8045653334611416,348.79428388381615,278.2757161161839,312.7602518458778,22.661870503597125,15.533216511561303,11453140.0,-16.928657799274486,0.03815640347563298,5.652553315706442,5.652553315706442,300.425,334.1,324.2693262135014,310.3,335.3,0,768.0,2.3721387822111986,4184553.603940171
2015-01-06,282.3,274.8,285.1,271.5,21940.0,1237.6,0.1,273.93333333333334,34.85231688316978,-3.3132140811615933,349.2767192298177,274.0232807701823,309.85927547960375,32.83582089552239,15.395129617878354,11475080.0,-15.806740232627497,0.02729257641921401,5.453464264214791,5.453464264214791,297.45,334.1,318.7997801164213,310.3,335.3,0,769.0,2.37232888292767,4196533.086547204
2015-01-07,291.3,282.3,296.1,280.7,30670.0,1237.6,0.1,282.8,39.57973140323247,-2.1312247089651706,349.36031557035625,272.0396844296437,308.0917254339272,45.974025974026,15.395477502315616,11505750.0,-9.646401985111652,0.03188097768331555,5.285093546967256,5.285093546967256,296.575,334.1,313.7677977071076,310.3,335.3,0,770.0,2.3725372716145525,4209113.642304068
2015-01-08,282.7,291.3,292.7,279.0,20180.0,1237.6,0.1,285.43333333333334,36.829547606850916,-1.6966519701133436,349.3060938900264,268.5839061099736,305.67346586879125,34.805194805194795,15.274371966435927,11485570.0,-11.379310344827589,-0.029522828698935855,5.4030321777276,5.4030321777276,296.2,325.8,309.138373890539,310.3,335.3,0,771.0,2.3727257210255503,4221106.368206424
2015-01-09,288.0,282.7,290.6,277.3,20930.0,1237.6,0.1,287.3333333333333,39.61429078896804,-0.8623939781406023,346.90885585244416,266.7411441475558,303.9902786431921,42.914438502673804,15.13334539740479,11506500.0,-12.727272727272727,0.018747789175804774,5.25463381854333,5.25463381854333,296.1,325.8,304.8793039792959,310.3,335.3,0,772.0,2.3729244727629673,4233453.248103217
2015-01-10,273.4,288.0,289.3,272.0,14730.0,1237.6,0.1,281.3666666666667,35.03279194163095,-1.0893601348380102,346.271862206559,262.45813779344104,301.0769187724119,26.15844544095661,15.288106440447306,11491770.0,-13.288931176657162,-0.050694444444444486,5.591845808503038,5.591845808503038,293.67499999999995,325.8,300.96095966095226,310.3,335.3,0,773.0,2.37308961805494,4244777.583450815
2015-01-11,264.8,273.4,278.0,263.8,15110.0,1237.6,0.1,275.40000000000003,32.63829935564763,-1.5841942326074943,344.49242336357884,257.63757663642116,297.6219741274203,13.546423135464236,15.210384551843926,11476660.0,-16.334913112164294,-0.0314557425018287,5.744102927433507,5.744102927433507,291.725,325.8,297.35608288807606,310.3,335.3,0,774.0,2.3732337038930846,4255465.91638527
2015-01-12,269.3,264.8,273.1,263.3,25390.0,1237.6,0.1,269.1666666666667,35.13655847010176,-1.381360650179925,340.3064750566962,255.22352494330377,294.92464325814217,20.45801526717559,14.823928512426503,11502050.0,-14.262973575294494,0.01699395770392753,5.504615117870962,5.504615117870962,286.8,325.8,294.03959625703,310.3,269.3,0,775.0,2.373387086629723,4266471.75142531
2015-01-13,221.3,269.3,269.1,217.1,95500.0,1237.6,0.1,251.80000000000004,24.639464087538116,-4.0991543035163716,345.20350055006327,240.2164994499367,287.9127724716525,4.02684563758391,17.49364790439604,11406550.0,-28.911018310311597,-0.1782398811734125,7.904947087390888,7.904947087390888,267.4,306.4,290.98842855646757,310.3,269.3,1,776.0,2.37341749148119,4273610.554801443
2015-01-14,164.9,221.3,230.9,157.3,170680.0,1237.6,0.1,218.5,17.8801391438395,-9.031794866265521,360.151163574726,209.85883642527398,276.1972703314951,4.6313223644119415,21.501244482653465,11235870.0,-48.17724701445631,-0.2548576592860371,13.038959662009377,13.038959662009377,237.5,276.5,283.5995857008208,164.9,269.3,1,777.0,2.3732645343909806,4274950.283165599
2015-01-15,209.8,164.9,231.3,164.6,124670.0,1237.6,0.1,198.66666666666666,33.51656348140594,-8.60876676184434,357.9172015658425,200.0727984341575,269.8737207761146,32.99811439346324,24.72972701960679,11360540.0,-33.37567481740234,0.2722862340812613,11.787286472643846,11.787286472643846,237.5,276.5,269.1,164.9,269.3,1,778.0,2.3732601918687775,4280994.016030865
2015-01-16,206.9,209.8,222.6,198.7,62320.0,1237.6,0.1,193.86666666666667,33.07846581302664,-7.881948335298958,356.5637673122059,190.58623268779405,263.8762235593418,31.29337539432176,24.670460803920587,11298220.0,-34.35913705583756,-0.013822688274547246,11.92385732427288,11.92385732427288,236.65,273.3,255.68400000000003,164.9,269.3,0,779.0,2.3732463430186925,4286740.733172688
2015-01-17,199.6,206.9,212.6,191.7,43130.0,1237.6,0.1,205.43333333333337,31.94647236509435,-7.26565420936009,354.1963425848431,181.26365741515696,257.7546784584521,30.475504322766554,24.401142175069115,11255090.0,-30.47718564959945,-0.035282745287578576,12.225021129794147,12.225021129794147,236.125,273.3,243.87792000000002,164.9,269.3,0,780.0,2.373209394946099,4291757.107188352
2015-01-18,210.6,199.6,220.7,192.5,40370.0,1237.6,0.1,205.69999999999996,35.52687434155577,-5.566518586792103,349.68730112879734,175.42269887120253,253.26375670050425,38.40057636887607,24.672489162564176,11295460.0,-20.438231960710237,0.05511022044088176,11.715331986022875,11.715331986022875,235.05,273.3,233.4885696,164.9,269.3,0,781.0,2.3732048041454123,4297805.198298074
2015-01-19,215.9,210.6,219.5,205.5,31580.0,1237.6,0.1,208.70000000000002,37.2401640779976,-3.6288238511968878,344.16294336518683,171.40705663481322,249.70530368140862,42.21902017291065,23.910168508095303,11327040.0,-21.433770014556043,0.02516619183285851,11.074649610048775,11.074649610048775,231.375,273.3,224.345941248,164.9,269.3,0,782.0,2.3732146948273267,4304319.675869288
2015-01-20,210.6,215.9,216.6,203.4,37480.0,1237.6,0.1,212.36666666666665,36.20408165270361,-2.311378458017579,336.4327448227632,168.37725517723675,245.980989045084,38.40057636887607,23.145156471802782,11289560.0,-25.398512221041454,-0.024548402037980588,10.990102788130477,10.990102788130477,230.15,271.1,157.3,164.9,269.3,0,783.0,2.373208322858512,4310321.044329117
2015-01-21,228.2,210.6,229.3,207.1,43180.0,1237.6,0.1,218.23333333333335,41.977108417041244,0.014936599550306795,327.5781404637249,168.5618595362751,244.28756151698073,52.36336779911373,23.077645295245443,11332740.0,-21.66151733607965,0.08357075023741678,10.112903284507206,10.112903284507206,228.60000000000002,271.1,158.48600000000002,164.9,269.3,0,784.0,2.3732506268784594,4317883.671761782
2015-01-22,232.7,228.2,238.8,225.6,53710.0,1237.6,0.1,223.83333333333334,43.38771495194929,2.0155968987894752,317.4258947958542,170.46410520414577,243.18398422964924,56.5641410352588,22.372099202727913,11386450.0,-17.686593562079945,0.019719544259421573,9.614138032972889,9.614138032972889,219.05,271.1,161.31856000000002,164.9,269.3,0,785.0,2.373304014328743,4325811.201036978
2015-01-23,232.2,232.7,237.0,224.8,38170.0,1237.6,0.1,231.0333333333333,43.26186474546683,3.3835829135347453,312.08314327115716,170.31685672884285,242.13789049349216,56.74242424242423,21.64552068824735,11348280.0,-19.375000000000004,-0.0021486892995272733,9.321929667634517,9.321929667634517,220.575,271.0,165.96744640000003,164.9,269.3,0,786.0,2.3733550907860907,4333675.5837858915
2015-01-24,248.2,232.2,248.9,229.6,33240.0,1237.6,0.1,237.69999999999996,48.417953499883744,5.328588439417327,310.52517818936303,170.22482181063697,242.71523425601674,75.31068765534381,21.477983496229683,11381520.0,-9.217264081931233,0.06890611541774327,8.653498588327833,8.653498588327833,229.825,268.85,170.33739961600003,164.9,269.3,0,787.0,2.373446252763233,4342840.486037272
2015-01-25,252.1,248.2,256.4,241.4,50190.0,1237.6,0.1,244.16666666666666,49.6197608578725,6.748959549409438,307.8430145110211,170.63698548897875,243.60902146972944,81.86528497409324,21.01527038935613,11431710.0,-4.796072507552877,0.015713134568896114,8.336085041394735,8.336085041394735,231.7,268.8,176.62240764672003,164.9,269.3,0,788.0,2.3735459652950825,4352297.229803501
2015-01-26,269.2,252.1,310.9,251.5,105710.0,1237.6,0.1,256.5,54.61301644861461,8.59305268914715,305.7664341912956,171.40356580870443,246.04625752023142,72.8515625,23.757036790116405,11537420.0,-0.03713330857780272,0.06783022610075373,8.825050813564788,8.825050813564788,245.52499999999998,268.8,184.60016688204803,164.9,269.3,1,789.0,2.373685006340829,4363042.778057046
2015-01-27,263.3,269.2,276.9,247.3,50260.0,1237.6,0.1,261.5333333333333,52.67322919595967,9.118664605584417,300.9964182572318,173.37358174276818,247.6894710897332,69.01041666666669,24.174391305108088,11487160.0,18.978761861726163,-0.021916790490341675,9.181310788115491,9.181310788115491,247.0,267.6,199.75614685620226,164.9,269.3,0,790.0,2.373809278950288,4373333.078203289
2015-01-28,236.2,263.3,267.7,228.1,63770.0,1237.6,0.1,256.23333333333335,44.801772733931,7.416606835203986,295.16046102642485,174.55953897357526,246.59523574785385,48.94053315105947,25.27622049760037,11423390.0,43.238326258338375,-0.10292442081276121,10.701194114140716,10.701194114140716,246.85,267.35,213.09340923345798,164.9,269.3,0,791.0,2.37386567179474,4381439.494062593
2015-01-29,234.0,236.2,241.5,220.4,54490.0,1237.6,0.1,244.5,44.22399447750136,5.979669424957292,287.3176069096491,177.00239309035092,245.3956894861535,35.48657718120806,24.977919033486053,11368900.0,11.534795042897992,-0.009314140558848383,10.674324373284637,10.674324373284637,246.55,262.20000000000005,310.9,164.9,269.3,0,792.0,2.3739153319690303,4389338.367955711
2015-01-30,231.8,234.0,244.8,227.2,48230.0,1237.6,0.1,234.0,43.61820948149145,4.770602077496948,281.8963526311855,178.26364736881447,244.10086191604364,33.64093959731546,24.45092481680848,11320670.0,12.03479942000967,-0.009401709401709368,10.548285080590372,10.548285080590372,249.875,262.20000000000005,309.09,164.9,269.3,0,793.0,2.3739582221226074,4397027.2572277095
2015-01-31,218.5,231.8,235.4,216.5,42150.0,1237.6,0.1,228.1,40.04678217735803,3.0484913435529872,277.25460597943123,178.27539402056868,241.66268459070614,21.959459459459463,24.05443018703645,11278520.0,9.468937875751505,-0.05737704918032793,11.00889253411279,11.00889253411279,248.89999999999998,262.20000000000005,307.3162,164.9,269.3,0,794.0,2.3739638973835877,4403510.898521593
2015-02-01,225.3,218.5,231.4,209.7,41160.0,1237.6,0.1,225.19999999999996,42.6330739315094,2.3708777589062873,271.23824271386206,179.89175728613793,240.10433367730556,20.372093023255825,23.88625660224813,11319680.0,6.980056980056988,0.03112128146453097,10.601978074677378,10.601978074677378,247.2,256.85,303.68355199999996,164.9,269.3,0,795.0,2.373987479117933,4410585.876176084
2015-02-02,238.9,225.3,242.5,220.5,39020.0,1237.6,0.1,227.56666666666663,47.51010375031987,2.812012779945551,272.43275815365826,180.45724184634182,239.98963523184787,33.0232558139535,23.75152398780184,11358700.0,10.653080129689672,0.060363959165556924,9.94203599321969,9.94203599321969,247.2,255.20000000000002,298.04453887999995,164.9,269.3,0,796.0,2.3740460635092475,4418815.298950038
2015-02-03,227.4,238.9,247.5,223.9,63080.0,1237.6,0.1,230.5333333333333,44.09629236679606,2.3230002187621075,265.88027953623276,193.25972046376722,238.79062235262424,19.556840077071303,23.740700845815997,11295620.0,7.977207977207983,-0.04813729593972371,10.440061937474052,10.440061937474052,247.2,254.45000000000002,292.74386654719996,164.9,269.3,0,797.0,2.374073448621035,4426032.4234089935
2015-02-04,226.6,227.4,230.7,220.2,55240.0,1237.6,0.1,230.96666666666667,43.86018970721358,1.9541784349626408,265.6123806013083,195.20761939869172,237.62961069999335,16.69960474308301,22.794936499686283,11240380.0,-0.7011393514460974,-0.0035180299032542273,10.059548322897742,10.059548322897742,238.7,254.25,287.76123455436795,164.9,269.3,0,798.0,2.374097752461395,4433156.364126558
2015-02-05,216.5,226.6,229.9,214.4,40640.0,1237.6,0.1,223.5,40.88395117521283,1.0820659078537798,265.04317847579296,196.73682152420707,235.6172668238035,6.719367588932818,22.273869606851548,11199740.0,-6.961753330468409,-0.044571932921447455,10.288161481224734,10.288161481224734,236.39999999999998,251.9,283.0775604811059,216.5,269.3,0,799.0,2.3740932455846533,4439339.352102879
2015-02-06,223.0,216.5,226.2,215.6,52520.0,1237.6,0.1,222.0333333333333,43.53929166474072,0.9971250452590361,263.326621179772,200.79337882022796,234.41562236439364,13.14229249011859,21.440021777790726,11252260.0,-3.962101636520236,0.03002309468822162,9.614359541610192,9.614359541610192,231.35,248.3,278.67490685223953,216.5,269.3,0,800.0,2.3741059603015433,4446095.04710584
2015-02-07,227.7,223.0,231.0,222.4,39760.0,1237.6,0.1,222.39999999999998,45.4473848394904,1.2928764277601967,262.6870187424261,203.14298125757392,233.77603928207043,17.786561264822137,20.522877365091386,11292020.0,-8.259468170829976,0.02107623318385654,9.013121372459985,9.013121372459985,231.35,248.3,274.53641244110514,216.5,269.3,0,801.0,2.37413052488955,4453248.7207469735
2015-02-08,223.7,227.7,230.2,219.5,29050.0,1237.6,0.1,224.79999999999995,44.081980829889204,1.2535741559618074,262.37123298605053,204.23876701394946,232.81641649330183,13.833992094861662,19.821243267584858,11262970.0,-11.265370884569617,-0.017566974088713216,8.860636239421037,8.860636239421037,231.35,248.3,270.6462276946388,216.5,269.3,0,802.0,2.3741433525164983,4460021.852131204
2015-02-09,220.3,223.7,225.0,215.7,91690.0,1237.6,0.1,223.89999999999998,42.90210980693718,1.0417604839651808,261.6221325090151,205.95786749098497,231.62437682727307,15.773809523809561,19.069725891328797,11171280.0,-18.164933135215446,-0.015198927134555063,8.65625324163813,8.65625324163813,233.175,248.3,266.98945403296045,216.5,269.3,0,803.0,2.374145941350169,4466462.227641823
2015-02-10,219.7,220.3,222.2,214.4,86150.0,1237.6,0.1,221.23333333333332,42.68498692081996,0.9092387069370851,261.7791003728672,204.9508996271328,230.4887218913423,17.24137931034483,18.264745470519596,11085130.0,-16.559058108621354,-0.002723558783477187,8.31349361425562,8.31349361425562,241.125,248.3,263.5520867909828,216.5,269.3,0,804.0,2.3741459942940826,4472823.9376650425
2015-02-11,218.8,219.7,223.5,217.3,71730.0,1237.6,0.1,219.6,42.338854721723415,0.8121449259911486,261.78646269723316,203.55353730276684,229.37551028264303,24.074074074074126,17.402977936911054,11013400.0,-7.366638441998297,-0.004096495220755503,7.953829038807611,7.953829038807611,241.125,248.3,260.32096158352385,216.5,269.3,0,805.0,2.3741426782994406,4479078.915483358
2015-02-12,221.8,218.8,223.0,217.3,50110.0,1237.6,0.1,220.1,43.96984766060072,0.9893843893947523,261.6504067768458,202.6495932231542,228.6540331128675,32.01058201058206,16.567050941417406,11063510.0,-5.213675213675209,0.013711151736745864,7.469364716599371,7.469364716599371,237.2,248.3,257.28370388851243,216.5,269.3,0,806.0,2.3741467980769837,4485586.322035784
2015-02-13,236.2,221.8,241.6,220.6,112250.0,1237.6,0.1,225.6,51.117280690336635,2.0545457904586506,260.19601193882613,202.9039880611739,229.37269662592774,70.10582010582009,16.88369015988759,11175760.0,1.8981880931837694,0.0649233543733092,7.1480483318745085,7.1480483318745085,242.575,246.8,254.4286816552017,216.5,269.3,0,807.0,2.374188340189492,4493347.1952762
2015-02-14,258.6,236.2,261.3,235.4,133800.0,1237.6,0.1,238.86666666666667,59.72411746292888,4.1262605244949695,261.5743518447688,202.17564815523124,232.15624932822035,94.76744186046514,17.52771229132419,11309560.0,18.352402745995434,0.09483488569009335,6.77792431992428,6.77792431992428,247.5,245.1,209.7,216.5,258.6,1,808.0,2.37428406840451,4502928.563713276
2015-02-15,233.3,258.6,264.6,226.6,179140.0,1237.6,0.1,242.69999999999996,49.189519305918274,3.6667535312608406,254.3892245865508,205.77077541344917,232.26517796362793,37.64940239043824,18.990018556229607,11130420.0,3.550821127385708,-0.09783449342614081,8.139742201555768,8.139742201555768,249.25,245.1,210.732,216.5,258.6,1,809.0,2.374316157464323,4510395.874897246
2015-02-16,235.8,233.3,240.0,228.0,115470.0,1237.6,0.1,242.5666666666667,50.125677860170974,3.410587694297331,247.9197313277955,209.49026867220454,232.60182768137764,42.62948207171314,18.490731516498922,11245890.0,-1.2976140644621155,0.010715816545220802,7.841701236852808,7.841701236852808,249.89999999999998,244.0,212.88672,216.5,258.6,0,810.0,2.374353804042405,4518058.3105507335
2015-02-17,243.2,235.8,247.2,232.0,116260.0,1237.6,0.1,237.4333333333333,52.89238756980528,3.600233924639336,249.04254362094963,209.06745637905033,233.61117742600834,57.370517928286795,18.255679265320428,11362150.0,6.948109058926994,0.031382527565733565,7.506447066332413,7.506447066332413,249.89999999999998,240.05,214.9552512,216.5,258.6,0,811.0,2.374409288137359,4526329.512956751
2015-02-18,235.2,243.2,245.5,231.7,99660.0,1237.6,0.1,238.0666666666667,49.68358869556313,3.068367269024664,249.1686555270944,209.06134447290552,233.7624938616266,41.43426294820712,17.937416460654685,11262490.0,3.795233892321268,-0.03289473684210531,7.626452576808965,7.626452576808965,249.89999999999998,239.45000000000002,216.941041152,216.5,258.6,0,812.0,2.3744435112307887,4533896.556845338
2015-02-19,241.9,235.2,244.1,234.9,66050.0,1237.6,0.1,240.1,52.29390247399806,3.0432778719217386,250.4137105875639,208.82628941243615,234.5374944462336,54.780876494023886,17.313315284893637,11328540.0,11.732101616628178,0.028486394557823314,7.157220043362396,7.157220043362396,250.625,239.35,218.84739950592,216.5,258.6,0,813.0,2.3744938517841065,4542016.148659631
2015-02-20,244.5,241.9,247.8,238.8,83590.0,1237.6,0.1,240.53333333333333,53.30623953635234,3.068553202687014,252.01906159049184,209.8209384095082,235.48630449897325,59.960159362549774,16.71950705025838,11412130.0,9.641255605381167,0.010748243075651143,6.838244192334715,6.838244192334715,250.625,239.35,220.67750352568322,216.5,258.6,0,814.0,2.374549724955699,4550333.663852221
2015-02-21,244.4,244.5,247.3,242.6,42950.0,1237.6,0.1,243.6,53.25942733405948,2.944769648787838,253.59014448488358,210.15985551511642,236.3352278800234,59.76095617529879,15.860970832382781,11369180.0,7.334211682037776,-0.00040899795501014857,6.48975893305351,6.48975893305351,242.95,239.35,222.4344033846559,216.5,258.6,0,815.0,2.3746043929956806,4558622.0742142685
2015-02-22,235.7,244.4,246.5,232.7,75700.0,1237.6,0.1,241.53333333333333,49.2104762444488,2.178504177642331,253.26728758158558,210.16271241841437,236.27472998668784,42.4302788844621,15.713758630069725,11293480.0,5.364327223960662,-0.03559738134206225,6.666847106520884,6.666847106520884,242.15,236.85,224.12102724926967,216.5,258.6,0,816.0,2.3746361602879436,4566145.32803218
2015-02-23,238.8,235.7,240.1,231.3,62670.0,1237.6,0.1,239.63333333333335,50.65013361150479,1.7977955712625258,253.95334326844971,210.61665673155028,236.51523189271757,48.60557768924302,15.219918727921884,11356150.0,8.397639582387653,0.013152312261349275,6.37350030482491,6.37350030482491,241.375,236.55,225.7401861592989,216.5,258.6,0,817.0,2.374674922688325,4573914.971651677
2015-02-24,238.9,238.8,240.3,235.5,45030.0,1237.6,0.1,237.79999999999998,50.69868107354099,1.4831533812611952,254.58621682081434,211.21378317918567,236.7423526648397,45.66596194503169,14.475638818784606,11401180.0,8.73918980427857,0.00041876046901179187,6.059287910751196,6.059287910751196,237.525,234.1,227.29457871292695,216.5,258.6,0,818.0,2.3747130149887337,4581671.394996385
2015-02-25,237.3,238.9,239.6,234.6,38100.0,1237.6,0.1,238.33333333333334,49.85363182922122,1.1145439695911183,254.337195885694,213.542804114306,236.79546193485496,42.283298097251574,13.798807474585706,11363080.0,8.455210237659964,-0.006697362913352878,5.814920975383778,5.814920975383778,238.35000000000002,234.1,228.78679556440989,216.5,258.6,0,819.0,2.3747461247913377,4589267.45858076
2015-02-26,236.5,237.3,238.2,233.5,50870.0,1237.6,0.1,237.5666666666667,49.41016985004802,0.7799459232541895,254.40381249593756,214.82618750406246,236.767322702964,36.136363636363626,13.14889265497244,11312210.0,6.627592425608651,-0.003371260008428245,5.559785477789616,5.559785477789616,238.35000000000002,234.1,230.21932374183348,236.5,258.6,0,820.0,2.3747762837719444,4596771.670180966
2015-02-27,253.5,236.5,258.7,235.7,167810.0,1237.6,0.1,242.43333333333337,57.96668377867223,1.6183824857129823,257.04041814110565,214.76958185889444,238.36091101696744,70.78947368421049,13.852543179617268,11480020.0,7.324301439458091,0.07188160676532762,5.464514074799711,5.464514074799711,242.25,234.1,231.59455079216013,236.5,258.6,0,821.0,2.374847441951198,4605687.2770903595
2015-02-28,254.1,253.5,255.4,248.7,39410.0,1237.6,0.1,248.0333333333333,58.235175754494605,2.097803877793499,259.19386538153464,215.6561346184654,239.85987187249432,72.36842105263152,13.341647238216035,11519430.0,-1.7401392111369016,0.002366863905325367,5.250549877298715,5.250549877298715,242.25,234.1,232.91476876047372,236.5,258.6,0,822.0,2.374919049112617,4614632.105947591
2015-03-01,257.9,254.1,260.6,244.8,51330.0,1237.6,0.1,255.16666666666666,59.978768808821094,2.5265046596183796,261.32630559252516,217.28369440747485,241.57797931320917,91.71779141104281,13.517243864057749,11570760.0,10.544363480497198,0.014954742227469398,5.241273309056902,5.241273309056902,242.72500000000002,234.1,234.18217801005477,236.5,258.6,0,823.0,2.374998629348983,4623864.798290107
2015-03-02,273.8,257.9,274.8,256.1,81090.0,1237.6,0.1,261.93333333333334,66.31546934827796,3.6673768591939484,266.84504781552437,217.1749521844756,244.64674318814164,97.70114942528735,13.887440730910766,11651850.0,16.11535199321459,0.06165180302442819,5.072111296899476,5.072111296899476,248.82500000000002,234.1,235.3988908896526,236.5,258.6,0,824.0,2.375113269317156,4634319.89964162
2015-03-03,280.6,273.8,287.1,266.1,164820.0,1237.6,0.1,270.7666666666667,68.60491763015305,4.60571846602197,272.8251510365478,217.3748489634522,248.07086288450913,88.35125448028674,14.395480678702855,11816670.0,15.378289473684227,0.0248356464572681,5.13024970730679,5.13024970730679,254.97500000000002,234.1,237.76295743627344,236.5,258.6,0,825.0,2.3752416310698057,4645269.137205601
2015-03-04,271.9,280.6,284.5,265.9,139000.0,1237.6,0.1,275.43333333333334,62.73038508963151,4.368257250220575,275.5093706253947,219.70062937460526,250.34030451455587,72.75985663082429,14.69580348736694,11677670.0,15.603741496598635,-0.031004989308624498,5.4048560085939465,5.4048560085939465,255.525,234.1,241.70992084137157,236.5,258.6,0,826.0,2.375349961302229,4655547.835778399
2015-03-05,275.2,271.9,280.8,262.8,123640.0,1237.6,0.1,275.90000000000003,63.98995170451443,4.162129537530627,279.383273500144,219.726726499856,252.70789456078865,78.67383512544798,14.931817523983586,11801310.0,13.766019016122359,0.012136815005516777,5.425805786331246,5.425805786331246,255.525,234.1,245.34112717406185,236.5,258.6,0,827.0,2.3754645093144497,4666061.664796074
2015-03-06,272.6,275.2,278.0,269.0,98800.0,1237.6,0.1,273.23333333333335,62.20616167600235,3.6004360612166426,281.5218818400459,218.988118159954,254.60238079309448,74.01433691756273,14.508116272270472,11702510.0,11.49284253578733,-0.009447674418604501,5.322126292102154,5.322126292102154,255.525,234.1,248.6818370001369,236.5,258.6,0,828.0,2.3755723023837914,4676361.1471284395
2015-03-07,274.9,272.6,278.3,269.4,60720.0,1237.6,0.1,274.23333333333335,63.18386987510417,3.1498261835292407,284.33957935982596,220.33042064017408,256.53548738422836,78.13620071684579,14.107536538536868,11763230.0,12.479541734860872,0.008437270726338708,5.131879424713303,5.131879424713303,256.075,237.75,251.75529004012597,236.5,258.6,0,829.0,2.375684107693812,4686819.883754024
2015-03-08,274.5,274.9,278.8,271.3,50400.0,1237.6,0.1,274.0,62.87921215581042,2.6129762844756534,286.7183034995576,221.8216965004424,258.2463933476352,77.41935483870965,13.635569642927091,11712830.0,16.461603733559617,-0.0014550745725717684,4.967420634946118,4.967420634946118,259.07500000000005,251.29999999999998,254.58286683691588,236.5,258.6,0,830.0,2.37579399719367,4697231.830748888
2015-03-09,290.0,274.5,293.3,273.8,151770.0,1237.6,0.1,279.8,69.09732297481584,3.0589607227851516,292.1319312537959,221.0880687462041,261.27054636214615,94.48160535117056,14.054457525575156,11864600.0,21.44053601340033,0.0564663023679417,4.846364663991433,4.846364663991433,262.175,251.29999999999998,257.18423748996264,236.5,258.6,0,831.0,2.3759358108157116,4708781.304390525
2015-03-10,291.4,290.0,301.0,288.1,158180.0,1237.6,0.1,285.29999999999995,69.59277216380156,3.190786391797637,296.5766198677894,222.2633801322105,264.1400181371799,85.77777777777776,13.971996273748358,12022780.0,21.975722059439086,0.004827586206896495,4.794782523592437,4.794782523592437,269.675,251.7,260.79581374096637,236.5,258.6,0,832.0,2.3760794196696424,4720419.085348428
2015-03-11,295.6,291.4,297.7,288.9,79980.0,1237.6,0.1,292.3333333333333,71.09022669120532,3.290209922153183,301.5027905471793,222.70720945282073,267.13620688601986,92.00000000000003,13.602567968480619,12102760.0,24.568057311420148,0.01441317776252582,4.601680638863538,4.601680638863538,272.85,257.15,265.6203160920504,236.5,295.6,0,833.0,2.3762305103005685,4732345.842750408
2015-03-12,293.9,295.6,297.0,290.8,107320.0,1237.6,0.1,293.63333333333327,69.5962394014181,2.980089203503587,305.41590474021615,223.7340952597838,269.6851395635418,89.12710566615617,13.073813113589145,11995440.0,24.2706131078224,-0.005751014884979866,4.448388265937103,4.448388265937103,272.85,257.15,269.8658781610044,236.5,295.6,0,834.0,2.376377038935015,4744138.6918724915
2015-03-13,287.2,293.9,294.9,286.1,97340.0,1237.6,0.1,292.23333333333335,63.89686582468096,2.103650579096783,307.58837886692777,225.8416211330723,271.35322150987116,75.44483985765123,12.768540748332773,11898100.0,13.293885601577903,-0.022796869683565757,4.445870734099156,4.445870734099156,273.2,259.0,273.60197278168386,236.5,295.6,0,835.0,2.3765086646668045,4755430.648036717
2015-03-14,281.6,287.2,288.4,279.3,75720.0,1237.6,0.1,287.56666666666666,59.51023652296855,0.9836040087048357,307.7590851504835,230.26091484951658,272.3291051755977,65.48042704626337,12.506502123451858,11822380.0,10.822510822510834,-0.01949860724233976,4.441229447248529,4.441229447248529,275.575,260.29999999999995,276.8897360478818,236.5,295.6,0,836.0,2.3766274392429523,4766290.623345535
2015-03-15,284.9,281.6,286.4,280.4,39460.0,1237.6,0.1,284.56666666666666,61.20062567683158,0.3353187647274716,308.0329669916435,234.5970330083565,273.5263332541122,64.14253897550104,12.041751971776725,11861840.0,10.469174098487786,0.011718749999999778,4.226659168752799,4.226659168752799,275.67499999999995,260.29999999999995,279.3,236.5,295.6,0,837.0,2.3767521334661796,4777382.531988392
2015-03-16,290.4,284.9,294.0,284.8,66340.0,1237.6,0.1,285.6333333333333,63.90531940345243,0.1563431654470353,308.3049328053888,239.4750671946112,275.133349134673,72.25130890052348,11.838769688078386,11928180.0,6.0628195763330766,0.019305019305019266,4.0767113250958635,4.0767113250958635,276.15,260.29999999999995,279.3,236.5,295.6,0,838.0,2.3768871977794768,4788866.4967519725
2015-03-17,285.4,290.4,292.5,283.3,65010.00000000001,1237.6,0.1,286.9,59.82259013318289,-0.3895378517031922,306.626203405065,245.96379659493493,276.11112540756125,59.16230366492139,11.65028613892993,11863170.0,1.7106200997861563,-0.017217630853994526,4.082090448118406,4.082090448118406,276.775,260.29999999999995,280.4,236.5,295.6,0,839.0,2.3770108167726236,4799966.104040198
2015-03-18,255.9,285.4,285.6,248.2,206740.0,1237.6,0.1,277.2333333333333,42.55021599853665,-2.699417019663665,303.3931667937004,251.13683320629954,274.18625632112685,14.583333333333362,13.489551414720651,11656430.0,-5.884516366311134,-0.103363700070077,5.271415167925225,5.271415167925225,270.375,260.29999999999995,301.0,236.5,295.6,1,840.0,2.3770682643576375,4808719.788028892
2015-03-19,260.9,255.9,264.8,247.0,180690.0,1237.6,0.1,267.4,45.426308357669036,-3.7859864522169193,302.58978110501937,252.68021889498064,272.9208985762576,25.740740740740698,13.797440599383464,11837120.0,-5.196220930232562,0.019538882375927935,5.288401916206771,5.288401916206771,269.25,255.35,299.944,236.5,295.6,0,841.0,2.3771363211040075,4817866.188503111
2015-03-20,261.8,260.9,264.7,257.9,52830.0,1237.6,0.1,259.5333333333333,45.95082669074183,-4.3018726696410585,301.71637947027835,254.32362052972158,271.8617653785188,27.40740740740743,13.297623413713216,11889950.0,-3.961848862802645,0.003449597546953065,5.079306116773574,5.079306116773574,269.075,255.35,297.82624000000004,236.5,295.6,0,842.0,2.37720547962747,4827066.010052076
2015-03-21,259.7,261.8,263.3,254.0,51650.0,1237.6,0.1,260.8,44.86722903448907,-4.614670249273878,301.5118717200021,254.70812827999796,270.70350200913606,23.518518518518498,13.012078884162273,11838300.0,-5.529283375773004,-0.008021390374331583,5.010426986585395,5.010426986585395,269.1,255.35,295.7931904,236.5,295.6,0,843.0,2.3772688877467405,4836072.853382097
2015-03-22,268.6,259.7,270.4,259.0,56630.0,1237.6,0.1,263.3666666666667,50.22452384806518,-4.0712663702778,301.5512657889707,254.14873421102936,270.5031684844564,40.00000000000004,12.896930392436394,11894930.0,-2.149362477231321,0.034270311898344286,4.801537748487116,4.801537748487116,268.875,255.35,293.841462784,236.5,295.6,0,844.0,2.377351418958953,4845782.642174697
2015-03-23,265.5,268.6,271.0,259.4,81450.0,1237.6,0.1,264.59999999999997,48.45824300039009,-3.7762308598827214,301.35323365373966,252.83676634626025,270.0266762478415,34.25925925925926,12.804292507262366,11813480.0,-8.448275862068966,-0.011541325390915902,4.8227090422833765,4.8227090422833765,268.875,255.35,291.96780427263997,236.5,295.6,0,845.0,2.37742606846774,4855223.562203955
2015-03-24,246.7,265.5,267.0,242.7,151090.0,1237.6,0.1,260.26666666666665,39.40717084402099,-4.645664608164536,303.4300194781491,248.23998052185087,267.80508803376136,7.2727272727272725,13.625414471029341,11662390.0,-15.339739190116674,-0.07080979284369116,5.523070316590735,5.523070316590735,268.35,255.35,290.16909210173435,236.5,295.6,0,846.0,2.3774560810573813,4863063.010753224
2015-03-25,246.4,246.7,249.2,234.8,131440.0,1237.6,0.1,252.86666666666667,39.28108569520628,-5.008172784520387,304.8317195998424,243.9582804001577,265.76650822102215,18.649517684887456,13.680742008812958,11530950.0,-16.64411366711773,-0.001216051884880387,5.552249191888375,5.552249191888375,265.775,257.7,287.3209465756303,246.4,295.6,0,847.0,2.37748449167326,4870853.235607165
2015-03-26,248.0,246.4,254.7,243.5,89470.0,1237.6,0.1,247.03333333333333,40.37677532374533,-4.901278355473714,305.70785021321007,240.62214978678998,264.07445981902003,21.963394342762058,13.503546151040604,11620420.0,-15.617556992174203,0.006493506493506551,5.444978286709921,5.444978286709921,264.05,257.7,283.11927084957983,246.4,295.6,0,848.0,2.3775158722341208,4878760.033031048
2015-03-27,247.2,248.0,250.1,244.5,62560.0,1237.6,0.1,247.20000000000002,39.98822225948238,-4.6477664381693495,306.212519512801,237.34748048719894,262.4673684076848,20.945945945945912,12.93900714025199,11557860.0,-13.92757660167131,-0.003225806451612967,5.234226189422326,5.234226189422326,260.4,257.7,279.25372918161344,246.4,295.6,0,849.0,2.377544455437325,4886574.093044358
2015-03-28,252.0,247.2,254.3,246.3,55060.0,1237.6,0.1,249.0666666666667,43.501340633908846,-3.947674916053479,306.11350955693746,235.1964904430626,261.47047617838143,29.054054054054042,12.586220915948276,11612920.0,-10.511363636363644,0.01941747572815533,4.994532109503284,4.994532109503284,260.4,257.7,275.6974308470844,246.4,295.6,0,850.0,2.377583575879452,4894780.961744147
2015-03-29,242.1,252.0,252.8,238.9,77540.0,1237.6,0.1,247.1,38.49582763909687,-3.933498012215551,304.6274799786763,231.89252002132378,259.6256689232975,12.331081081081054,12.680062279094829,11535380.0,-15.022815022815017,-0.03928571428571426,5.237530887688901,5.237530887688901,260.4,257.7,272.4256363793176,246.4,295.6,0,851.0,2.3775980400145875,4902097.5992709985
2015-03-30,246.8,242.1,248.8,236.6,85330.0,1237.6,0.1,246.96666666666667,41.91303983675446,-3.4092791500926976,301.91476556979876,230.14523443020119,258.4041766448882,20.797227036395153,12.645772116302341,11620710.0,-15.013774104683186,0.01941346551011991,5.123894698663833,5.123894698663833,260.4,257.7,269.4155854689722,246.4,295.6,0,852.0,2.377623052460358,4909807.027663595
2015-03-31,244.1,246.8,248.7,241.2,75330.0,1237.6,0.1,244.33333333333334,40.52023609166869,-3.0573365640960306,297.84252535439873,229.06747464560135,257.0418741072798,18.30708661417319,12.278216965137888,11545380.0,-14.470918009810788,-0.010940032414910927,5.0299946600319085,5.0299946600319085,260.4,257.7,266.64633863145446,246.4,295.6,0,853.0,2.377640685667687,4917254.462052764
2015-04-01,246.2,244.1,247.7,239.6,67080.0,1237.6,0.1,245.70000000000002,42.13098220058816,-2.518529747554792,293.2245704371775,228.91542956282248,256.00931466849124,31.491712707182266,11.979772896199467,11612460.0,-3.7905431809300576,0.008603031544448969,4.865870388383212,4.865870388383212,259.4,257.7,264.0986315409381,246.4,295.6,0,854.0,2.3776625394496747,4924864.168016556
2015-04-02,252.6,246.2,254.9,244.3,81370.0,1237.6,0.1,247.63333333333333,46.854541538265465,-1.6106890019721716,289.33562634784295,229.34437365215712,255.68461803339684,49.17127071823201,11.881217689328077,11693830.0,-3.1812955155231823,0.025995125913891082,4.703569948269231,4.703569948269231,256.375,257.7,261.75474101766304,246.4,295.6,0,855.0,2.3776987184571765,4933008.249587905
2015-04-03,254.5,252.6,256.5,251.3,71740.0,1237.6,0.1,251.1,48.20617689476308,-0.8026438521959864,286.23348845512635,229.73651154487368,255.57179726831143,54.419889502762416,11.403987854376071,11765570.0,-2.7883880825057337,0.0075217735550277,4.480938253192955,4.480938253192955,257.225,259.15,259.59836173625,246.4,295.6,0,856.0,2.377738447213749,4941292.720815535
2015-04-04,252.9,254.5,255.2,250.3,30720.0,1237.6,0.1,253.33333333333334,47.119390690681804,-0.321040146156339,281.8413371284913,230.9286628715087,255.3173403856151,50.0,10.939417293349207,11734850.0,-2.6184058529071943,-0.006286836935166962,4.325590072498698,4.325590072498698,257.225,259.15,257.61449279735,246.4,295.6,0,857.0,2.3777735634716257,4949417.251314936
2015-04-05,259.6,252.9,260.3,250.6,43830.0,1237.6,0.1,255.66666666666666,51.99947084343178,0.4611282502073517,275.073739456511,234.61626054348903,255.72521272984224,68.50828729281773,10.850887486681406,11778680.0,-3.3507073715562172,0.026492684855674353,4.1798488007247325,4.1798488007247325,257.35,260.8,234.8,246.4,259.6,0,858.0,2.377823244081734,4958089.444167609
2015-04-06,255.0,259.6,261.5,252.3,45930.0,1237.6,0.1,255.83333333333334,48.677996429118245,0.6684916060526231,267.9278593090327,238.72214069096725,255.65614485080965,62.73291925465837,10.732966951918447,11732750.0,-3.954802259887006,-0.017719568567026278,4.209006647811156,4.209006647811156,257.475,263.8,235.31,246.4,259.6,0,859.0,2.3778614715228934,4966349.226380552
2015-04-07,253.0,255.0,255.6,250.1,44790.0,1237.6,0.1,255.86666666666667,47.26440776131073,0.669110266893822,267.7352189952403,238.6247810047597,255.40317867454206,68.16479400749063,10.359183598209986,11687960.0,2.55370895824889,-0.007843137254901933,4.094538971624501,4.094538971624501,256.95000000000005,263.8,236.3576,246.4,259.6,0,860.0,2.3778941740956285,4974414.1750351805
2015-04-08,244.6,253.0,254.3,242.6,102650.0,1237.6,0.1,250.86666666666667,41.77706308741875,0.13015484091476814,266.9252575526466,237.8047424473533,254.37430451506185,32.128514056224894,10.454956198337845,11585310.0,-0.7305194805194851,-0.033201581027668015,4.2743075218061515,4.2743075218061515,257.475,264.5,237.363296,246.4,259.6,0,861.0,2.377906102409232,4981716.987928641
2015-04-09,243.3,244.6,246.2,237.6,69190.0,1237.6,0.1,246.96666666666667,40.98402978045988,-0.26593347148925783,265.8347768304828,237.04522316951724,253.31960884696073,26.907630522088414,10.322459327027998,11516120.0,-1.895161290322576,-0.005314799672935355,4.2426877628557325,4.2426877628557325,256.975,266.15,261.5,246.4,259.6,0,862.0,2.3779140588040915,4988878.899465901
2015-04-10,234.7,243.3,244.1,231.3,100200.0,1237.6,0.1,240.86666666666667,36.101760937958,-1.0169746707538896,265.78998717946274,234.5900128205372,251.5463127662978,11.258278145695293,10.49942651795457,11415920.0,-5.05663430420712,-0.03534730785039053,4.473551988902671,4.473551988902671,254.52499999999998,266.15,261.022,246.4,259.6,0,863.0,2.3779000013276637,4995227.349757556
2015-04-11,236.5,234.7,240.0,233.1,51990.0,1237.6,0.1,238.16666666666666,37.77264797503397,-1.2851010475292304,262.82413972118405,234.3458602788159,250.11333059807896,17.218543046357585,10.242324623814957,11467910.0,-6.15079365079365,0.007669365146996121,4.33079265277588,4.33079265277588,254.14999999999998,266.15,259.83312,246.4,259.6,0,864.0,2.3778896548224173,5001718.191786247
2015-04-12,235.9,236.5,237.5,232.3,33030.0,1237.6,0.1,235.70000000000002,37.42137769986188,-1.3867235293805429,260.1030729340699,234.10692706593008,248.75968006492857,15.231788079470185,9.882158579256744,11434880.0,-2.5609252375051588,-0.0025369978858350573,4.189130385441604,4.189130385441604,252.425,266.15,258.6917952,246.4,259.6,0,865.0,2.377877023877644,5008128.122783517
2015-04-13,223.6,235.9,236.8,220.4,105150.0,1237.6,0.1,232.0,31.047190418616026,-2.122163420425963,262.50530126573966,229.39469873426032,246.3635200587449,7.785888077858854,10.347718680738407,11329730.0,-9.400324149108597,-0.05214073760067828,4.627781163120933,4.627781163120933,243.325,260.7,257.596123392,246.4,259.6,0,866.0,2.3778321326176437,5013336.120192384
2015-04-14,218.0,223.6,224.7,214.3,115190.0,1237.6,0.1,225.83333333333334,28.65409842236633,-2.7838996228421706,265.0778076689315,223.98219233106846,243.66223243410255,7.838983050847435,10.35145306068566,11214540.0,-10.692339205243751,-0.025044722719141266,4.748372963617276,4.748372963617276,240.275,257.65,255.36435598847999,218.0,259.6,0,867.0,2.377771613782049,5017960.486790194
2015-04-15,223.0,218.0,223.6,217.1,77230.0,1237.6,0.1,221.53333333333333,33.577011431415045,-2.68193816907276,265.7802755538549,220.77972444614508,241.69440077371183,18.432203389830487,10.076349270636685,11291770.0,-9.423233143785536,0.022935779816513735,4.51854227382811,4.51854227382811,238.8,257.65,252.07920750940158,218.0,259.6,0,868.0,2.377723708083196,5023057.252741745
2015-04-16,228.0,223.0,229.5,222.9,84890.0,1237.6,0.1,223.0,38.17139512221545,-2.100538127990644,265.69088787357896,218.94911212642103,240.39017212859642,29.025423728813543,9.82803860844835,11376660.0,-9.738717339667456,0.022421524663677195,4.310543249319452,4.310543249319452,238.47500000000002,257.65,249.05687090864947,218.0,259.6,0,869.0,2.3776880915682574,5028615.813456253
2015-04-17,222.6,228.0,229.3,220.6,66920.0,1237.6,0.1,224.5333333333333,35.32921694712876,-1.908029371936241,265.27519191325626,216.4248080867437,238.69587002111103,17.584745762711833,9.747464422130614,11309740.0,-12.534381139489199,-0.023684210526315863,4.378914834739719,4.378914834739719,236.45,257.65,246.2763212359575,218.0,259.6,0,870.0,2.377637677832576,5033620.751445228
2015-04-18,223.4,222.6,224.5,220.6,36540.0,1237.6,0.1,224.66666666666666,36.08844727231338,-1.569343465796262,265.4821879564296,214.34781204357034,237.23912049529093,19.279661016949145,9.329788391978427,11346280.0,-11.664689600632661,0.003593890386343279,4.176270542514962,4.176270542514962,234.925,257.65,243.7182155370809,218.0,259.6,0,871.0,2.3775886515674585,5038678.5463151755
2015-04-19,223.0,223.4,226.9,222.0,35500.0,1237.6,0.1,223.0,35.86174725154875,-1.229795374133479,265.1022534582242,212.3477465417758,235.8830137814537,18.432203389830487,9.01337493540854,11310780.0,-14.098613251155632,-0.0017905102954342,4.0418721683446375,4.0418721683446375,232.525,257.65,241.36475829411444,218.0,259.6,0,872.0,2.3775378591301317,5043670.705951725
2015-04-20,224.2,223.0,226.7,221.6,44870.0,1237.6,0.1,223.53333333333333,37.13754156712955,-0.8025953388019769,264.7154849872927,210.7445150127073,234.77034580226763,23.970944309927315,8.73384815430793,11355650.0,-12.078431372549025,0.0053811659192823935,3.895561174981236,3.895561174981236,231.9,257.65,239.19957763058528,218.0,259.6,0,873.0,2.3774894957148245,5048755.029204829
2015-04-21,233.7,224.2,235.3,223.3,68350.0,1237.6,0.1,226.96666666666667,46.2523951416658,0.18866459176618022,263.8548392518423,210.35516074815777,234.6684081068136,48.49999999999994,8.967144714714506,11424000.0,-7.62845849802372,0.04237288135593231,3.837032398251821,3.837032398251821,231.72500000000002,257.65,237.20761142013845,218.0,259.6,0,874.0,2.3774646951623093,5054728.782462155
2015-04-22,233.8,233.7,238.4,231.8,77560.0,1237.6,0.1,230.5666666666667,46.340594468397526,0.8811868088192316,261.9755617916271,210.35443820837293,234.58570257283134,61.12852664576807,8.798062949377755,11501560.0,-4.415372035977098,0.0004278990158324003,3.763072262351477,3.763072262351477,232.125,257.65,214.3,218.0,259.6,0,875.0,2.3774393887669643,5060686.37985627
2015-04-23,235.4,233.8,236.1,232.6,42450.0,1237.6,0.1,234.29999999999998,47.81612151490354,1.443880948339059,259.61122128089903,210.80877871910093,234.66325470875216,70.8053691275168,8.419629881565058,11544010.0,-3.247020139745173,0.006843455945252375,3.576733169738767,3.576733169738767,232.825,257.65,214.782,218.0,259.6,0,876.0,2.377417313550461,5066769.040194203
2015-04-24,231.1,235.4,236.6,229.1,69780.0,1237.6,0.1,233.43333333333337,44.29118143570699,1.515888894174716,257.1733815306866,211.06661846931348,234.32389711744244,65.36964980544742,8.35394203288184,11474230.0,-1.5338730293992309,-0.018266779949023038,3.6148602478934833,3.6148602478934833,233.7,257.65,215.25436000000002,218.0,259.6,0,877.0,2.3773837127560355,5072418.591535399
2015-04-25,226.1,231.1,232.3,223.1,43780.0,1237.6,0.1,230.86666666666665,40.54806167291373,1.228442082377235,252.52618273407717,212.36381726592282,233.54066882054317,48.962655601659684,8.414374744818852,11430450.0,-4.397463002114168,-0.02163565556036351,3.7215279720561045,3.7215279720561045,233.7,257.65,215.71727280000002,218.0,259.6,0,878.0,2.3773366072136626,5077558.470844783
2015-04-26,218.7,226.1,226.7,214.1,100770.0,1237.6,0.1,225.29999999999998,35.73465603071212,0.5748021679925222,248.68869319744365,212.57130680255628,232.12727179001524,18.930041152263342,8.713347977331791,11329680.0,-7.2912250953794056,-0.032728881026094725,3.984155453741103,3.984155453741103,232.025,257.55,238.4,218.0,259.6,0,879.0,2.3772693767338677,5081935.885031804
2015-04-27,229.0,218.7,242.6,216.6,123410.0,1237.6,0.1,224.6,45.442580205447776,0.8541669548074706,244.2894885510706,214.57051144892935,231.82943638144235,52.28070175438598,9.948108836093805,11453090.0,2.4150268336314875,0.04709647919524462,4.344152330171967,4.344152330171967,233.075,257.55,214.1,218.0,259.6,0,880.0,2.3772282985373336,5087305.72165496
2015-04-28,225.8,229.0,229.9,222.0,65970.0,1237.6,0.1,224.5,43.25634541696219,0.8401909684677005,241.67634141827818,215.30365858172183,231.2552043451145,41.052631578947434,9.80181534780139,11387120.0,3.577981651376152,-0.013973799126637543,4.340927966253937,4.340927966253937,233.075,257.55,214.1,218.0,259.6,0,881.0,2.37717829866756,5092337.850505171
2015-04-29,225.4,225.8,227.2,222.3,60890.0,1237.6,0.1,226.73333333333335,42.97800595944309,0.8198618062870242,238.94039113470308,216.24960886529698,230.697565836056,39.649122807017584,9.45168568010129,11326230.0,1.0762331838565047,-0.001771479185119551,4.193294445475284,4.193294445475284,233.075,257.55,214.67,218.0,259.6,0,882.0,2.377126560358858,5097304.533886278
2015-04-30,235.8,225.4,240.0,224.7,112240.0,1237.6,0.1,229.0,51.68324569826601,1.4839784231778497,239.14234527846247,216.15765472153754,231.1835119469078,76.14035087719304,9.869422417236914,11438470.0,3.4210526315789522,0.04614019520851831,4.185505690091991,4.185505690091991,233.075,257.55,215.2286,218.0,259.6,0,883.0,2.3771003717031545,5103245.184934226
2015-05-01,233.2,235.8,239.4,232.4,60140.0,1237.6,0.1,231.46666666666667,49.64282592565316,1.709266387380345,238.55121434815896,216.41878565184112,231.37555842815468,67.01754385964911,9.664463673148562,11378330.0,4.761904761904759,-0.011026293469041604,4.14428116344278,4.14428116344278,233.075,255.89999999999998,215.776028,218.0,259.6,0,884.0,2.377066988609523,5108914.1762987375
2015-05-02,235.3,233.2,236.4,231.7,37080.0,1237.6,0.1,234.76666666666668,51.31468013044154,1.9437423423444828,238.43270012340463,216.47729987659534,231.74931476833044,74.38596491228077,9.309859125066524,11415410.0,5.3267681289167434,0.009005145797598813,3.9565912133729384,3.9565912133729384,231.6,255.55,216.31250744,218.0,259.6,0,885.0,2.3770380847778574,5114756.37256912
2015-05-03,240.0,235.3,243.6,233.8,55720.0,1237.6,0.1,236.16666666666666,54.92184836592136,2.333181278853753,240.37142509171196,216.17857490828806,232.53509431420375,87.79661016949154,9.344869187561772,11471130.0,7.623318385650224,0.01997450063748407,3.893695494817405,3.893695494817405,231.52499999999998,254.5,216.8382572912,218.0,259.6,0,886.0,2.3770199322689707,5121012.256820719
2015-05-04,239.0,240.0,243.2,237.4,69120.0,1237.6,0.1,238.10000000000002,54.00501733182304,2.430254501645285,241.31680970493608,217.3331902950639,233.1507996176129,84.40677966101697,9.091664245593073,11402010.0,6.601248884924179,-0.004166666666666652,3.8040436174029595,3.8040436174029595,229.5,254.05,217.908726999552,218.0,259.6,0,887.0,2.376998598749173,5127149.901964381
2015-05-05,235.8,239.0,239.6,231.8,77870.0,1237.6,0.1,238.26666666666665,51.0672250746032,2.1930519184010038,241.9043927818545,218.0256072181455,233.40310441593547,73.55932203389837,8.999402513764995,11324140.0,0.8985879332477633,-0.013389121338912124,3.81654050626166,3.81654050626166,229.6,254.05,218.9363779195699,218.0,259.6,0,888.0,2.3769686927690166,5132962.137011046
2015-05-06,230.0,235.8,237.1,228.2,103660.0,1237.6,0.1,234.9333333333333,46.1653136320786,1.5878419524475422,241.9703391383614,218.1596608616386,233.07899923346542,53.89830508474578,8.992302334210352,11220480.0,-1.6253207869974386,-0.02459711620016969,3.9096966670479794,3.9096966670479794,230.825,254.05,219.9229228027871,230.0,259.6,0,889.0,2.3769236083486813,5138194.221080946
2015-05-07,237.7,230.0,240.3,228.3,91050.0,1237.6,0.1,234.5,52.66185031578196,1.6416176435185164,242.65090867175465,218.98909132824534,233.51909454456396,79.99999999999999,9.207137881766755,11311530.0,0.9770603228547081,0.03347826086956518,3.8734278004908522,3.8734278004908522,230.89999999999998,253.3,220.87000589067563,230.0,259.6,0,890.0,2.376896903749079,5144133.6481988765
2015-05-08,243.7,237.7,247.0,235.8,87500.0,1237.6,0.1,237.13333333333333,57.01480201135459,1.9933821599879378,244.4054852730275,219.26451472697258,234.4887045879388,89.96960486322186,9.349485175926272,11399030.0,5.452185201211594,0.0252419015565839,3.836473194881523,3.836473194881523,233.2,249.85000000000002,221.7792056550486,230.0,243.7,0,891.0,2.3768839019027914,5150603.052337489
2015-05-09,241.4,243.7,247.9,238.5,62790.0,1237.6,0.1,240.9333333333333,54.929636360014676,1.9792502911486336,245.29764326206407,220.21235673793598,235.1469231986113,80.76923076923077,9.353093377645823,11336240.0,6.766917293233088,-0.009437833401723328,3.8745208689502166,3.8745208689502166,234.525,242.55,223.2924533157457,230.0,243.7,0,892.0,2.376864648898727,5156835.687043035
2015-05-10,240.0,241.4,244.8,238.2,44000.0,1237.6,0.1,241.69999999999996,53.64359279146379,1.7894472581662875,245.82025559812914,221.26974440187084,235.60912098921975,74.76038338658145,9.156443850671122,11292240.0,9.739368998628263,-0.0057995028997515075,3.8151849377796343,3.8151849377796343,234.525,242.55,225.26105705048604,230.0,243.7,0,893.0,2.3768412809665356,5162913.031521879
2015-05-11,241.8,240.0,243.9,238.9,57170.0,1237.6,0.1,241.0666666666667,55.09916101741049,1.6996247433858997,246.74257597200037,221.1574240279996,236.19872851405597,76.44787644787648,8.859555004194613,11349410.0,5.589519650655027,0.007500000000000062,3.6640012424295336,3.6640012424295336,234.525,242.55,227.07217248644716,230.0,243.7,0,894.0,2.3768214926505333,5169131.6910867775
2015-05-12,241.6,241.8,243.0,239.2,40080.0,1237.6,0.1,241.13333333333333,54.89291703715525,1.545667608895135,247.5589863453822,221.12101365461774,236.71313532224113,75.39062499999994,8.498158218180713,11309330.0,6.997342781222312,-0.0008271298593880427,3.5174495936178447,3.5174495936178447,234.525,242.55,228.73839868753137,230.0,243.7,0,895.0,2.376800479378619,5175306.372974298
2015-05-13,236.4,241.6,243.9,234.1,84430.0,1237.6,0.1,239.9333333333333,49.68548229043132,1.0369716164307121,247.6321901511571,221.14780984884294,236.6833129105991,50.43103448275866,8.591146916882092,11224900.0,4.880212954747116,-0.021523178807946963,3.6341569022343876,3.6341569022343876,234.525,242.55,230.27132679252887,230.0,243.7,0,896.0,2.376766154169182,5180968.858271638
2015-05-14,236.9,236.4,239.2,232.4,71020.0,1237.6,0.1,238.29999999999998,50.17493054424232,0.6939960804163945,247.87524156654214,221.4847584334578,236.70394977625634,44.1624365482234,8.463207851390512,11295920.0,0.46649703138252513,0.002115059221658111,3.572481152971934,3.572481152971934,234.525,240.55,231.68162064912656,230.0,243.7,0,897.0,2.3767323287243003,5186652.7356381025
2015-05-15,237.2,236.9,238.8,235.5,46030.0,1237.6,0.1,236.83333333333334,50.48615666622022,0.4585249700925805,247.8615236704091,222.60847632959087,236.75119265470812,45.68527918781722,8.094407290576905,11341950.0,1.7152658662092626,0.0012663571127056183,3.4124819943410225,3.4124819943410225,234.55,237.8,232.4,230.0,243.7,0,898.0,2.3766985135041216,5192339.071136386
2015-05-16,236.2,237.2,237.8,234.6,27050.0,1237.6,0.1,236.76666666666665,49.378938240382766,0.21877130166560432,246.2031461893407,226.01685381065937,236.6986981161645,40.60913705583753,7.744806769821413,11314900.0,0.38249043773904684,-0.004215851602023646,3.2789190388744345,3.2789190388744345,235.575,237.8,232.4,230.0,243.7,0,899.0,2.3766615430166627,5197904.863821121
2015-05-17,236.3,236.2,237.8,235.4,28430.0,1237.6,0.1,236.5666666666667,49.49821406121412,0.05860249840963505,246.0267275923993,226.92327240760068,236.66072686700596,41.11675126903561,7.3630348576913125,11343330.0,-1.5416666666666619,0.0004233700254023809,3.1159690468435515,3.1159690468435515,235.575,237.8,233.64000000000001,230.0,243.7,0,900.0,2.3766241036322326,5203454.189797737
2015-05-18,232.6,236.3,237.1,231.5,53140.0,1237.6,0.1,235.0333333333333,45.24982327130385,-0.2859284292941815,245.24026557441383,228.38973442558617,236.27399097491016,22.33502538071067,7.237103796427647,11290190.0,-2.677824267782429,-0.015658061785865485,3.111394581439229,3.111394581439229,234.575,237.8,247.9,230.0,243.7,0,901.0,2.3765768630618824,5208623.552265919
2015-05-19,232.0,232.6,234.5,231.3,40940.0,1237.6,0.1,233.63333333333335,44.581595158693375,-0.529466637810919,244.15398708797517,230.1360129120248,235.8669442153949,19.289340101522885,6.9487392395399565,11249250.0,-1.6115351993214635,-0.002579535683576939,2.9951462239396367,2.9951462239396367,234.3,237.8,247.572,230.0,243.7,0,902.0,2.3765274421563785,5213708.801315843
2015-05-20,234.0,232.0,235.2,231.5,49690.0,1237.6,0.1,232.86666666666665,47.37151760319531,-0.529805203683491,244.17608839991493,229.93391160008508,235.68914000440492,29.081632653061174,6.716686436715674,11298940.0,1.7391304347826086,0.008620689655172376,2.8703788191092623,2.8703788191092623,234.3,237.8,246.92112,230.0,243.7,0,903.0,2.376482270679811,5218960.583649265
2015-05-21,235.4,234.0,236.6,233.6,42940.0,1237.6,0.1,233.79999999999998,49.29578275877283,-0.41477626198703493,244.11029337029058,230.21970662970935,235.66160286112824,24.698795180722865,6.4512088340931255,11341880.0,-0.9676062263357101,0.005982905982905962,2.7405305157574875,2.7405305157574875,234.3,237.8,246.2962752,230.0,243.7,0,904.0,2.376439833683648,5224320.2478838395
2015-05-22,240.4,235.4,242.0,234.6,74110.0,1237.6,0.1,236.6,55.547090920734306,-0.002778260041093314,244.4466919670214,230.39330803297864,236.11287877911602,54.81927710843372,6.518979631657902,11415990.0,-1.3541239228559634,0.021240441801189558,2.711721976563187,2.711721976563187,234.45,237.8,245.696424192,230.0,243.7,0,905.0,2.3764087756542573,5230126.260185483
2015-05-23,238.9,240.4,241.7,238.1,36030.0,1237.6,0.1,238.23333333333335,53.41929055244799,0.1589480969678252,244.3269752943689,230.4030247056311,236.37831889539066,56.296296296296255,6.31048108653948,11379960.0,-1.035625517812759,-0.006239600665557399,2.6414738746502633,2.6414738746502633,235.8,237.8,245.12056722431998,230.0,243.7,0,906.0,2.376373405024005,5235765.686005864
2015-05-24,241.0,238.9,242.4,237.5,30260.0,1237.6,0.1,240.10000000000002,55.96262627042175,0.38471238750184306,244.57394506937584,230.35605493062417,236.81847900059157,76.98412698412693,6.209732437500946,11410220.0,0.4166666666666667,0.008790288823775638,2.5766524636933386,2.5766524636933386,235.97500000000002,237.8,244.56774453534717,230.0,243.7,0,907.0,2.3763423484101973,5241576.145779148
2015-05-25,237.4,241.0,241.8,235.8,26390.0,1237.6,0.1,239.1,50.838088548917405,0.2741419558697491,244.61309026536895,230.47690973463108,236.87386195291617,48.41269841269839,6.194751549108021,11383830.0,-1.8196856906534349,-0.014937759336099532,2.6094151428424692,2.6094151428424692,236.57500000000002,237.8,244.03703475393328,230.0,243.7,0,908.0,2.3763019416791358,5247021.893954987
2015-05-26,237.8,237.4,239.0,235.6,37080.0,1237.6,0.1,238.73333333333335,51.37092604682058,0.2132055513054505,244.097556287727,231.77244371227306,236.96206557644797,51.58730158730161,5.995126438457449,11420910.0,-1.5728476821191983,0.0016849199663016012,2.52107924241272,2.52107924241272,237.45000000000002,237.8,243.52755336377595,230.0,243.7,0,909.0,2.3762618009029506,5252479.54042756
2015-05-27,237.3,237.8,238.9,235.9,48030.0,1237.6,0.1,237.5,50.63219312212344,0.1286513443418819,244.08307101121602,231.74692898878402,236.99424980726243,54.054054054054085,5.781188835710489,11372880.0,0.3807106598984796,-0.002102607232968845,2.4362363403752587,2.4362363403752587,237.45000000000002,237.8,243.0384512292249,230.0,243.7,0,910.0,2.3762197551443185,5257863.718738768
2015-05-28,237.3,237.3,238.4,236.2,35750.0,1237.6,0.1,237.4666666666667,50.63219312212344,0.06534203710712572,243.1643715982508,232.02562840174915,237.02336887323744,54.054054054054085,5.52538963315974,11408630.0,0.16884761502744014,0.0,2.3284406376568647,2.3284406376568647,237.5,234.85,242.56891318005592,230.0,243.7,0,911.0,2.376177014594998,5263221.836340174
2015-05-29,237.0,237.3,237.9,235.1,38920.0,1237.6,0.1,237.20000000000002,50.13055196094862,-0.0006268269259549486,242.6664553763027,232.0835446236973,237.02114326626247,51.351351351351276,5.330718945076902,11369710.0,-0.0843170320404674,-0.0012642225031606058,2.2492485000324485,2.2492485000324485,238.025,234.2,242.11815665285368,230.0,243.7,0,912.0,2.376132857225071,5268525.336401051
2015-05-30,233.2,237.0,237.1,231.6,41630.0,1237.6,0.1,235.83333333333334,44.16208226693357,-0.28816484747158255,242.47973139827877,231.59026860172122,236.65722485995175,17.117117117116923,5.342810448999981,11328080.0,-1.2701100762066047,-0.016033755274261652,2.291085098198963,2.291085098198963,237.525,231.0,241.68543038673954,230.0,243.7,0,913.0,2.376078764079752,5273437.8456223095
2015-05-31,229.8,233.2,234.0,229.1,39000.0,1237.6,0.1,233.33333333333334,39.617184502363365,-0.6733210531361165,242.27735397758494,230.59264602241507,236.00415582567064,5.263157894736966,5.311181131214269,11289080.0,-2.750740584003385,-0.014579759862778596,2.3112189430871495,2.3112189430871495,236.9,231.0,241.27001317126997,230.0,243.7,0,914.0,2.3760156023589722,5277992.430788644
2015-06-01,223.1,229.8,231.8,221.0,87060.0,1237.6,0.1,228.70000000000002,32.5157119531149,-1.3085355770326565,243.31638200445013,227.70361799554996,234.7751886041782,9.813084112149504,5.703239621841822,11202020.0,-4.08426483233018,-0.029155787641427455,2.556360207011126,2.556360207011126,233.075,231.0,240.53981238099377,223.1,243.7,0,915.0,2.3759348781654928,5281852.295152418
2015-06-02,225.7,223.1,227.4,222.3,60810.0,1237.6,0.1,226.20000000000002,37.21874495786915,-1.4706961246035797,243.8566383623407,226.09336163765929,233.9108849275898,21.962616822429847,5.660151077424549,11262830.0,-2.715517241379315,0.011653966831017382,2.507820592567368,2.507820592567368,232.925,231.0,238.97662739051427,223.1,243.7,0,916.0,2.375860145806899,5285947.600515075
2015-06-03,225.6,225.7,227.9,223.7,54350.0,1237.6,0.1,224.79999999999998,37.11161853903304,-1.4968105588792826,244.1282097116394,224.69179028836064,233.11937207734314,21.495327102803707,5.555854571894225,11208480.0,-3.589743589743592,-0.00044306601683652413,2.4627014946339654,2.4627014946339654,232.225,231.0,237.53849719927314,223.1,243.7,0,917.0,2.3757845263081654,5290006.545535639
2015-06-04,224.2,225.6,226.7,223.5,44060.0,1237.6,0.1,225.16666666666666,35.56811226941342,-1.5158363921215652,244.34515942248404,223.17484057751605,232.2699080699771,14.953271028037326,5.387579245330351,11164420.0,-4.757858963466447,-0.006205673758865271,2.403023749032271,2.403023749032271,231.425,231.0,236.21541742333127,223.1,243.7,0,918.0,2.375704724081187,5293898.4314262755
2015-06-05,225.3,224.2,226.4,222.1,56460.0,1237.6,0.1,225.03333333333333,37.75853355719026,-1.3664228046438844,244.34968005824152,222.08031994175843,231.60610730140786,20.09345794392528,5.309895013521041,11220880.0,-6.281198003327784,0.004906333630686932,2.3568109247763163,2.3568109247763163,231.075,231.0,234.99818402946477,223.1,243.7,0,919.0,2.375627088087652,5297874.66629771
2015-06-06,224.7,225.3,225.8,223.5,22470.0,1237.6,0.1,224.73333333333335,37.019272340861924,-1.2246428331419525,244.26397673913758,221.00602326086252,230.94838279651188,17.289719626168168,5.094902512555253,11198410.0,-5.943909585600677,-0.0026631158455393544,2.267424349156766,2.267424349156766,230.95,231.0,233.87832930710758,223.1,243.7,0,920.0,2.375547305860412,5301764.272876525
2015-06-07,223.5,224.7,226.4,222.2,40480.0,1237.6,0.1,224.5,35.52135778651201,-1.1305791941864265,244.47204620880518,219.88795379119483,230.23901300636788,12.019230769230763,5.0309809045155935,11157930.0,-7.261410788381744,-0.005340453938584733,2.2509981675684982,2.2509981675684982,230.75,231.0,232.84806296253896,223.1,243.7,0,921.0,2.375463851982267,5305506.442311581
2015-06-08,228.6,223.5,229.9,223.0,74150.0,1237.6,0.1,225.6,45.59666504023326,-0.6667260987113437,244.40094830912474,219.61905169087524,230.08291652957095,42.22222222222219,5.164482268478766,11232080.0,-3.7068239258635263,0.02281879194630876,2.2591785951350682,2.2591785951350682,229.6,231.0,231.90021792553586,223.1,243.7,0,922.0,2.375392623436701,5309732.870317769
2015-06-09,229.6,228.6,231.4,227.5,54840.0,1237.6,0.1,227.23333333333335,47.33440163004195,-0.25554489965643956,244.18804823346812,219.39195176653192,230.03692447913562,48.04469273743012,5.074162106444569,11286920.0,-3.4482758620689724,0.004374453193350725,2.2100009174410142,2.2100009174410142,229.05,231.0,221.0,223.1,243.7,0,923.0,2.375323242363523,5314031.810233327
2015-06-10,228.8,229.6,230.4,227.8,41640.0,1237.6,0.1,229.0,46.06669106033989,-0.013221579106639236,243.8073721900412,219.11262780995887,229.91912214778938,44.827586206896605,4.897436241698528,11245280.0,-3.581963758954909,-0.0034843205574912606,2.1404878678752306,2.1404878678752306,229.225,231.0,221.208,223.1,243.7,0,924.0,2.3752512394638168,5318225.437086075
2015-06-11,229.9,228.8,230.6,228.5,38000.0,1237.6,0.1,229.4333333333333,48.123988926922685,0.23184560154006872,242.5907753924568,219.2792246075432,229.91730099085706,52.66272189349114,4.697619367291489,11283280.0,-3.118415507796041,0.004807692307692291,2.0433316082172635,2.0433316082172635,229.225,231.0,221.41184,223.1,243.7,0,925.0,2.3751813291678068,5322501.416736953
2015-06-12,230.5,229.9,231.6,229.3,40750.0,1237.6,0.1,229.73333333333335,49.26089903048725,0.4333484990420371,241.58302150338542,219.4469784966146,229.97279613458497,59.00621118012425,4.526360841056381,11324030.0,-2.7426160337552745,0.002609830361026466,1.9637140308270635,1.9637140308270635,229.27499999999998,231.0,221.61160320000002,223.1,243.7,0,926.0,2.3751122637878415,5326810.182154001
2015-06-13,232.5,230.5,233.1,229.0,38010.0,1237.6,0.1,230.96666666666667,52.961533069638534,0.6853400734525144,240.118938129204,220.061061870796,230.21348221700543,88.46153846153847,4.49590649526664,11362040.0,-0.30017152658661606,0.008676789587852562,1.933723223770598,1.933723223770598,229.64999999999998,231.0,222.01113907200002,223.1,243.7,0,927.0,2.3750474656347427,5331288.495265008
2015-06-14,233.8,232.5,235.5,232.1,32900.0,1237.6,0.1,232.26666666666668,55.24639236807066,0.9095327643642741,239.52850300199577,220.29149699800422,230.5550553391954,88.2758620689656,4.4176274598904515,11394940.0,1.7406440382941688,0.005591397849462387,1.889489931518585,1.889489931518585,230.27499999999998,231.0,222.67647072768003,223.1,243.7,0,928.0,2.374985187916291,5335866.993110288
2015-06-15,237.0,233.8,238.6,233.3,63470.0,1237.6,0.1,234.43333333333337,60.35170277149262,1.223729654438525,239.36275513217322,220.37724486782673,231.16885959260537,90.30303030303033,4.480654069898275,11458410.0,6.230389959659348,0.01368691189050475,1.8905713375098208,1.8905713375098208,231.04999999999998,231.0,223.70235306946563,223.1,243.7,0,929.0,2.374929970738313,5340727.618381634
2015-06-16,249.8,237.0,254.1,235.7,122470.0,1237.6,0.1,240.20000000000002,73.41545649157342,2.1877291579453155,243.02296471895585,217.96703528104422,232.94325391711916,86.56250000000006,5.474893064905542,11580880.0,10.67789100575987,0.05400843881856554,2.191710594437767,2.191710594437767,238.05,234.1,225.19211776251908,223.1,249.8,1,930.0,2.374903897841147,5346755.847251416
2015-06-17,247.4,249.8,258.5,245.1,121620.0,1237.6,0.1,244.73333333333335,68.83569262732242,2.53346313656398,245.27669429522822,216.72330570477178,234.32008687739355,69.50549450549453,6.040972131698004,11459260.0,9.663120567375891,-0.009607686148919159,2.4417834000396135,2.4417834000396135,241.375,237.55,228.6610636310168,223.1,249.8,1,931.0,2.3748716534267733,5352539.244762627
2015-06-18,248.4,247.4,251.9,242.5,78140.0,1237.6,0.1,248.53333333333333,69.68428065839018,2.6847620975438637,247.56613703365292,215.57386296634712,235.66103098430844,72.25274725274727,6.280902693719575,11537400.0,10.793933987511158,0.004042037186742009,2.5285437575360605,2.5285437575360605,241.45,239.75,232.83851472267443,223.1,249.8,0,932.0,2.3748409980559466,5358388.568285586
2015-06-19,244.1,248.4,250.8,243.6,84700.0,1237.6,0.1,246.63333333333335,61.88143625386623,2.361908880630298,249.0134348387477,215.2165651612523,236.4647423191362,60.33057851239669,6.346552501311036,11452700.0,8.344429649356405,-0.01731078904991956,2.5999805412990726,2.5999805412990726,241.625,239.75,236.4311226615,223.1,249.8,0,933.0,2.374799770376445,5363815.145699677
2015-06-20,245.0,244.1,246.6,238.7,51280.0,1237.6,0.1,245.83333333333334,62.81983659488701,2.0852593473353886,250.63392733245456,215.11607266754544,237.277624003028,62.80991735537191,6.457513036931677,11503980.0,9.034267912772592,0.0036870135190496534,2.6357196069108886,2.6357196069108886,241.75,239.75,258.5,223.1,249.8,0,934.0,2.3747599460055944,5369299.5011075
2015-06-21,244.1,245.0,246.0,240.9,25150.0,1237.6,0.1,244.4,61.19739436097583,1.7324472907665558,251.73116466281837,216.11883533718165,237.92737409797772,59.43661971830985,6.3605478200079855,11478830.0,9.217002237136462,-0.003673469387755146,2.6057139778811904,2.6057139778811904,241.75,239.75,258.104,223.1,249.8,0,935.0,2.374717363852172,5374674.180880934
2015-06-22,247.5,244.1,248.6,243.2,47590.0,1237.6,0.1,245.53333333333333,64.88685792139805,1.620860387724779,253.33529202822382,216.6947079717762,238.83905275531316,64.51612903225806,6.291937261435987,11526420.0,8.267716535433074,0.013928717738631802,2.5421968733074696,2.5421968733074696,242.525,239.75,257.71592,223.1,249.8,0,936.0,2.3746819190200115,5380337.894361661
2015-06-23,243.8,247.5,247.7,242.3,38430.0,1237.6,0.1,245.13333333333333,58.3813129488404,1.2095186256566675,254.09165902138866,217.75834097861141,239.31152392147382,52.117263843648225,6.228227457047701,11487990.0,6.1846689895470455,-0.014949494949494935,2.5546462087972523,2.5546462087972523,242.825,239.75,257.33560159999996,223.1,249.8,0,937.0,2.374637289776512,5385632.594804027
2015-06-24,240.6,243.8,244.5,239.1,47110.0,1237.6,0.1,243.96666666666667,53.39520018856536,0.6610116343455701,254.18672869870989,219.30327130129007,239.4342359289525,40.33333333333332,6.169068352972865,11440880.0,5.1573426573426495,-0.01312551271534046,2.5640350594234684,2.5640350594234684,243.425,239.75,256.962889568,240.6,249.8,0,938.0,2.374584540512234,5390600.120195074
2015-06-25,242.6,240.6,243.6,239.3,40360.0,1237.6,0.1,242.33333333333334,55.928633383165206,0.38563105015469956,254.39927038317634,220.82072961682374,239.73573726905227,46.10169491525422,6.035563470617659,11481240.0,5.524140930839491,0.00831255195344971,2.487866228614039,2.487866228614039,244.175,239.75,256.59763177663996,240.6,249.8,0,939.0,2.3745358039133264,5395730.304054352
2015-06-26,242.9,242.6,243.5,240.1,37620.0,1237.6,0.1,242.03333333333333,56.31226490304922,0.18650775221867644,254.3576260847199,222.68237391528007,240.0370956243806,47.11864406779662,5.847308937002112,11518860.0,5.379609544468549,0.0012366034624897715,2.4072906286546365,2.4072906286546365,242.525,239.75,256.23967914110716,240.6,249.8,0,940.0,2.3744871039373914,5400862.620918482
2015-06-27,250.7,242.9,251.6,241.8,54700.0,1237.6,0.1,245.4,64.87372588925994,0.523826806010006,254.97908606503717,224.78091393496277,241.05261032682057,70.45454545454542,6.129644012930532,11573560.0,7.8279569892473075,0.03211198023878126,2.445011572768461,2.445011572768461,242.725,239.75,255.888885558285,240.6,249.8,0,941.0,2.374455541798374,5406690.380835234
2015-06-28,248.9,250.7,251.6,246.6,39890.0,1237.6,0.1,247.5,61.860945398033756,0.5658512311558632,255.5471636627292,226.2428363372709,241.7999807718853,61.90476190476191,6.048955154864066,11533670.0,6.458511548331905,-0.007179896290386845,2.4302752731474753,2.4302752731474753,242.725,239.75,255.5451078471193,240.6,249.8,0,942.0,2.3744192378384295,5412327.828888016
2015-06-29,257.0,248.9,257.5,248.0,92640.0,1237.6,0.1,252.20000000000002,68.86757022094622,1.0510928964453017,257.5469206907836,226.98307930921638,243.24760165075335,93.42105263157895,6.295458358088061,11626310.0,8.438818565400844,0.03254319003615902,2.449594691863059,2.449594691863059,244.3,239.75,238.7,240.6,249.8,0,943.0,2.3744002675391642,5418671.390054853
2015-06-30,264.1,257.0,268.7,255.4,116530.0,1237.6,0.1,256.6666666666667,73.46861874560298,1.7224840542507454,260.76823168675236,227.2917683132476,245.2335443506816,84.66666666666679,6.79578276108177,11742840.0,5.72457966373099,0.027626459143968995,2.573185445316838,2.573185445316838,249.64999999999998,244.85,239.076,240.6,249.8,0,944.0,2.374395909561162,5425612.947221957
2015-07-01,257.6,264.1,265.0,254.4,66940.0,1237.6,0.1,259.56666666666666,64.12507968605243,1.6035085562341944,261.82819895691887,229.00180104308117,246.41130203156905,63.000000000000114,7.0675125638616425,11675900.0,4.122877930476967,-0.02461188943581971,2.7435995977723766,2.7435995977723766,249.67499999999998,244.85,240.26095999999998,240.6,249.8,0,945.0,2.374376821734031,5431959.219692233
2015-07-02,254.9,257.6,261.3,253.1,45010.0,1237.6,0.1,258.86666666666673,60.67330624502681,1.2342358446498496,262.027891216383,231.24210878361694,247.2197494571339,54.000000000000064,7.148404523585812,11630890.0,2.616747181964573,-0.010481366459627384,2.8043956546040847,2.8043956546040847,249.67499999999998,244.85,241.39852159999998,240.6,249.8,0,946.0,2.374351113252095,5438038.768277305
2015-07-03,255.4,254.9,256.7,252.4,36580.0,1237.6,0.1,255.9666666666667,61.090997502767905,0.9288430254657936,262.1710527759231,233.388947224077,247.99882093740686,55.66666666666673,6.944947057615396,11667470.0,4.629250307251132,0.001961553550411832,2.719243170562019,2.719243170562019,249.925,244.85,242.49058073599997,240.6,249.8,0,947.0,2.3743258118695008,5444137.652476425
2015-07-04,260.5,255.4,261.1,253.4,32950.0,1237.6,0.1,256.93333333333334,65.15616758541469,0.9709423139189521,263.0162625325689,235.21373746743114,249.1894094195586,72.29729729729732,6.99887941064287,11700420.0,6.326530612244897,0.019968676585747858,2.6867099465039805,2.6867099465039805,251.25,244.85,243.53895750655997,240.6,249.8,0,948.0,2.374310907265726,5450664.441939788
2015-07-05,270.1,260.5,274.1,257.6,48450.0,1237.6,0.1,262.00000000000006,71.24608436847564,1.5136025223765035,266.29444523966646,235.2455547603335,251.18089423674348,88.57142857142858,7.6775308813112355,11748870.0,10.651372388365436,0.03685220729366612,2.8424771867127863,2.8424771867127863,254.45000000000005,247.55,244.54539920629756,240.6,249.8,0,949.0,2.3743155794466815,5457996.692278979
2015-07-06,269.1,270.1,277.5,266.5,90580.0,1237.6,0.1,266.5666666666667,69.87606306513223,1.6616404303994052,269.17899896810945,234.29100103189054,252.887475738006,78.12500000000006,7.914850104074718,11658290.0,8.727272727272736,-0.003702332469455727,2.941230064687743,2.941230064687743,257.525,249.25,246.3186752539197,240.6,249.8,0,950.0,2.374317432741255,5465219.286511466
2015-07-07,266.2,269.1,271.3,263.2,41610.0,1237.6,0.1,268.4666666666667,65.91739543667282,1.4295355579448739,271.08281084212365,234.2671891578764,254.15533519152922,70.57291666666664,7.928075096640812,11616680.0,9.1878589007383,-0.01077666295057611,2.978240081382724,2.978240081382724,258.0,249.25,248.81318123360614,240.6,249.8,0,951.0,2.374312483857337,5472168.164758719
2015-07-08,268.6,266.2,273.6,263.2,45290.0,1237.6,0.1,267.9666666666667,67.55556464723122,1.3063072937575377,273.2255501457713,234.14444985422867,255.53101755424075,76.70157068062832,8.104641161166471,11661970.0,11.637572734829604,0.009015777610819065,3.0173645425042706,3.0173645425042706,259.1,249.25,251.10812673491765,240.6,249.8,0,952.0,2.3743118344612917,5479298.703633737
2015-07-09,269.1,268.6,272.3,265.1,48390.0,1237.6,0.1,267.9666666666667,67.90170433882327,1.1335497077605705,275.0529795208019,234.81702047919813,256.823301596694,77.54010695187172,8.040023935368867,11710360.0,10.923330585325651,0.0018615040953089412,2.987745795380478,2.987745795380478,259.875,249.25,253.21947659612422,240.6,249.8,0,953.0,2.3743114956680786,5486447.374567303
2015-07-10,283.6,269.1,297.9,266.9,117170.0,1237.6,0.1,273.7666666666667,75.92371644257608,1.8296680448918927,279.9827226386901,233.7472773613099,259.3734633493898,74.50980392156869,9.68002222569966,11827530.0,16.7558666117744,0.053883314752879885,3.413265947002701,3.413265947002701,270.375,259.45,255.1619184684343,240.6,249.8,1,954.0,2.3743397641362436,5494781.176562822
2015-07-11,292.0,283.6,298.8,282.3,46490.0,1237.6,0.1,281.56666666666666,79.1712944231607,2.6404313713368106,286.2004825494906,232.31951745050944,262.4807525542098,86.97318007662834,10.167163495292543,11874020.0,16.473873155165542,0.02961918194640334,3.481905306607035,3.481905306607035,271.425,259.9,259.43572662159085,240.6,249.8,0,955.0,2.374383563714827,5503765.48246066
2015-07-12,310.4,292.0,315.9,291.3,120700.0,1237.6,0.1,295.3333333333333,84.19907108887543,4.112708963722918,296.77978581750597,228.03021418249412,267.0444904061898,91.899852724595,11.19808038848593,11994720.0,24.70871836078745,0.06301369863013684,3.607628991135931,3.607628991135931,280.97499999999997,268.45,264.15943942699994,240.6,310.4,0,956.0,2.3744606827504255,5514139.892582364
2015-07-13,290.4,310.4,310.9,276.9,146850.0,1237.6,0.1,297.59999999999997,65.64923012920389,3.4624596718815557,300.0539057021789,229.4160942978211,269.2688246532194,59.842519685039356,12.826788932165508,11847870.0,12.996108949416332,-0.06443298969072164,4.4169383375225575,4.4169383375225575,282.025,268.45,271.40311790721995,240.6,310.4,1,957.0,2.37449977843978,5522953.521391967
2015-07-14,287.0,290.4,297.0,285.2,60620.0,1237.6,0.1,295.93333333333334,63.10402068388481,2.567420364947152,301.81908923011514,232.29091076988487,270.95750801957945,54.48818897637797,12.753446865582259,11787250.0,8.670957970465723,-0.011707988980716122,4.4437097092621105,4.4437097092621105,283.42499999999995,268.45,276.9,240.6,310.4,0,958.0,2.374531513961918,5531471.830211872
2015-07-15,283.4,287.0,292.9,283.2,59580.0,1237.6,0.1,286.93333333333334,60.432416490597184,1.5472556552639034,302.6467197770756,235.54328022292438,272.14250725580996,48.81889763779525,12.535343518040667,11727670.0,10.01552795031054,-0.012543554006968716,4.4231981362175965,4.4231981362175965,283.42499999999995,268.45,276.9,240.6,310.4,0,959.0,2.374555434513458,5539674.428847274
2015-07-16,276.6,283.4,290.8,273.3,121320.0,1237.6,0.1,282.3333333333333,55.64062227525972,0.29440045421094396,302.21867681693055,239.3413231830695,272.56703037430424,38.11023622047249,12.88996183818062,11606350.0,8.513142408787767,-0.023994354269583518,4.660145277722566,4.660145277722566,283.525,268.45,315.9,240.6,310.4,0,960.0,2.374565059463256,5547289.840800476
2015-07-17,279.6,276.6,280.8,271.2,62120.0,1237.6,0.1,279.86666666666673,57.25108372408814,-0.41388179175748974,302.47323135324456,241.9767686467555,273.23683700532285,41.92000000000005,12.654964564024864,11668470.0,9.475332811276434,0.010845986984815648,4.526096052941654,4.526096052941654,284.0,268.45,315.048,240.6,310.4,0,961.0,2.374579950871878,5555131.52374163
2015-07-18,274.0,279.6,282.5,243.2,55340.0,1237.6,0.1,276.73333333333335,53.35697942437562,-1.2915955224045312,301.7726562909778,245.18734370902223,273.3095191952921,42.365887207702905,14.558181380880232,11613130.0,5.182341650671785,-0.02002861230329045,5.313204883532931,5.313204883532931,278.525,268.45,313.29408,240.6,310.4,0,962.0,2.374582834905153,5562478.770601824
2015-07-19,273.2,274.0,277.1,271.9,30200.0,1237.6,0.1,275.6,52.80441773731875,-1.9202258273178465,301.55806923856926,247.0219307614308,273.2990887957405,41.265474552957365,13.889739853674504,11582930.0,1.147723065531272,-0.0029197080291971655,5.084092186557286,5.084092186557286,278.525,268.45,309.0884352,273.2,310.4,0,963.0,2.3745833651445127,5569733.320385893
2015-07-20,277.7,273.2,278.9,271.8,46600.0,1237.6,0.1,274.9666666666667,55.59037137367788,-2.017171425867364,301.8634267061564,248.07657329384367,273.71822319614614,47.45529573590097,13.404758435554895,11629530.0,3.195837978446661,0.016471449487554857,4.827064614891932,4.827064614891932,278.575,268.45,305.135129088,273.2,310.4,0,964.0,2.374592254344688,5577343.553906392
2015-07-21,275.1,277.7,281.0,274.2,49050.0,1237.6,0.1,275.3333333333333,53.62088915112112,-2.224293173835603,301.5326215325476,250.15737846745233,273.84982098698936,43.87895460797805,12.932989975872403,11580480.0,3.343350864012034,-0.009362621534029447,4.701195919982698,4.701195919982698,277.525,268.45,301.41902134272,273.2,310.4,0,965.0,2.374595181499494,5584710.145811325
2015-07-22,276.5,275.1,277.4,273.1,41970.0,1237.6,0.1,276.43333333333334,54.55453550897723,-2.2292732641697732,300.7480035889559,253.10199641104413,274.10221898822846,45.80467675378269,12.316347834738655,11622450.0,2.9411764705882266,0.0050890585241729624,4.454375347102587,4.454375347102587,274.475,268.45,297.9258800621568,273.2,310.4,0,966.0,2.374600202159319,5592170.471586345
2015-07-23,275.5,276.5,277.9,274.5,35660.0,1237.6,0.1,275.70000000000005,53.72263018501288,-2.2553752435267684,299.63798009947965,256.22201990052037,274.23534098934954,44.42916093535078,11.679465846543035,11586790.0,2.3782980304719348,-0.003616636528028905,4.239370543209813,4.239370543209813,273.79999999999995,269.0,294.6423272584274,273.2,310.4,0,967.0,2.3746024842254125,5599521.613583755
2015-07-24,288.4,275.5,289.8,274.3,74360.0,1237.6,0.1,280.1333333333334,61.81245587908632,-1.4011417213738673,299.93120052312906,258.7187994768709,275.584356133221,62.17331499312242,11.952361143218534,11661150.0,1.6925246826516058,0.046823956442831216,4.144369328439159,4.144369328439159,273.275,269.0,291.55578762292174,273.2,310.4,0,968.0,2.3746294256037364,5607917.420903925
2015-07-25,288.7,288.4,291.2,284.7,41650.0,1237.6,0.1,284.2,61.978916386656515,-0.8408203732903239,300.79067383845495,259.71932616154504,276.83346507291424,62.585969738652004,11.56290677584578,11702800.0,-1.1301369863013737,0.0010402219140084323,4.00516341387107,4.00516341387107,273.375,269.0,243.2,273.2,310.4,0,969.0,2.374656180911034,5616314.159785496
2015-07-26,291.8,288.7,293.3,286.8,30990.0,1237.6,0.1,289.6333333333334,63.73792227051272,-0.3134845944414204,301.84315623563765,260.9368437643623,278.2588493516843,71.7872968980798,11.201270577571082,11733790.0,-5.992268041237103,0.010737790093522825,3.838680801086731,3.838680801086731,273.9,269.0,244.16,273.2,310.4,0,970.0,2.374688092476105,5624937.616429265
2015-07-27,293.0,291.8,295.8,285.4,69710.0,1237.6,0.1,291.1666666666667,64.4240477868223,0.04499358928811592,302.52798979693154,262.9320102030685,279.66276846104773,92.56505576208178,11.144036964887436,11803500.0,0.8953168044077213,0.004112405757368043,3.8034255852858143,3.8034255852858143,281.67499999999995,269.04999999999995,246.1256,273.2,310.4,0,971.0,2.374721507584898,5633634.194459301
2015-07-28,293.7,293.0,296.7,291.7,49070.0,1237.6,0.1,292.8333333333333,64.84195235050618,0.246831703563819,303.2151092040426,264.7548907959574,280.9996476552337,94.39252336448598,10.70517718168119,11852570.0,2.3344947735191597,0.0023890784982933955,3.6449360509639734,3.6449360509639734,281.9,269.04999999999995,249.106064,273.2,310.4,0,972.0,2.374755472642066,5642363.770351894
2015-07-29,288.4,293.7,294.7,286.9,50670.0,1237.6,0.1,291.7,59.17414493818218,-0.04355839283108054,302.99599678597457,266.9040032140254,281.70444311664,84.4859813084112,10.497664525846819,11801900.0,1.7642907551164433,-0.018045624787197845,3.6399668952312134,3.6399668952312134,282.22499999999997,269.45,252.91357888,273.2,310.4,0,973.0,2.3747785940650874,5650642.528346028
2015-07-30,287.0,288.4,289.9,284.9,44790.0,1237.6,0.1,289.7,57.73845385987043,-0.378256699652189,303.17597961893523,267.0640203810648,282.2087818674362,81.86915887850469,10.104974202572047,11757110.0,3.7599421547360725,-0.004854368932038722,3.520896934694093,3.520896934694093,282.22499999999997,271.7,256.4164925696,273.2,310.4,0,974.0,2.3747982731664328,5658783.169966039
2015-07-31,283.7,287.0,288.7,280.8,49210.0,1237.6,0.1,286.36666666666673,54.38873356522677,-0.8435725337910798,302.48886628378114,266.92113371621895,282.3508026419661,75.70093457943925,9.94747604524547,11707900.0,1.4663805436337503,-0.011498257839721249,3.506336286656845,3.506336286656845,282.525,271.85,259.639173164032,273.2,310.4,0,975.0,2.3748108166783126,5666627.704332897
2015-08-01,280.5,283.7,284.5,276.3,39430.0,1237.6,0.1,283.73333333333335,51.28183096134516,-1.3580598398237766,296.5821950329557,269.83780496704435,282.1745357236836,34.939759036144565,9.822656327727936,11668470.0,2.3722627737226274,-0.011279520620373629,3.501838263004612,3.501838263004612,282.525,272.2,262.60403931090946,273.2,310.4,0,976.0,2.3748163628213836,5674180.702691187
2015-08-02,281.4,280.5,282.5,275.9,35670.0,1237.6,0.1,281.8666666666666,52.110415783244974,-1.611648882362883,295.7338814546536,269.78611854534637,282.10077041666614,38.554216867469776,9.592466590033085,11704140.0,3.001464128843334,0.0032085561497325887,3.40883674130529,3.40883674130529,282.92499999999995,272.45,265.3317161660367,273.2,310.4,0,977.0,2.374822956122043,5681784.554959838
2015-08-03,281.6,281.4,285.0,278.9,45890.0,1237.6,0.1,281.1666666666667,52.304546905000954,-1.7294174820040533,295.32369003830956,269.65630996169045,282.0530779960313,36.01694915254242,9.343004690745008,11750030.0,1.4043932301044415,0.0007107320540158391,3.317828370292972,3.317828370292972,282.92499999999995,272.45,267.84117887275374,273.2,310.4,0,978.0,2.3748292195221286,5689380.5426324345
2015-08-04,284.3,281.6,285.7,279.6,44840.0,1237.6,0.1,282.43333333333334,54.95903184963903,-1.592396982908566,295.3874355668256,269.6825644331743,282.26707056783783,47.45762711864409,9.111361498548934,11794870.0,3.3442384587422715,0.009588068181818121,3.204840484892344,3.204840484892344,282.92499999999995,274.0,270.14988456293344,273.2,284.3,0,979.0,2.3748400232853677,5697177.25143525
2015-08-05,281.7,284.3,285.5,280.5,38290.0,1237.6,0.1,282.53333333333336,51.96009388604529,-1.6374666771891153,295.360584711914,270.21941528808605,282.2130638470914,33.03571428571422,8.817692820081152,11756580.0,1.8806509945750411,-0.009145269081955787,3.1301713951299797,3.1301713951299797,282.92499999999995,274.6,272.2738937978988,273.2,284.3,0,980.0,2.374845037554702,5704732.347182973
2015-08-06,278.0,281.7,282.0,276.5,33260.0,1237.6,0.1,281.3333333333333,47.9502084291689,-1.8607716615728167,295.38073794218025,270.0392620578198,281.81181967117794,16.51785714285711,8.580714761503927,11723320.0,0.9074410163339384,-0.013134540291089736,3.0865880437064486,3.0865880437064486,282.42499999999995,275.79999999999995,274.22798229406686,273.2,284.3,0,981.0,2.374842053698016,5711949.911438762
2015-08-07,277.9,278.0,279.6,274.3,42810.0,1237.6,0.1,279.20000000000005,47.842744902728846,-1.9501003917706878,295.1463193733113,270.66368062668874,281.43926541678,16.071428571428434,8.346377992825076,11680510.0,-3.640776699029127,-0.0003597122302159139,3.0033745925962854,3.0033745925962854,279.575,277.29999999999995,296.7,273.2,284.3,0,982.0,2.3748381688100717,5719133.844713661
2015-08-08,258.6,277.9,278.9,257.4,82540.0,1237.6,0.1,271.5,32.639027437535745,-3.171627113792123,297.8921085126815,266.45789148731853,279.2640972818486,3.0534351145039316,9.285922421908998,11597970.0,-10.426047800484922,-0.06944944224541183,3.590843937319798,3.590843937319798,271.575,277.29999999999995,296.252,273.2,284.3,0,983.0,2.3747939871559436,5724587.3795589935
2015-08-09,263.9,258.6,266.8,258.6,57480.0,1237.6,0.1,266.8,38.42579159675463,-3.4616158438617814,299.0324528065872,263.93754719341285,277.8008499216725,16.539440203562336,9.208356534629782,11655450.0,-9.56134338588075,0.020494972931167643,3.489335556888891,3.489335556888891,270.75,277.29999999999995,294.69792,273.2,284.3,0,984.0,2.374760325789555,5730495.337067557
2015-08-10,263.3,263.9,266.6,260.5,48570.0,1237.6,0.1,261.93333333333334,38.027514403674715,-3.521167412855291,299.9870376073222,261.8029623926779,276.4198165957989,15.012722646310515,8.986331067870514,11606880.0,-10.136518771331055,-0.002273588480484867,3.4129628058756225,3.4129628058756225,270.75,277.29999999999995,293.2060032,273.2,284.3,0,985.0,2.3747247631557187,5736323.150380634
2015-08-11,269.0,263.3,269.9,261.4,51360.0,1237.6,0.1,265.40000000000003,43.969052299928954,-3.023086907100798,300.22731843756026,260.8126815624397,275.713167396199,31.099195710455817,8.951593134451192,11658240.0,-8.409942117807283,0.021648309912647212,3.327729789758808,3.327729789758808,270.75,277.5,291.773763072,273.2,284.3,0,986.0,2.3747003163397227,5742632.919768102
2015-08-12,267.7,269.0,271.5,263.7,56730.0,1237.6,0.1,266.6666666666667,42.95749136819393,-2.641437043328251,300.5162796998227,259.7437203001773,274.950008596561,31.69230769230773,8.869336481990393,11601510.0,-7.177531206657417,-0.004832713754646889,3.3131626753793024,3.3131626753793024,270.75,277.5,290.39881254912,273.2,284.3,0,987.0,2.374672546335273,5748801.74989599
2015-08-13,263.4,267.7,268.4,261.3,56490.0,1237.6,0.1,266.70000000000005,39.70372764737684,-2.5382029889425537,300.13206813464046,257.6279318653595,273.8500077778409,19.16932907348242,8.742955304705363,11545020.0,-8.222996515679451,-0.016062756817332824,3.319269288043039,3.319269288043039,274.25,277.5,289.0788600471552,273.2,284.3,0,988.0,2.374635234820897,5754559.882326939
2015-08-14,265.0,263.4,267.2,260.2,52330.0,1237.6,0.1,265.36666666666673,41.47991296125344,-2.2325769752253186,299.265301342341,256.124698657659,273.007149894237,26.85512367491173,8.61845849722641,11597350.0,-6.591469862530838,0.006074411541381997,3.2522484895194,3.2522484895194,273.375,277.5,287.811705645269,273.2,284.3,0,989.0,2.374600602291045,5760435.693574977
2015-08-15,260.5,265.0,266.5,259.4,38910.0,1237.6,0.1,262.9666666666667,38.082125528965115,-2.200316277802373,297.92046580501193,254.33953419498806,271.8159927614525,10.954063604240359,8.509997175995954,11558440.0,-7.130124777183601,-0.016981132075471694,3.2667935416491183,3.2667935416491183,272.775,277.6,286.5952374194582,273.2,284.3,0,990.0,2.3745559389108255,5765878.031160793
2015-08-16,257.1,260.5,261.9,254.6,69040.0,1237.6,0.1,260.86666666666673,35.70250275215825,-2.2658724276588718,296.1855171563373,252.48448284366265,270.41446964131416,8.038585209003308,8.423568806281956,11489400.0,-8.635394456289964,-0.01305182341650668,3.2763783766168633,3.2763783766168633,271.2,278.0,285.4274279226799,273.2,284.3,0,991.0,2.3745034518152983,5770981.429141082
2015-08-17,257.1,257.1,259.9,252.9,47880.0,1237.6,0.1,258.23333333333335,35.70250275215825,-2.1671572820793883,293.68182459669976,251.32817540330024,269.14642491356994,12.804878048780546,8.321885320118957,11537280.0,-8.70028409090909,0.0,3.236828206969645,3.236828206969645,268.5,278.85,283.5777822473191,273.2,284.3,0,992.0,2.3744503501088037,5776058.315802156
2015-08-18,246.7,257.1,257.5,245.7,94500.0,1237.6,0.1,253.63333333333335,29.224296250280418,-2.6294191959218334,293.08535682488554,247.7546431751145,267.0086701598966,2.512562814070351,8.570322082967603,11442780.0,-13.225466056982068,-0.04045118630882938,3.4739854410083515,3.4739854410083515,264.9,279.54999999999995,281.1235596675335,273.2,284.3,0,993.0,2.3743740442482917,5780125.691702318
2015-08-19,226.0,246.7,247.9,214.3,245820.0,1237.6,0.1,243.26666666666668,21.040784040526844,-4.070387088400713,295.93845113056324,238.80154886943677,263.1030825256208,17.28212703101919,10.35815621989849,11196960.0,-19.772807951721685,-0.08390758005674903,4.583254964556853,4.583254964556853,249.2,265.1,277.5812037007802,273.2,284.3,1,994.0,2.3742492425735735,5782080.249195464
2015-08-20,234.7,226.0,238.0,225.5,90980.0,1237.6,0.1,235.80000000000004,29.922699356689492,-4.163734457824584,295.77900840920483,234.0609915907951,260.39802704699025,31.24042879019904,10.511145061334313,11287940.0,-15.575539568345329,0.03849557522123881,4.478544977134347,4.478544977134347,249.2,265.1,269.9874592566866,273.2,284.3,0,995.0,2.374144589658095,5784908.143463426
2015-08-21,232.4,234.7,236.3,230.5,57650.0,1237.6,0.1,231.03333333333333,28.994144912793146,-4.100030276719153,295.5620134807878,229.46798651921216,257.73154828061024,28.018575851393198,10.174634699810435,11230290.0,-16.37279596977329,-0.009799744354495044,4.378070008524284,4.378070008524284,248.425,265.1,263.3049641458842,273.2,284.3,0,996.0,2.3740340307250705,5787475.448191063
2015-08-22,229.5,232.4,235.1,221.0,74210.0,1237.6,0.1,232.20000000000002,27.82182261279017,-3.9701745047149295,294.7314693743221,225.10853062567782,255.0428293967426,26.57342657342656,10.455017935538262,11156080.0,-11.252900232018568,-0.012478485370051695,4.555563370604907,4.555563370604907,248.125,265.1,257.42436844837806,273.2,284.3,0,997.0,2.373916100140774,5789717.873027428
2015-08-23,226.8,229.5,232.7,224.3,48840.0,1237.6,0.1,229.5666666666667,26.737861169178288,-3.783851087706088,293.3350881619636,221.0249118380363,252.35303612086236,21.853146853146857,10.30823094014267,11107240.0,-14.058355437665771,-0.0117647058823529,4.545075370433276,4.545075370433276,247.45,265.1,252.2494442345727,273.2,284.3,0,998.0,2.373791208526352,5791652.883062399
2015-08-24,211.4,226.8,228.4,207.8,196700.0,1237.6,0.1,222.5666666666667,21.574709774637284,-4.37376239463396,292.6004463688739,214.46955363112613,248.45274696649452,5.651491365777072,11.043357301561048,10910540.0,-19.711355867831372,-0.0679012345679012,5.223915469044961,5.223915469044961,241.85,261.85,247.695510926424,211.4,284.3,1,999.0,2.3736274795767702,5791889.63493294
2015-08-25,220.5,211.4,226.6,196.3,190790.0,1237.6,0.1,219.5666666666667,30.157232998642286,-3.8457770101170823,289.82297961775623,211.12702038224376,245.79058058873312,32.18085106382978,12.418831780020971,11101330.0,-18.029739776951672,0.043046357615893927,5.632123256245338,5.632123256245338,235.3,256.1,242.11013939672463,211.4,284.3,1,1000.0,2.3734862930777205,5793104.819829652
2015-08-26,225.0,220.5,230.7,218.8,92810.0,1237.6,0.1,218.9666666666667,34.003467636832625,-2.9295894528058213,286.5347339179612,209.11526608203877,243.81052529456804,39.805825242718456,12.381772367162329,11194140.0,-15.950691072095626,0.020408163265306145,5.503009940961035,5.503009940961035,233.95,256.1,234.7805170932487,211.4,284.3,0,1001.0,2.3733556475905173,5794775.45845463
2015-08-27,222.7,225.0,228.4,222.0,60250.0,1237.6,0.1,222.73333333333335,33.003078882607355,-2.245395346997446,282.6592163104826,207.47078368951742,241.79999907603775,37.23554301833566,11.954502912365019,11133890.0,-15.451784358390277,-0.010222222222222244,5.367985142507867,5.367985142507867,231.55,256.1,230.7,211.4,284.3,0,1002.0,2.373218927554935,5796176.611729075
2015-08-28,231.6,222.7,234.8,219.6,90660.0,1237.6,0.1,226.43333333333337,40.319893269332056,-1.0226012827842883,281.20709383322503,206.22290616677492,240.8285705926056,50.28490028490027,12.186324132910375,11224550.0,-12.603773584905662,0.039964077233947126,5.261797984849039,5.261797984849039,229.075,256.1,196.3,211.4,284.3,0,1003.0,2.3731030604375225,5798484.045441665
2015-08-29,228.5,231.6,233.1,226.4,43740.0,1237.6,0.1,227.60000000000002,38.73315099484622,-0.28980533511310647,278.79520895462264,205.09479104537735,239.65442101235743,49.08536585365855,11.79444383770249,11180810.0,-12.284069097888676,-0.013385146804835935,5.161682204683803,5.161682204683803,228.65,256.1,197.07000000000002,211.4,284.3,0,1004.0,2.3729793615351387,5800445.507847719
2015-08-30,228.4,228.5,232.3,225.4,39810.0,1237.6,0.1,229.5,38.68027001358907,0.28956842791905935,276.13388373108796,204.26611626891201,238.5825713921329,50.471698113207566,11.444840706438027,11141000.0,-11.162971606378846,-0.00043763676148789177,5.010875966041168,5.010875966041168,228.3,256.1,197.82460000000003,211.4,284.3,0,1005.0,2.3728549349329935,5802371.113766943
2015-08-31,229.5,228.4,231.8,224.2,54510.0,1237.6,0.1,228.80000000000004,39.65621777522607,0.8183296194335377,271.8798882036376,204.57011179636237,237.71756459288216,54.24836601307189,11.170209227406742,11195510.0,-10.735122520420077,0.004816112084063073,4.867193563140193,4.867193563140193,227.35000000000002,256.1,198.56410800000003,211.4,284.3,0,1006.0,2.3727326305368934,5804385.454614239
2015-09-01,227.2,229.5,231.4,225.8,66540.0,1237.6,0.1,228.36666666666667,38.284181666482084,1.0688041005397046,267.29347198367117,205.1065280163288,236.71589177451244,59.88372093023252,10.772337139734832,11128970.0,-7.90433725172274,-0.010021786492374729,4.741345572066388,4.741345572066388,226.75,256.1,199.28882584000004,211.4,284.3,0,1007.0,2.3726043665032055,5806135.072888142
2015-09-02,228.6,227.2,230.6,225.6,58770.0,1237.6,0.1,228.43333333333337,39.65284284662041,1.3654129120658212,263.06555190866527,205.8544480913348,235.94294970074935,77.45803357314146,10.360027344039485,11187740.0,1.1504424778761038,0.0061619718309859906,4.531945469833546,4.531945469833546,226.575,253.6,199.99904932320004,211.4,284.3,0,1008.0,2.372478955767058,5808005.3638571175
2015-09-03,226.2,228.6,229.6,225.4,54150.0,1237.6,0.1,227.33333333333334,38.0932357204028,1.4297699293772332,257.6263816588401,207.41361834116,235.01504972924943,74.74999999999994,9.920025390893807,11133590.0,-3.621644652748189,-0.01049868766404205,4.385510782888509,4.385510782888509,230.35000000000002,246.65,200.69506833673603,211.4,284.3,0,1009.0,2.372347336312337,5809599.725117732
2015-09-04,230.3,226.2,231.1,225.8,61760.0,1237.6,0.1,228.36666666666667,42.270536095540415,1.7567384002805433,252.5882205012216,209.4317794987785,234.56599737408283,87.62886597938149,9.590023577258535,11195350.0,-0.9036144578313229,0.01812555260831128,4.164143976230367,4.164143976230367,230.55,246.5,201.3771669700013,211.4,284.3,0,1010.0,2.3722249808771547,5811595.516303242
2015-09-05,233.7,230.3,235.6,228.3,48280.0,1237.6,0.1,230.0666666666667,45.55165541423306,2.182490088293097,247.88033259115076,211.79966740884925,234.483521433694,95.1653944020356,9.42645046459721,11243630.0,1.830065359477119,0.01476335214937019,4.03356887659273,4.03356887659273,230.75,246.5,202.04562363060128,211.4,284.3,0,1011.0,2.372110077765481,5813913.854778315
2015-09-06,239.9,233.7,243.6,234.7,66270.0,1237.6,0.1,234.63333333333335,51.01869600153432,2.821553698339816,242.91249439258218,215.04750560741775,234.99937653524694,92.17758985200847,9.460275431411693,11309900.0,5.7760141093474395,0.02652973898160038,3.94342452330625,3.94342452330625,233.89999999999998,246.5,203.38779868537722,211.4,284.3,0,1012.0,2.3720088540628836,5816828.213588345
2015-09-07,239.6,239.9,242.7,237.5,57190.0,1237.6,0.1,237.73333333333335,50.75314689665057,3.1395706117026787,241.0091632740906,216.2408367259094,235.4375311509377,91.54334038054968,9.155970043453715,11252710.0,13.339640491958368,-0.0012505210504377695,3.8213564455149065,3.8213564455149065,233.125,246.5,205.80053076425457,211.4,284.3,0,1013.0,2.371906432481777,5819686.937874384
2015-09-08,243.2,239.6,246.4,239.2,76350.0,1237.6,0.1,240.9,53.85690681904257,3.4814238755907123,243.32397033739633,215.64602966260364,236.17681389846746,88.40579710144921,9.016257897492737,11329060.0,10.294784580498861,0.015025041736226985,3.7073428854822112,3.7073428854822112,233.525,246.5,208.0684989183993,211.4,243.2,0,1014.0,2.371811559741117,5822873.868467274
2015-09-09,237.4,243.2,244.3,236.5,69260.0,1237.6,0.1,240.0666666666667,48.54815367707869,3.212475880104085,243.71022356101332,215.52977643898663,236.29330781289912,66.4179104477612,8.929382333386114,11259800.0,5.511111111111114,-0.023848684210526216,3.7613236450657594,3.7613236450657594,233.65,246.5,211.13501900492736,211.4,243.2,0,1015.0,2.3717031079438287,5825461.642320783
2015-09-10,238.1,237.4,240.6,234.3,60540.0,1237.6,0.1,239.5666666666667,49.19899949658527,2.982281119234181,244.43241890355398,215.37758109644608,236.46537373548014,69.02985074626862,8.741569309572819,11320340.0,6.915132465199823,0.0029486099410278577,3.671385682306938,3.671385682306938,232.5,246.5,213.95621748453317,211.4,243.2,0,1016.0,2.3715957400366805,5828093.6102917
2015-09-11,239.9,238.1,241.0,237.4,45770.0,1237.6,0.1,238.4666666666667,50.91831572232267,2.851845533065962,245.5878328487568,215.26216715124323,236.79248099876776,70.72072072072075,8.374314358889047,11366110.0,3.583765112262527,0.007559848803023961,3.490752129591099,3.490752129591099,232.0,246.5,216.5517200857705,211.4,243.2,0,1017.0,2.371491931363187,5830878.674338892
2015-09-12,235.6,239.9,240.3,233.3,43770.0,1237.6,0.1,237.86666666666667,46.8399985071378,2.394987031779266,246.09211725834336,215.63788274165665,236.6789113798375,51.35135135135133,8.276149047539828,11322340.0,3.107221006564549,-0.01792413505627355,3.5127967094821,3.5127967094821,231.5,246.5,218.93958247890887,211.4,243.2,0,1018.0,2.3713778471116878,5833208.520534916
2015-09-13,230.2,235.6,236.2,228.3,51600.0,1237.6,0.1,235.23333333333335,42.26208217843453,1.6818241586184515,244.15983306238246,219.4501669376175,236.06187220080537,27.027027027027007,8.24928125842984,11270740.0,0.7880910683012184,-0.022920203735144362,3.583527914174561,3.583527914174561,229.72500000000002,246.5,221.13641588059616,211.4,243.2,0,1019.0,2.3712507582899005,5834962.428117631
2015-09-14,229.9,230.2,232.6,226.0,61100.0,1237.6,0.1,231.9,42.01639530878297,1.1670367148791554,243.54103301962763,221.00896698037238,235.47502722930008,21.428571428571427,8.131475454256279,11209640.0,0.17429193899782383,-0.0013032145960033548,3.5369619200766764,3.5369619200766764,228.775,246.5,223.15750261014847,211.4,243.2,0,1020.0,2.37112249191584,5836660.342315364
2015-09-15,229.5,229.9,242.8,228.0,49520.0,1237.6,0.1,229.86666666666667,41.66856849582555,0.7945314764550937,243.34785693117956,221.65214306882044,234.9059770169858,19.523809523809497,8.607798636095117,11160120.0,1.0123239436619769,-0.0017398869073510514,3.7506747869695496,3.7506747869695496,228.775,246.5,225.01690240133658,211.4,243.2,0,1021.0,2.3709928152315367,5838291.958580484
2015-09-16,228.6,229.5,230.9,225.1,51910.0,1237.6,0.1,229.33333333333337,40.84917084569768,0.497013578131261,242.85292722181566,222.7370727781843,234.30540777727285,16.4319248826291,8.407241590659753,11108210.0,0.0,-0.0039215686274509665,3.677708482353348,3.677708482353348,228.55,246.5,246.4,211.4,243.2,0,1022.0,2.3708605532636904,5839805.457073295
2015-09-17,232.7,228.6,235.2,227.9,56060.0,1237.6,0.1,230.26666666666668,46.05361673574358,0.5800481962994599,242.8932066591971,222.8067933408029,234.15251179848497,35.68075117370888,8.328152905612628,11164270.0,2.873563218390805,0.017935258092738326,3.57892260662339,3.57892260662339,228.025,246.5,245.97400000000002,211.4,243.2,0,1023.0,2.3707373962864606,5841715.843394479
2015-09-18,232.2,232.7,234.7,230.6,53170.0,1237.6,0.1,231.16666666666666,45.52752852828035,0.6023696466525976,242.88533501964992,223.18466498035014,233.96655829386734,33.333333333333286,8.026141983783154,11111100.0,0.8250108554059823,-0.0021486892995272733,3.4565641618359835,3.4565641618359835,227.65,245.5,245.55652,211.4,243.2,0,1024.0,2.37061260389471,5843550.112006602
2015-09-19,231.1,232.2,233.4,230.2,34470.0,1237.6,0.1,232.0,44.32781242511657,0.5458036117546556,242.83480211899555,223.50519788100442,233.69355274207047,28.169014084507026,7.681417556370072,11076630.0,-1.1125374411638829,-0.004737295434969813,3.323850089299036,3.323850089299036,227.65,243.1,245.1473896,211.4,243.2,0,1025.0,2.3704847831848963,5845246.755110729
2015-09-20,231.1,231.1,232.7,229.9,33150.0,1237.6,0.1,231.4666666666667,44.32781242511657,0.5117131477896741,242.81796739121435,223.68203260878565,233.44654771901614,28.169014084507026,7.332744873772208,11109780.0,-3.6681950812838733,0.0,3.17297484801913,3.17297484801913,233.275,242.5,244.746441808,211.4,243.2,0,1026.0,2.3703564931076424,5846918.514073267
2015-09-21,226.3,231.1,231.6,225.0,53430.0,1237.6,0.1,229.5,39.11188988159404,0.18600593061667947,242.89406084196716,223.51593915803286,232.7659241267289,6.074766355140238,7.28040595421705,11056350.0,-5.550918196994985,-0.02077022933794892,3.2171480133526513,3.2171480133526513,233.45,241.0,244.35351297184,226.3,243.2,0,1027.0,2.3702164606565495,5848067.914349039
2015-09-22,230.0,226.3,233.2,224.1,71550.0,1237.6,0.1,229.13333333333335,44.53011754979906,0.23661928992723302,242.84952348680295,223.70047651319706,232.50250278132614,29.20792079207921,7.41037695748726,11127900.0,-5.427631578947364,0.016349977905435242,3.221903024994461,3.221903024994461,233.225,241.0,243.5793724529664,226.3,243.2,0,1028.0,2.3700846864970146,5849577.31497418
2015-09-23,229.9,230.0,232.2,228.5,43600.0,1237.6,0.1,228.73333333333335,44.41508038566102,0.277403434374901,242.61432138387883,224.30567861612113,232.2546453735808,31.016042780748695,7.145350031952455,11084300.0,-3.1592249368155008,-0.00043478260869567187,3.108025242258571,3.108025242258571,234.35,241.0,242.4106101057884,226.3,243.2,0,1029.0,2.3699522178714925,5851051.75670064
2015-09-24,233.8,229.9,235.8,229.6,72120.0,1237.6,0.1,231.23333333333335,49.855777143985534,0.5645272418562266,242.6740873432743,224.5959126567257,232.4018220046683,51.87165775401074,7.077825029670138,11156420.0,-1.8059638807223783,0.016963897346672585,3.027298986172001,3.027298986172001,232.6,241.0,241.3119734994411,226.3,243.2,0,1030.0,2.3698283112734155,5852900.071828787
2015-09-25,235.0,233.8,237.6,232.7,61580.0,1237.6,0.1,232.9,51.431056275871235,0.817406109213028,242.75869747807826,224.64130252192172,232.64926752803322,58.28877005347591,6.9222660989794145,11218000.0,-2.0425177157148835,0.0051325919589391145,2.945645148501878,2.945645148501878,233.05,240.9,240.27925508947465,226.3,243.2,0,1031.0,2.369706676368446,5854844.725472432
2015-09-26,234.3,235.0,235.7,232.7,40290.0,1237.6,0.1,234.3666666666667,50.43570542561927,0.9124479883243706,242.02990127698,224.81009872302002,232.806480144411,54.54545454545459,6.642104234766599,11177710.0,-0.5517826825127262,-0.0029787234042553123,2.8348716324227907,2.8348716324227907,233.05,239.15,239.30849978410617,226.3,243.2,0,1032.0,2.369582967920769,5856693.748198079
2015-09-27,232.5,234.3,234.8,231.8,36140.0,1237.6,0.1,233.93333333333337,47.870187659909654,0.8312993649277107,241.1987014943592,224.9312985056408,232.777291559229,44.91978609625667,6.381953932283271,11141570.0,0.9991311902693361,-0.007682458386683799,2.744926422487428,2.744926422487428,233.05,237.95000000000002,238.3959897970598,226.3,243.2,0,1033.0,2.3694546586600476,5858335.272519769
2015-09-28,238.9,232.5,240.4,232.4,64280.0,1237.6,0.1,235.23333333333335,56.368443236439774,1.165382036764102,240.07758604233396,225.62241395766603,233.36040664882626,79.14438502673795,6.4975286514058945,11205850.0,3.9147455415398,0.027526881720430163,2.7197692136483442,2.7197692136483442,233.75,237.6,224.1,226.3,243.2,0,1034.0,2.36934041796629,5860595.000404789
2015-09-29,236.7,238.9,240.4,234.8,57300.0,1237.6,0.1,236.03333333333333,53.1602673305997,1.190722424156253,239.96042510977065,225.66957489022934,233.67846315846185,77.30061349693243,6.433419462019758,11148550.0,3.1372549019607794,-0.009208874005860235,2.717963439805559,2.717963439805559,233.75,233.9,224.426,226.3,243.2,0,1035.0,2.369220743668619,5862610.54401464
2015-09-30,235.9,236.7,237.8,234.4,50520.0,1237.6,0.1,237.16666666666666,52.00125528656307,1.1078515760923586,239.5843822396594,225.82561776034063,233.8900380957512,72.39263803680984,6.216746643304062,11098030.0,3.193350831146112,-0.003379805661174462,2.635331345190361,2.635331345190361,233.75,233.9,224.74548,226.3,243.2,0,1036.0,2.3690987835719004,5864520.9817806035
2015-10-01,237.1,235.9,238.7,234.7,52880.0,1237.6,0.1,236.5666666666667,53.63421093860709,1.0866105586357782,238.9491287580484,226.1808712419516,234.1957487532987,79.75460122699381,6.058407597353772,11150910.0,1.8908465835840165,0.005086901229334417,2.5552119769522443,2.5552119769522443,234.85,233.9,225.05857039999998,226.3,243.2,0,1037.0,2.3689790628471905,5866526.638243757
2015-10-02,236.7,237.1,238.4,235.1,47940.0,1237.6,0.1,236.5666666666667,52.9871009578624,1.0005265468997282,239.12556684688892,226.11443315311104,234.43424887203216,77.30061349693243,5.861378483257075,11102970.0,1.937984496124031,-0.001687051876845258,2.4762900224998203,2.4762900224998203,235.125,233.9,225.36539899199997,226.3,243.2,0,1038.0,2.3688579658514275,5868467.410612865
2015-10-03,238.6,236.7,239.5,236.1,43310.0,1237.6,0.1,237.4666666666667,55.71999122410432,1.022813093103679,239.93910139071323,226.1408986092868,234.83098707469577,88.95705521472387,5.685565734452998,11146280.0,3.245348334054522,0.008027038445289403,2.382885890382648,2.382885890382648,235.675,232.35,225.66609101215997,226.3,243.2,0,1039.0,2.3687406642678086,5870572.497037597
2015-10-04,238.3,238.6,277.6,237.5,31850.0,1237.6,0.1,237.86666666666667,55.1746142428749,0.9691258496271987,240.56306975886773,226.35693024113223,235.16136925805807,26.542056074766375,8.1437396105635,11114430.0,3.1155344006923484,-0.0012573344509638762,3.4174316452217792,3.4174316452217792,252.77500000000003,236.95000000000002,225.96076919191677,226.3,243.2,0,1040.0,2.3686222143687963,5872622.848063133
2015-10-05,240.1,238.3,240.5,236.4,61240.0,1237.6,0.1,239.00000000000003,57.84093658803265,1.0024423408246959,241.40698051765955,226.57301948234036,235.63171504300493,29.906542056074752,7.854901066951821,11175670.0,6.0980998674326035,0.007553503986571508,3.2715123144322455,3.2715123144322455,252.77500000000003,236.95000000000002,228.0263384242401,226.3,243.2,0,1041.0,2.3685073018921337,5874826.307762083
2015-10-06,246.1,240.1,247.6,239.4,78840.0,1237.6,0.1,241.5,65.25905375342654,1.3542940010181121,243.55229532129206,226.17770467870795,236.62869456271875,35.84521384928714,7.8795509907409755,11254510.0,6.999999999999998,0.02498958767180337,3.201767976733432,3.201767976733432,252.925,236.95000000000002,230.0092848872705,226.3,243.2,0,1042.0,2.3684050625731743,5877588.65323321
2015-10-07,243.0,246.1,247.3,241.6,62600.0,1237.6,0.1,243.0666666666667,59.43970352031017,1.303525237937294,244.6916271402663,226.06837285973376,237.23548555674554,27.91666666666666,7.723868777116621,11191910.0,5.698129621574595,-0.012596505485574894,3.1785468218586916,3.1785468218586916,253.425,236.95000000000002,231.91291349177968,226.3,243.2,0,1043.0,2.368295572584433,5880025.778461516
2015-10-08,242.6,243.0,244.8,241.6,44150.0,1237.6,0.1,243.9,58.71218352102822,1.17239987066846,245.59680359702844,226.20319640297157,237.74639169419837,23.580786026200826,7.400735293036864,11147760.0,3.7639007698887865,-0.0016460905349794386,3.050591629446358,3.050591629446358,253.425,236.95000000000002,233.74039695210848,226.3,243.2,0,1044.0,2.3681847186057015,5882398.799520033
2015-10-09,244.0,242.6,244.6,241.3,40570.0,1237.6,0.1,243.20000000000002,60.532955795933894,1.1099820075017672,246.58879908198807,226.50120091801196,238.34197343760806,26.637554585152806,7.107825629248516,11188330.0,3.829787234042553,0.00577081615828523,2.9130432906756214,2.9130432906756214,253.5,236.95000000000002,235.49478107402413,226.3,243.2,0,1045.0,2.36807644185212,5884882.851599563
2015-10-10,245.4,244.0,245.9,242.9,38960.0,1237.6,0.1,244.0,62.322334976804186,1.0913708508271585,247.6804414493506,226.83955855064937,239.01416644355015,29.694323144104786,6.814409512873622,11227290.0,4.737516005121637,0.0057377049180327155,2.7768579922060397,2.7768579922060397,253.60000000000002,236.95000000000002,237.17898983106318,226.3,243.2,0,1046.0,2.3679707197479196,5887477.098683497
2015-10-11,247.6,245.4,248.3,244.5,41430.0,1237.6,0.1,245.66666666666666,65.00721919930925,1.1497591928147108,248.39512909546573,228.25487090453424,239.83186487749774,33.62831858407076,6.599094547668364,11268720.0,6.494623655913976,0.008964955175223999,2.665223969171391,2.665223969171391,253.85000000000002,236.95000000000002,238.79583023782064,226.3,247.6,0,1047.0,2.367869249951592,5890257.269586838
2015-10-12,245.4,247.6,248.0,244.6,40390.0,1237.6,0.1,246.13333333333335,60.37406570355421,0.969930260895874,248.85132615277624,229.3386738472237,240.3621634605932,25.46296296296295,6.370587794263481,11228330.0,2.7208036835496023,-0.008885298869143687,2.5960015461546377,2.5960015461546377,253.925,236.95000000000002,240.34799702830782,245.4,247.6,0,1048.0,2.3677625420891184,5892801.062873741
2015-10-13,248.8,245.4,251.2,243.1,74880.0,1237.6,0.1,247.26666666666668,64.57603772307205,1.00538653661002,249.71169064845165,230.3683093515484,241.1657669405367,33.33333333333333,6.494117237530375,11303210.0,5.111956062526414,0.013854930725346382,2.6101757385572246,2.6101757385572246,247.32500000000002,236.95000000000002,241.8380771471755,245.4,247.6,0,1049.0,2.367662651198212,5895645.192111605
2015-10-14,252.3,248.8,255.1,248.3,69580.0,1237.6,0.1,248.83333333333334,68.3023136857281,1.178011020235341,251.56656120575397,230.36343879424604,242.22617008905704,41.02564102564104,6.515966006278204,11372790.0,6.952098346757103,0.014067524115755736,2.582626241093224,2.582626241093224,249.05,236.95000000000002,243.1,245.4,247.6,0,1050.0,2.3675696745320405,5898794.494108492
2015-10-15,254.4,252.3,256.8,251.2,60640.0,1237.6,0.1,251.83333333333337,70.3196696753885,1.3355309637626043,253.66586100844046,230.20413899155955,243.3855824615278,45.41176470588235,6.45053986297262,11433430.0,7.296499367355551,0.00832342449464929,2.5355895687785455,2.5355895687785455,249.95000000000002,236.95000000000002,243.1,245.4,247.6,0,1051.0,2.3674805852283924,5902114.500481282
2015-10-16,262.9,254.4,267.3,253.9,95180.0,1237.6,0.1,256.53333333333336,76.76542744066649,1.8807153216673638,257.7065863836379,229.02341361636198,245.24409841757276,64.57831325301196,6.946929872760291,11528610.0,11.068863540346426,0.033411949685534514,2.6424229261165046,2.6424229261165046,252.57500000000002,248.20000000000002,244.48,245.4,247.6,0,1052.0,2.3674084029451126,5906186.732998445
2015-10-17,269.6,262.9,275.4,261.7,113840.0,1237.6,0.1,262.3,80.38202361235051,2.5211424337609487,262.711780927034,227.72821907296594,247.56370809208963,80.58252427184468,7.429292024705984,11642450.0,12.992455993294227,0.025484975275770427,2.755672115988866,2.755672115988866,254.60000000000002,248.60000000000002,245.8048,245.4,247.6,0,1053.0,2.367349012936911,5910829.056208194
2015-10-18,261.7,269.6,272.4,259.5,52270.0,1237.6,0.1,264.73333333333335,67.1163161982301,2.2502095262305986,264.9904481964163,227.72955180358366,248.9100216071287,64.87179487179488,7.820056880084127,11590180.0,9.819555182543004,-0.02930267062314551,2.9881761100818216,2.9881761100818216,256.1,248.60000000000002,247.076608,245.4,247.6,0,1054.0,2.367273315230171,5914741.646754044
2015-10-19,263.8,261.7,266.0,259.9,58170.0,1237.6,0.1,265.03333333333336,68.59979338359871,2.0553045205815295,267.2576994041088,228.17230059589122,250.32811478740214,67.77777777777784,7.697195674363833,11648350.0,9.870887130362355,0.008024455483377935,2.917814887931703,2.917814887931703,256.425,250.85000000000002,248.29754368,245.4,247.6,0,1055.0,2.3672013139672297,5918817.957033672
2015-10-20,269.8,263.8,272.1,262.7,75400.0,1237.6,0.1,265.1,72.42714826305652,2.1624740075288846,270.38750223452155,228.43249776547847,252.1825800457448,83.57771260997076,7.818824554766418,11723750.0,9.630231613165387,0.022744503411675554,2.8980076185197987,2.8980076185197987,256.975,250.85000000000002,249.4696419328,245.4,247.6,0,1056.0,2.3671406701085274,5923401.442595739
2015-10-21,267.1,269.8,272.2,263.5,59640.0,1237.6,0.1,266.90000000000003,68.387529864956,1.893217541784928,272.43523170605505,229.38476829394494,253.6032867080548,75.65982404692092,7.881765657997387,11664110.0,9.917695473251039,-0.010007412898443202,2.950866962934252,2.950866962934252,256.975,250.85000000000002,250.594856255488,245.4,247.6,0,1057.0,2.367074153117953,5927721.059822348
2015-10-22,274.4,267.1,278.7,266.8,93150.0,1237.6,0.1,270.43333333333334,72.80410909273074,2.036001062776558,275.5786322828332,230.01136771716682,255.58392606919244,88.5026737967914,8.168782396711858,11757260.0,13.107996702390759,0.027330587794833328,2.9769615148366833,2.9769615148366833,259.375,251.39999999999998,251.67506200526847,245.4,247.6,0,1058.0,2.3670213377438936,5932654.246397239
2015-10-23,276.9,274.4,279.8,273.2,69320.0,1237.6,0.1,272.8,74.13674819890672,2.118593072216454,278.8001556657353,230.61984433426466,257.614028348317,92.140921409214,8.056726511232442,11826580.0,13.48360655737704,0.009110787172011747,2.909615930383692,2.909615930383692,260.8,251.95,253.29655828495237,245.4,247.6,0,1059.0,2.3669727453163176,5937777.029246192
2015-10-24,282.6,276.9,283.0,277.0,60130.0,1237.6,0.1,277.96666666666664,76.91435522577088,2.3585164207650777,282.66258924218357,231.18741075781648,259.99364469609634,98.99749373433589,7.916960331858698,11886710.0,15.158924205378979,0.020585048754063084,2.801472162724238,2.801472162724238,263.575,253.55,255.4168336221562,245.4,247.6,0,1060.0,2.366934335358704,5943357.796584316
2015-10-25,287.9,282.6,295.6,281.8,113900.0,1237.6,0.1,282.46666666666664,79.1559424140172,2.6535722247382356,287.1511114381905,231.47888856180944,262.65139282027764,85.33333333333326,8.33717745101165,12000610.0,16.2762520193861,0.018754423213021676,2.8958587881249223,2.8958587881249223,271.275,259.85,258.17515025994055,245.4,247.6,0,1061.0,2.366905139732649,5949354.367005858
2015-10-26,285.1,287.9,287.6,279.6,73210.0,1237.6,0.1,285.2,75.01202255659545,2.444745566091747,290.5512612840793,231.97873871592066,264.78935540882264,80.00000000000001,8.33452191879653,11927400.0,16.17766911165445,-0.009725599166377052,2.923367912590855,2.923367912590855,271.35,259.85,262.6661322287477,245.4,247.6,0,1062.0,2.3668701888485724,5955093.769430655
2015-10-27,294.7,285.1,298.4,285.1,105870.0,1237.6,0.1,289.23333333333335,79.05972117820632,2.7168091418894207,295.27950842758065,232.42049157241937,267.63798822703,92.61477045908187,8.689198924596774,12033270.0,18.44855305466237,0.033672395650648834,2.9484896249055903,2.9484896249055903,272.95,261.25,266.618196361298,245.4,247.6,0,1063.0,2.366852099105747,5961594.996492494
2015-10-28,303.5,294.7,307.5,294.0,116410.0,1237.6,0.1,294.4333333333334,81.94662083925809,3.2187770893951377,301.170908448929,232.61909155107097,271.0534179196938,92.89520426287744,9.032827572839862,12149680.0,20.29330162504954,0.02986087546657612,2.9762199581020963,2.9762199581020963,278.45000000000005,265.8,271.06764887071625,245.4,247.6,0,1064.0,2.366848889711984,5968771.253154874
2015-10-29,313.6,303.5,318.5,300.2,138920.0,1237.6,0.1,303.93333333333334,84.57505053080881,3.914157372713275,308.55655968526384,232.19344031473616,275.10547335591343,92.41486068111459,9.694768460494158,12288600.0,23.27044025157233,0.03327841845140034,3.0914440243922696,3.0914440243922696,284.225,271.3,276.89682505140166,245.4,247.6,0,1065.0,2.3668622740024032,5976702.570178412
2015-10-30,327.1,313.6,334.9,310.8,156490.0,1237.6,0.1,314.73333333333335,87.24760566244231,4.902370678161034,318.1621464003699,230.75785359963004,280.0573330363026,89.65517241379315,10.723713570458857,12445090.0,24.419931532902265,0.043048469387755084,3.278420535144866,3.278420535144866,293.25,279.5,284.38539654214935,245.4,247.6,0,1066.0,2.366897169482333,5985614.781448086
2015-10-31,311.2,327.1,333.3,304.6,105830.0,1237.6,0.1,317.3,71.52843333531132,4.134909463682094,322.306560198871,232.97343980112896,283.0233013185595,68.56763925729445,12.007734029711795,12339260.0,15.430267062314526,-0.04860898807704073,3.858526359161888,3.858526359161888,295.59999999999997,279.5,294.4883172337195,245.4,247.6,0,1067.0,2.3669051599377955,5993316.4994347505
2015-11-01,323.0,311.2,324.3,304.7,73710.0,1237.6,0.1,320.43333333333334,75.11214594896252,4.065582050888668,327.76398771731704,235.2760122826829,286.8306059548872,84.13333333333335,12.55003874187524,12412970.0,23.423767672907918,0.03791773778920304,3.885460910797288,3.885460910797288,297.025,279.5,302.5706537869756,245.4,247.6,0,1068.0,2.3669320562173572,6001882.922289443
2015-11-02,359.3,323.0,365.8,319.8,223100.0,1237.6,0.1,331.1666666666667,82.43617683626437,5.9917321170852915,341.9287854015134,232.16121459848657,293.7324530068027,93.69544131910766,14.939321688884151,12636070.0,36.20166793025019,0.11238390092879258,4.157896378759853,4.157896378759853,313.125,294.95,304.6,245.4,247.6,1,1069.0,2.367014220399467,6012972.236756339
2015-11-03,396.5,359.3,416.8,354.6,421990.0,1237.6,0.1,359.59999999999997,86.7420414537316,9.11141636694606,364.6746698373358,223.8353301626642,303.51983843472624,86.7579908675799,18.315084425392424,13058060.0,46.96071163825055,0.10353465070971324,4.619189010187244,4.619189010187244,338.625,320.45,304.7,245.4,247.6,1,1070.0,2.367147343651212,6026402.381353543
2015-11-04,400.9,396.5,492.8,368.6,517730.0,1237.6,0.1,385.56666666666666,87.14351593964864,10.701659582946785,383.44118982765514,219.71881017234494,312.79413953618086,59.33628318584069,25.878292680721536,13575790.0,50.09359790340694,0.011097099621689699,6.455049309234607,6.455049309234607,378.40000000000003,358.45,319.8,245.4,400.9,1,1071.0,2.3672854087641872,6040085.44146426
2015-11-05,382.7,400.9,447.2,366.1,302950.0,1237.6,0.1,393.3666666666666,76.7857662541121,9.783245162793726,394.6021572753393,220.5378427246608,319.4518405327351,49.86338797814207,29.822700346384284,13272840.0,39.46793002915452,-0.04539785482664005,7.792709784788158,7.792709784788158,380.67499999999995,358.45,354.40000000000003,245.4,400.9,1,1072.0,2.3673982469562542,6052640.8079428105
2015-11-06,369.8,382.7,396.4,348.8,255280.0,1237.6,0.1,384.4666666666667,70.39874642399663,7.656533162146985,401.80088544729534,223.35911455270474,324.2469033391413,43.00278035217795,31.092507464499693,13017560.0,33.55001805706033,-0.0337078651685393,8.407925220254109,8.407925220254109,382.225,358.45,492.8,245.4,400.9,0,1073.0,2.367492292109422,6064356.422867677
2015-11-07,385.1,369.8,391.8,369.0,103030.0,1237.6,0.1,379.20000000000005,73.241656782242,6.666176735784003,410.08545861273916,227.41454138726084,330.04243635446113,49.484052532833026,30.50018550274972,13120590.0,36.27034677990092,0.04137371552190383,7.92006894384568,7.92006894384568,383.32500000000005,358.45,489.92,245.4,400.9,0,1074.0,2.3676067932685387,6077032.432989034
2015-11-08,371.6,385.1,389.8,365.5,94360.0,1237.6,0.1,375.5,67.1166011333303,4.586839805714174,414.5871204627289,233.6928795372711,334.0002995587982,43.151969981238274,30.05731510969617,13026230.0,29.072594650920475,-0.03505582965463516,8.088620858368182,8.088620858368182,384.625,358.45,487.0976,245.4,400.9,0,1075.0,2.3677017879230924,6088832.601575559
2015-11-09,380.2,371.6,385.1,360.2,125540.0,1237.6,0.1,378.9666666666667,68.90082798754133,3.333869305425452,419.6420959969226,239.67790400307734,338.4002710293889,45.78719306692343,29.68893545900359,13151770.0,33.35671694142405,0.023143164693218532,7.808767874540661,7.808767874540661,385.375,358.45,484.331648,245.4,400.9,0,1076.0,2.3678079717889573,6101169.269612124
2015-11-10,336.7,380.2,381.4,323.2,210290.0,1237.6,0.1,362.8333333333333,53.18218537234849,-0.6679667894136188,418.4365274791383,247.84347252086167,338.23834045516134,21.478873239436613,31.72544006907476,12941480.0,14.251781472684085,-0.11441346659652818,9.422465122980327,9.422465122980327,389.82500000000005,358.45,481.62101504,245.4,400.9,0,1077.0,2.3678497849921083,6110548.86984587
2015-11-11,304.7,336.7,341.8,292.4,263960.0,1237.6,0.1,340.53333333333336,45.04169242734172,-5.4475301583965425,416.74035740312877,252.56964259687115,335.04421279276505,6.137724550898208,32.98790863556942,12677520.0,0.39538714991762397,-0.09504009504009503,10.826356624735615,10.826356624735615,384.375,358.45,475.2841744384,304.7,400.9,0,1078.0,2.3678386772358486,6117487.4391091615
2015-11-12,333.9,304.7,346.1,306.1,164610.0,1237.6,0.1,325.1,52.227564250579675,-6.545948257281633,415.2127981929703,259.7972018070297,334.93524014583505,20.708582834331335,33.58877230445732,12842130.0,6.473214285714271,0.09583196586806686,10.05953048950504,10.05953048950504,384.375,358.45,464.31112397209597,304.7,400.9,0,1079.0,2.3678747770349897,6126619.724535941
2015-11-13,333.8,333.9,341.8,323.9,97250.0,1237.6,0.1,324.1333333333334,52.20239105537006,-7.13445293438086,413.6321196935112,266.4978803064888,334.82712203670786,20.658682634730553,32.4681457112818,12744880.0,2.048303271170892,-0.0002994908655284956,9.72682615676507,9.72682615676507,373.075,360.65,453.9964565337702,304.7,400.9,0,1080.0,2.3679100281414582,6135722.590788771
2015-11-14,331.8,333.8,369.8,326.4,71110.0,1237.6,0.1,333.1666666666667,51.66602864835167,-7.477496069602548,411.9900050193559,272.52999498064406,334.53882469987855,19.660678642714586,33.24899244619024,12673770.0,6.619537275064275,-0.005991611743559,10.02079338342081,10.02079338342081,361.075,361.2,444.300669141744,304.7,400.9,0,1081.0,2.3679414515238135,6144657.226044584
2015-11-15,317.5,331.8,334.8,314.2,88320.0,1237.6,0.1,327.70000000000005,47.87815028729685,-8.416620316628105,409.61381473792164,278.14618526207835,332.9160794903663,12.524950099800408,32.34549298574809,12585450.0,-1.7027863777089782,-0.04309825195901151,10.18755684590491,10.18755684590491,360.125,362.3,435.18662899323937,304.7,400.9,0,1082.0,2.367949203387709,6152498.047518985
2015-11-16,330.2,317.5,332.0,314.1,87140.0,1237.6,0.1,326.5,51.293463650959694,-7.937866108378202,407.80020013644986,283.5097998635502,332.6574052531886,18.862275449101798,31.31367205819465,12672590.0,-8.099081547453387,0.040000000000000036,9.483244112112251,9.483244112112251,360.45000000000005,362.3,426.619431253645,304.7,400.9,0,1083.0,2.3679767640339255,6161269.459795042
2015-11-17,333.9,330.2,342.9,328.1,98250.0,1237.6,0.1,327.20000000000005,52.274630184799214,-7.151777211764909,406.54680728257654,287.8031927174235,332.7757476100278,20.708582834331335,30.134124054037887,12770840.0,-15.788146279949563,0.011205330102967759,9.024894894890053,9.024894894890053,360.875,362.3,418.5662653784263,304.7,400.9,0,1084.0,2.3680094568656407,6170289.57719548
2015-11-18,335.9,333.9,337.4,329.4,78360.0,1237.6,0.1,333.3333333333333,52.82779508001902,-6.306454647027341,405.9095071134716,290.67049288652834,333.07329545669177,28.100775193798448,28.553115193035183,12849200.0,-16.21351958094288,0.005989817310572132,8.500480855324556,8.500480855324556,360.9,362.6,410.9962894557207,304.7,400.9,0,1085.0,2.3680445774835586,6179432.9057208
2015-11-19,325.0,335.9,335.6,323.4,86380.0,1237.6,0.1,331.59999999999997,49.46293958889018,-6.277192949771727,405.96600985617516,290.40399014382484,332.3044101751021,31.346153846153868,27.406464107818383,12762820.0,-15.077083877710997,-0.032450133968442874,8.432758187021042,8.432758187021042,358.65000000000003,363.6,403.8805120883775,304.7,400.9,0,1086.0,2.368061833675131,6187748.629165642
2015-11-20,321.1,325.0,327.1,309.5,109990.0,1237.6,0.1,327.3333333333333,48.278053829095846,-6.299925701848666,405.34397797542465,292.01602202457536,331.237323491759,28.873239436619755,26.706002385831358,12652830.0,-13.169280692266087,-0.0119999999999999,8.317035934547294,8.317035934547294,362.07500000000005,363.6,397.19168136307485,304.7,400.9,0,1087.0,2.3680721483632667,6195745.936202979
2015-11-21,324.7,321.1,328.4,318.4,45000.0,1237.6,0.1,323.6,49.48107490421931,-5.861064595388498,405.27953883735944,292.25046116264053,330.6147212544486,33.162217659137575,25.51271650112912,12697830.0,-15.684237860296035,0.011211460604173107,7.8573195260637885,7.8573195260637885,364.3,363.75,390.9041804812904,304.7,400.9,0,1088.0,2.368087615738841,6203992.004163537
2015-11-22,322.8,324.7,326.9,319.4,36750.0,1237.6,0.1,322.86666666666673,48.8354660207195,-5.4935298245534,404.32649318436705,289.55350681563294,329.87046208735825,32.793959007551265,24.226093893905613,12661080.0,-13.13240043057051,-0.005851555281798482,7.5049857168233,7.5049857168233,366.125,363.95,384.99392965241293,304.7,400.9,0,1089.0,2.368099377670989,6212070.8604420945
2015-11-23,322.1,322.8,325.0,319.9,42730.0,1237.6,0.1,323.20000000000005,48.58395768442607,-5.100865736798705,396.7925900064521,289.64740999354797,329.1304180790384,33.37078651685398,22.859944330055214,12618350.0,-15.281430825881106,-0.0021685254027261625,7.097157507002549,7.097157507002549,359.4,364.45,379.43829387326815,304.7,400.9,0,1090.0,2.3681093637061967,6220072.743666546
2015-11-24,318.4,322.1,323.3,315.5,50660.0,1237.6,0.1,321.09999999999997,47.20023340398892,-4.892862267001143,386.6320371394705,291.5579628605294,328.10847350008237,33.59173126614986,21.784234020765556,12567690.0,-5.435105435105439,-0.01148711580254591,6.841782041697725,6.841782041697725,359.4,364.6,374.2159962408721,304.7,400.9,0,1091.0,2.3681127046668773,6227767.496122808
2015-11-25,327.5,318.4,330.0,315.7,77680.0,1237.6,0.1,322.6666666666667,50.90386934096722,-3.9834864609677494,379.64676629969506,293.0232337003049,328.0505236429317,33.594976452119276,21.24964587642516,12645370.0,7.482769937643588,0.02858040201005041,6.488441488984781,6.488441488984781,359.4,364.6,369.30703646641973,304.7,400.9,0,1092.0,2.3681300403895413,6236129.3521635765
2015-11-26,353.7,327.5,368.9,327.4,211380.0,1237.6,0.1,333.2,59.67433093080871,-1.581813822143383,376.8778463767993,294.18215362320063,330.4933309150334,73.30016583747924,22.69609974239479,12856750.0,5.929919137466311,0.08000000000000007,6.41676554775086,6.41676554775086,365.9,366.1,292.4,304.7,400.9,0,1093.0,2.3681866520664707,6246357.943372812
2015-11-27,359.5,353.7,363.9,345.1,103480.0,1237.6,0.1,346.90000000000003,61.321565537733015,0.3310268443657982,370.67205375866934,297.82794624133066,333.2558708278874,82.91873963515754,22.4178069036523,12960230.0,7.699221090473333,0.016398077466779792,6.23582945859591,6.23582945859591,365.9,367.05,293.92999999999995,304.7,359.5,0,1094.0,2.3682509838766577,6256965.95603119
2015-11-28,355.8,359.5,360.1,350.5,56170.0,1237.6,0.1,356.3333333333333,59.64767966535693,1.2301805489130881,367.19344927515414,299.7265507248458,335.402930749041,77.94612794612799,21.502249267677136,12904060.0,7.233273056057866,-0.010292072322670376,6.0433528014831746,6.0433528014831746,365.9,367.05,295.42939999999993,304.7,359.5,0,1095.0,2.368309227910271,6267299.287791843
2015-11-29,370.8,355.8,372.8,354.5,67370.0,1237.6,0.1,362.0333333333333,63.94459862574575,2.6374262641886084,364.27884146144436,301.70115853855566,338.77408020151324,96.84044233807266,21.27351717712877,12971430.0,16.787401574803155,0.042158516020236014,5.7371944922138,5.7371944922138,368.375,367.05,296.8988119999999,304.7,359.5,0,1096.0,2.3683881481163205,6278630.288647653
2015-11-30,378.0,370.8,382.6,367.9,129770.00000000001,1237.6,0.1,368.2,65.82570820299846,3.7855750569221094,371.9922697962288,298.1177302037712,342.50988208708344,93.70725034199724,20.803980235905293,13101200.0,14.476075105996369,0.01941747572815533,5.50369847510722,5.50369847510722,359.42499999999995,367.85,299.9348595199999,304.7,359.5,0,1097.0,2.3684762788667126,6290417.663475374
2015-12-01,361.8,378.0,379.0,353.7,111910.0,1237.6,0.1,370.20000000000005,58.438051767503964,3.209177636575779,373.8339697138192,301.98603028618083,344.3470361740279,71.54582763337892,21.1251245047692,12989290.0,8.355795148247989,-0.042857142857142816,5.838895661904146,5.838895661904146,346.725,367.95,304.89476794879994,304.7,359.5,0,1098.0,2.368540981286469,6301104.435102843
2015-12-02,360.0,361.8,363.4,347.2,92450.0,1237.6,0.1,366.6000000000001,57.663669147765525,2.49374375909985,376.3377302336372,302.09226976636285,345.83779463364425,69.08344733242131,20.773329897285684,12896840.0,7.174754391187861,-0.00497512437810943,5.77036941591269,5.77036941591269,345.57500000000005,367.95,309.55708187187196,360.0,359.5,0,1099.0,2.368602380375859,6311647.800910798
2015-12-03,360.3,360.0,371.4,355.5,87230.0,1237.6,0.1,360.70000000000005,57.76412489725137,1.8570020974921988,378.6729988330238,302.4070011669761,347.21514752567816,69.4938440492476,20.425234904622418,12984070.0,10.861538461538466,0.0008333333333334636,5.668952235532172,5.668952235532172,345.125,367.95,313.93965695955967,360.0,359.5,0,1100.0,2.3686634922565997,6322191.551984194
2015-12-04,361.7,360.3,364.0,354.3,60550.0,1237.6,0.1,360.6666666666667,58.26184625881522,1.3689291891227402,381.01521421182036,303.0547857881797,348.5946572851374,68.85245901639341,19.65914669714939,13044620.0,12.64403612581749,0.0038856508465168194,5.435207823375557,5.435207823375557,346.875,370.55,318.0592775419861,360.0,359.5,0,1101.0,2.368725891250192,6332811.240934421
2015-12-05,386.7,361.7,390.3,361.5,115200.0,1237.6,0.1,369.56666666666666,65.9730830745599,2.50260136301862,387.3300319708185,303.6599680291815,352.22373754369573,95.18716577540104,20.312064790210147,13159820.0,19.094548814290118,0.06911805363560952,5.252667388210537,5.252667388210537,354.52500000000003,372.0,321.93172088946693,360.0,359.5,0,1102.0,2.3688220878213686,6345071.505772883
2015-12-06,393.4,386.7,402.2,382.6,131860.0,1237.6,0.1,380.6000000000001,67.69563187442843,3.4197557848012643,394.7247069667195,302.58529303328044,356.14528634905804,89.85005767012686,20.26120301948085,13291680.0,21.871127633209404,0.017326092578225927,5.150280381159342,5.150280381159342,361.0,373.35,327.4011832183096,360.0,359.5,0,1103.0,2.3689263817146764,6357742.693308831
2015-12-07,394.3,393.4,398.7,381.7,96750.0,1237.6,0.1,391.4666666666667,67.93048358876771,3.775185558568076,401.2641873294916,302.0858126705084,359.7790686015287,90.88811995386392,20.02825994666079,13388430.0,22.415398944427192,0.0022877478393492634,5.079447107953535,5.079447107953535,364.42499999999995,376.15,334.8810648964786,360.0,359.5,0,1104.0,2.369031073437919,6370455.187889334
2015-12-08,410.7,394.3,411.1,388.0,74360.0,1237.6,0.1,399.4666666666667,71.93446321595361,4.740474366956965,410.64322738418656,300.1867726158135,364.6286811156688,99.58071278825992,20.247669950470733,13462790.0,28.98869346733669,0.04159269591681447,4.930038945817077,4.930038945817077,369.725,376.15,341.6129584068308,360.0,359.5,0,1105.0,2.3691559970601967,6384169.614489947
2015-12-09,416.0,410.7,424.6,403.3,147360.0,1237.6,0.1,407.0,73.1032001382308,5.318228400556521,419.264587688275,300.66541231172505,369.52118767608135,91.15226337448557,20.32283638257997,13610150.0,27.022900763358777,0.012904796688580467,4.885297207350954,4.885297207350954,376.475,376.35,349.9514033980111,360.0,359.5,0,1106.0,2.3692867175919003,6398191.839022249
2015-12-10,415.5,416.0,420.4,409.5,71660.0,1237.6,0.1,414.06666666666666,72.79521831738518,5.240532555545462,425.85735568456903,303.512644315431,373.9001221831212,88.55345911949684,19.64977664096711,13538490.0,17.4724342663274,-0.0012019230769231282,4.7291881205697015,4.7291881205697015,376.475,377.75,360.40220692228957,360.0,359.5,0,1107.0,2.369415999049404,6412171.793587495
2015-12-11,449.8,415.5,453.4,413.7,175060.0,1237.6,0.1,427.09999999999997,79.25265346625413,6.964996836487106,439.60374297982474,302.27625702017525,381.1286819752049,96.61016949152545,21.081935452326604,13713550.0,25.118219749652297,0.08255114320096268,4.686957637244688,4.686957637244688,392.65,378.15,369.38989795316905,360.0,359.5,0,1108.0,2.3695853018416035,6428130.854495071
2015-12-12,432.3,449.8,467.7,403.7,211440.0,1237.6,0.1,432.5333333333333,70.10904778387798,6.406991281164121,446.3029467433365,306.5270532566635,386.0021408347092,70.62240663900417,24.14751149144613,13502110.0,21.500843170320405,-0.03890618052467765,5.585822690595913,5.585822690595913,399.8,379.8,382.831514280662,360.0,359.5,0,1109.0,2.369733306928932,6443085.5120151015
2015-12-13,434.7,432.3,441.0,420.8,64140.0,1237.6,0.1,438.93333333333334,70.60984672786489,5.702998105370462,451.66498204538294,312.425017954617,390.6400321837845,72.61410788381743,23.865546384914264,13566250.0,17.233009708737857,0.005551700208188626,5.49011879110059,5.49011879110059,401.6,383.0,398.10784171014285,360.0,359.5,0,1110.0,2.3698833155056884,6458170.185260891
2015-12-14,442.0,434.7,449.5,428.8,218920.0,1237.6,0.1,436.3333333333333,72.13888530960122,5.2441154693111045,456.070084567708,320.379915432292,395.53145769009075,78.6721991701245,23.63943592884896,13785170.0,16.93121693121693,0.016793190706234196,5.348288671685285,5.348288671685285,406.65,384.9,403.7,360.0,359.5,0,1111.0,2.3700410387355806,6473666.216350229
2015-12-15,462.6,442.0,464.2,440.7,107060.0,1237.6,0.1,446.4333333333334,75.94249708857936,5.799741285871683,464.184468063843,325.77553193615705,401.91893791008215,95.76763485477181,23.62947621964546,13892230.0,27.860696517412936,0.046606334841629016,5.107971513109697,5.107971513109697,406.65,386.20000000000005,415.21999999999997,360.0,359.5,0,1112.0,2.3702213093513547,6490307.050644817
2015-12-16,454.0,462.6,465.2,437.4,185220.0,1237.6,0.1,452.86666666666673,71.55084071869365,5.085419955774121,471.01979778217935,328.97020221782066,406.8790390615029,87.91887125220458,23.92737077538507,13707010.0,26.111111111111114,-0.01859057501080852,5.270345985767637,5.270345985767637,409.725,386.20000000000005,424.66639999999995,360.0,359.5,0,1113.0,2.370391052044627,6506467.979781129
2015-12-17,455.5,454.0,458.4,447.3,64580.0,1237.6,0.1,457.36666666666673,71.85654281347304,4.24553396540405,477.1866701009134,332.40332989908666,411.5096067699312,89.24162257495591,23.011130005714705,13771590.0,26.422425756314176,0.0033039647577093323,5.051839737807839,5.051839737807839,413.55,388.95000000000005,432.412448,360.0,359.5,0,1114.0,2.3705616133666743,6522706.847365487
2015-12-18,463.2,455.5,466.1,453.5,83410.0,1237.6,0.1,457.56666666666666,73.43462315014116,3.7569677750070767,483.15358198375606,337.1764180162439,416.4325013632711,95.76271186440677,22.26747786244937,13855000.0,28.06192977605751,0.01690450054884729,4.807313873585787,4.807313873585787,413.65,392.6,437.4,360.0,463.2,0,1115.0,2.3707398993954087,6539366.851469056
2015-12-19,461.2,463.2,466.0,452.3,61310.0,1237.6,0.1,459.9666666666667,72.3006113182209,2.8866192475085946,488.55383713718186,340.81616286281826,420.69607266200717,92.44186046511628,21.6555151579887,13793690.0,19.265580553400568,-0.0043177892918825345,4.695471630092953,4.695471630092953,413.65,392.6,442.854,360.0,463.2,0,1116.0,2.370915080681757,6555912.104411396
2015-12-20,441.8,461.2,462.8,431.1,121530.0,1237.6,0.1,455.40000000000003,62.25756902187818,0.7055955158666265,490.63341875686615,345.11658124313385,422.7059705037208,69.88372093023258,22.372978360989503,13672160.0,12.302999491611601,-0.042064180398959206,5.064051236077298,5.064051236077298,413.7,392.6,467.7,360.0,463.2,0,1117.0,2.3710673576852974,6571353.643402983
2015-12-21,437.6,441.8,445.5,424.0,121990.0,1237.6,0.1,446.8666666666666,60.30455359784801,-1.2141808786301524,490.11399634033717,353.21600365966276,424.1244495033664,62.23337515683817,22.310622763775967,13550170.0,10.981486178037029,-0.009506564056133926,5.098405567590486,5.098405567590486,420.5,392.6,466.96799999999996,360.0,463.2,0,1118.0,2.371213897013879,6586541.656566512
2015-12-22,437.0,437.6,443.2,433.3,65790.0,1237.6,0.1,438.8,60.01491306410678,-2.6370636989572276,488.0649248600628,362.9650751399372,425.3506924078077,52.329192546583855,21.42414970922054,13484380.0,6.403700998295596,-0.0013711151736746086,4.902551420874265,4.902551420874265,425.725,392.6,465.24927999999994,360.0,463.2,0,1119.0,2.3713588984417324,6601684.678880307
2015-12-23,442.4,437.0,444.8,434.3,63250.0,1237.6,0.1,439.0,61.79349445056978,-3.2849970002798905,484.86047791248285,374.37952208751716,426.97443598801647,60.468749999999986,20.643853301419075,13547630.0,6.3461538461538405,0.012356979405034219,4.666332120573932,4.666332120573932,426.25,392.6,463.59930879999996,360.0,463.2,0,1120.0,2.3715093517622448,6617133.429371872
2015-12-24,453.0,442.4,460.6,441.8,79600.0,1237.6,0.1,444.1333333333334,65.07731982118395,-3.073902197541308,480.60539530205995,387.76460469793994,429.4530611320149,77.03125000000001,20.512149494174857,13627230.0,9.025270758122744,0.02396021699819184,4.528068321009902,4.528068321009902,426.25,392.6,462.01533644799997,360.0,463.2,0,1121.0,2.3716710747370273,6633182.991304339
2015-12-25,454.0,453.0,457.4,449.5,42390.0,1237.6,0.1,449.8,65.37963033734029,-2.9410946874490023,479.22879556800456,395.87120443199547,431.79086483372777,78.59375000000001,19.611281673162363,13669620.0,0.9337483325922608,0.002207505518763808,4.319665566775851,4.319665566775851,426.25,392.6,460.6,360.0,463.2,0,1122.0,2.3718330683999294,6649282.234376861
2015-12-26,415.4,454.0,456.5,400.5,208580.0,1237.6,0.1,440.8,48.07867261068272,-5.384794262308169,476.60473619984094,400.695263800159,430.22983008765846,22.7134146341463,22.21047583936505,13461040.0,-3.9093222299329247,-0.08502202643171808,5.346768377314649,5.346768377314649,420.375,380.04999999999995,460.6,415.4,463.2,0,1123.0,2.3719488080405444,6663076.524496337
2015-12-27,422.4,415.4,425.5,406.1,67580.0,1237.6,0.1,430.6000000000001,50.63011193881796,-6.392937287600496,473.1018440248009,407.0081559751991,429.4841319840719,33.38414634146337,22.009727565124685,13528620.0,-2.8295376121463103,0.016851227732306295,5.210636260682928,5.210636260682928,420.35,380.04999999999995,457.4,415.4,463.2,0,1124.0,2.3720722960539877,6677289.1613335395
2015-12-28,421.8,422.4,429.9,417.1,68350.0,1237.6,0.1,419.86666666666673,50.40148851984852,-6.9188962034906645,471.99737962939116,409.22262037060875,428.7523098903508,32.46951219512195,21.35188988190149,13460270.0,-4.570135746606333,-0.0014204545454544748,5.0620886396162845,5.0620886396162845,421.325,380.04999999999995,456.5,415.4,463.2,0,1125.0,2.3721942622955643,6691451.58468361
2015-12-29,431.9,421.8,433.6,419.3,70650.0,1237.6,0.1,425.3666666666666,54.15436784554053,-6.416441258743696,471.0138145659281,411.79618543407173,429.05208990079353,47.86585365853654,20.848183461765668,13530920.0,-6.636402939904896,0.023944997629208098,4.827085774893649,4.827085774893649,420.775,380.04999999999995,453.14,415.4,463.2,0,1126.0,2.3723275066098006,6706215.366166302
2015-12-30,427.1,431.9,435.0,420.8,68270.0,1237.6,0.1,426.9333333333334,52.13538294147032,-6.231994771649575,469.9501408006382,414.0198591993617,428.86617657690846,40.5487804878049,20.373313214496694,13462650.0,-5.9251101321585855,-0.011113683723083967,4.770150600444087,4.770150600444087,422.57500000000005,380.04999999999995,449.9816,415.4,463.2,0,1127.0,2.3724542428277546,6720676.31196358
2015-12-31,430.0,427.1,433.1,417.1,65209.99999999999,1237.6,0.1,429.6666666666667,53.26894833726212,-5.750938826518002,469.1843933953805,412.8056066046195,428.97415976006005,44.969512195121936,20.060933699175504,13527860.0,-5.598243688254665,0.006789978927651541,4.665333418412907,4.665333418412907,427.625,380.04999999999995,447.012704,415.4,463.2,0,1128.0,2.3725836285124844,6735300.844602694
2016-01-01,434.0,430.0,438.0,425.9,46970.0,1237.6,0.1,430.36666666666673,54.8570157473484,-5.02588458383935,469.1740990245198,412.98590097548026,429.45281121148287,51.14503816793893,19.492295577805827,13574830.0,-6.30397236614853,0.009302325581395321,4.49131234511655,4.49131234511655,427.625,380.04999999999995,444.22194176,415.4,463.2,0,1129.0,2.3727169280544302,6750154.772459186
2016-01-02,433.7,434.0,437.4,430.7,33570.0,1237.6,0.1,432.56666666666666,54.70685684371207,-4.448866423604711,469.17285699781604,412.887143002184,429.8573053818178,53.290529695024055,18.578560179391125,13541260.0,-5.962705984388552,-0.0006912442396314056,4.283735342262192,4.283735342262192,428.4,386.9,441.5986252544,415.4,463.2,0,1130.0,2.3728490677976777,6764978.708953536
2016-01-03,430.7,433.7,434.1,423.1,54830.0,1237.6,0.1,432.8,53.14036503812375,-4.157050483162436,468.9588080992962,411.97119190070373,429.9375620121209,50.24958402662226,18.03723445229176,13486430.0,-2.5124490719782755,-0.00691722388747984,4.187888194170364,4.187888194170364,431.3,388.6,439.13270773913604,415.4,463.2,0,1131.0,2.3729768701777125,6779608.6020882195
2016-01-04,433.3,430.7,435.3,428.6,53010.0,1237.6,0.1,432.56666666666666,54.360106435125886,-3.6924375662869355,465.7504766312587,412.2495233687413,430.2577942014427,54.57570715474209,17.227431991413777,13539440.0,-0.9826325411334578,0.006036684467146669,3.9758670647158496,3.9758670647158496,428.07500000000005,388.6,437.4,415.4,463.2,0,1132.0,2.3731069354428564,6794383.796060078
2016-01-05,431.2,433.3,435.3,428.9,45030.0,1237.6,0.1,431.73333333333335,53.15657758754706,-3.4354018368819386,463.8899366115155,411.8300633884844,430.3475280870196,51.081530782029915,16.45404399202708,13494410.0,-1.3272311212814671,-0.004846526655896688,3.815872910952477,3.815872910952477,430.82500000000005,388.6,400.5,415.4,463.2,0,1133.0,2.3732337302453304,6809018.78395995
2016-01-06,430.8,431.2,432.1,425.0,43430.0,1237.6,0.1,431.7666666666667,52.91625715098269,-3.2056257006252764,461.50855882906455,411.74144117093545,430.3906206501606,50.41597337770382,15.785897992596578,13450980.0,-2.622061482820969,-0.0009276437847866026,3.6643217253009697,3.6643217253009697,430.82500000000005,388.6,401.196,415.4,463.2,0,1134.0,2.3733592583099883,6823616.408627095
2016-01-07,457.0,430.8,457.5,428.5,130199.99999999999,1237.6,0.1,439.6666666666667,64.30085095669602,-1.3001244670445544,459.99176286994316,412.63823713005695,432.9248472549072,99.12280701754386,16.729762421696822,13581180.0,0.8830022075055187,0.06081708449396461,3.6607795233472262,3.6607795233472262,435.3,388.6,401.87808,415.4,457.0,0,1135.0,2.373513975012645,6839759.426644989
2016-01-08,452.9,457.0,462.9,446.5,91310.0,1237.6,0.1,446.90000000000003,61.783263008747106,-0.3749126970335972,458.0598736458382,413.74012635416176,434.82724275443985,83.97435897435898,16.706207963004193,13489870.0,-0.24229074889868343,-0.00897155361050328,3.6887189143307997,3.6887189143307997,436.65,388.6,404.1029568,415.4,457.0,0,1136.0,2.373663281476778,6855655.680303273
2016-01-09,448.3,452.9,454.5,444.9,39810.0,1237.6,0.1,452.73333333333335,58.992497348203,-0.14368283128446002,458.9059942462741,413.54400575372597,436.11036249211224,74.29577464788737,16.198621679932465,13450060.0,7.920077034183929,-0.010156767498343933,3.6133441177632086,3.6133441177632086,438.15,388.6,407.630779392,415.4,457.0,0,1137.0,2.373806581802646,6871272.093983682
2016-01-10,446.2,448.3,448.9,438.6,44460.0,1237.6,0.1,449.1333333333334,57.71088578884745,-0.1996771883340287,459.7463382028742,413.56366179712586,437.0712803500063,63.53711790393012,15.777291559937286,13405600.0,5.6344696969697,-0.004684363149676574,3.5359237023615613,3.5359237023615613,438.15,388.6,410.94693262848,415.4,457.0,0,1138.0,2.3739466838801646,6886753.538026543
2016-01-11,447.7,446.2,451.1,441.8,56590.0,1237.6,0.1,447.40000000000003,58.40598551995883,-0.20256411260680274,460.77897199963405,413.60102800036606,438.0835393642914,66.81222707423579,15.314627877084623,13462190.0,6.140350877192977,0.003361721201255108,3.4207343929159313,3.4207343929159313,438.15,391.6,414.06411667077117,415.4,457.0,0,1139.0,2.374087674826879,6902313.389814006
2016-01-12,445.0,447.7,448.4,443.1,44590.0,1237.6,0.1,446.3,56.602505335948614,-0.4395854929833112,461.0506215679135,413.5893784320866,438.7422499010256,60.9170305676856,14.599297314435718,13417600.0,3.033109516091693,-0.006030824212642338,3.280740969536117,3.280740969536117,438.625,391.6,416.9942696705249,415.4,457.0,0,1140.0,2.374224789058145,6917701.37054911
2016-01-13,432.2,445.0,443.7,420.4,92040.0,1237.6,0.1,441.6333333333334,48.894455386351886,-1.454489262389723,458.9711083907225,413.58889160927754,438.1191784818803,32.96943231441044,15.313633220547455,13325560.0,1.1940997424490671,-0.028764044943820233,3.5431821426532757,3.5431821426532757,437.45,391.6,419.7486134902934,415.4,457.0,0,1141.0,2.3743463209415743,6932299.077632814
2016-01-14,429.1,432.2,433.7,427.0,46170.0,1237.6,0.1,435.4333333333334,47.2174002352366,-2.2814052962394005,456.3937710320495,413.6762289679506,437.2602091026536,20.470588235294226,14.698373704794065,13279390.0,-0.20930232558139006,-0.007172605275335364,3.4253958762046297,3.4253958762046297,436.67499999999995,391.6,420.4,415.4,457.0,0,1142.0,2.374463428265492,6946690.598510607
2016-01-15,372.3,429.1,430.1,364.7,268140.0,1237.6,0.1,411.20000000000005,28.1592658478328,-6.368954717318981,466.7569892404787,399.0030107595212,431.0735225214485,7.739307535641572,18.319918440165917,13011250.0,-14.21658986175115,-0.13237007690515035,4.920740918658587,4.920740918658587,413.79999999999995,391.7,462.9,415.4,457.0,1,1143.0,2.3745079465611547,6957267.011628409
2016-01-16,385.0,372.3,386.7,350.4,183960.0,1237.6,0.1,395.4666666666667,34.52293491595675,-7.836086110104745,470.63569368477357,391.3843063152263,426.68556799559633,30.755555555555574,19.60420998015407,13195210.0,-11.22896011067558,0.03411227504700509,5.092002592247811,5.092002592247811,406.65,397.54999999999995,460.936,415.4,457.0,1,1144.0,2.3745687568985527,6968719.155165645
2016-01-17,382.5,385.0,390.7,377.7,66090.0,1237.6,0.1,379.9333333333334,33.88659994459451,-8.536049261465985,473.8605095920988,384.2294904079011,422.4774186626824,28.533333333333353,19.13248069585735,13129120.0,-11.191084281402366,-0.00649350649350644,5.0019557374790455,5.0019557374790455,404.54999999999995,406.4,456.51455999999996,415.4,457.0,0,1145.0,2.3746255870527575,6979975.15876074
2016-01-18,384.4,382.5,387.3,373.2,69300.0,1237.6,0.1,383.9666666666667,34.86916876501013,-8.418219892862563,475.4846740232842,377.85532597671573,418.85099783766503,30.22222222222222,18.773017789010396,13198420.0,-11.28548349873068,0.004967320261437758,4.883719508067221,4.883719508067221,403.7,407.45,452.26997759999995,415.4,457.0,0,1146.0,2.3746842375820907,6991342.434194693
2016-01-19,379.5,384.4,386.7,375.9,66350.0,1237.6,0.1,382.1333333333334,33.486951657614,-8.208764114218635,477.2539462275943,371.3260537724058,415.1032837578874,25.86666666666669,18.203516518366797,13132070.0,-11.989795918367346,-0.012747138397502522,4.7967105450241885,4.7967105450241885,403.7,407.45,448.1951784959999,415.4,457.0,0,1147.0,2.3747357285251214,7002343.145349802
2016-01-20,414.6,379.5,425.7,374.0,190320.0,1237.6,0.1,392.8333333333333,49.06317759186063,-5.381442708300571,476.57719932299005,370.4628006770099,415.05535197142194,57.066666666666706,20.596122481340597,13322390.0,-3.760445682451251,0.09249011857707523,4.967709233319005,4.967709233319005,403.025,407.45,444.28337135615993,415.4,457.0,1,1148.0,2.374831174658445,7015702.956557334
2016-01-21,410.2,414.6,423.4,403.9,89940.0,1237.6,0.1,401.4333333333334,47.559606786807514,-3.5700390280290115,475.46116223083675,369.19883776916333,414.5929374979532,53.155555555555566,20.517828018387696,13232450.0,-10.240700218818382,-0.010612638687891973,5.001908341879009,5.001908341879009,401.84999999999997,407.45,440.52803650191356,415.4,457.0,0,1149.0,2.3749205027242697,7028757.639362375
2016-01-22,382.6,410.2,411.5,374.9,144860.0,1237.6,0.1,402.4666666666667,39.40254775270169,-3.962782630198509,475.3326052399623,364.2173947600377,411.5459910695767,30.931796349663824,21.666554588502862,13087590.0,-15.522190328990938,-0.06728425158459284,5.6629781987723105,5.6629781987723105,399.34999999999997,407.45,436.92291504183703,415.4,457.0,0,1150.0,2.374973996978548,7039913.512733245
2016-01-23,388.6,382.6,395.4,380.3,61380.0,1237.6,0.1,393.8,41.741811436677,-3.5631492914932696,474.5859766673601,360.7540233326398,409.3606585867599,37.93445878848066,21.19751497503837,13148970.0,-13.316975239794775,0.015682174594877196,5.454841733154495,5.454841733154495,398.45,409.04999999999995,433.46199844016354,415.4,457.0,0,1151.0,2.375034655831956,7051467.739198046
2016-01-24,402.1,388.6,405.4,385.5,64540.00000000001,1237.6,0.1,391.1000000000001,46.72508554028175,-2.2010652604988827,472.9371026887653,359.2828973112346,408.6691672927828,51.34061569016884,21.104835333964196,13213510.0,-9.883460331689818,0.03474009264024702,5.248653403124645,5.248653403124645,397.34999999999997,409.04999999999995,430.139518502557,415.4,457.0,0,1152.0,2.3751118249641636,7063924.631207272
2016-01-25,392.8,402.1,403.8,386.9,67660.0,1237.6,0.1,394.50000000000006,43.93690359954248,-1.7571645390724058,471.44123230114326,356.9387676988566,407.1578180268035,43.26530612244902,20.804489952966755,13145850.0,-12.26267589903953,-0.023128574981347905,5.296458745663634,5.296458745663634,403.04999999999995,409.04999999999995,426.94993776245474,415.4,457.0,0,1153.0,2.3751765101631475,7075727.706129236
2016-01-26,389.8,392.8,397.7,387.9,56810.0,1237.6,0.1,394.90000000000003,43.044599948043675,-1.505977121770968,469.8001214011857,354.47987859881425,405.5046925004413,42.229367631296924,20.018454956326273,13089040.0,-12.40449438202247,-0.0076374745417515655,5.135570794337166,5.135570794337166,403.04999999999995,409.04999999999995,423.88794025195654,415.4,457.0,0,1154.0,2.375236650326029,7087301.673917077
2016-01-27,395.0,389.8,397.4,389.4,43680.0,1237.6,0.1,392.53333333333336,45.12489695391832,-0.8620090597072245,463.2850145174602,354.79498548253974,404.50424559563737,53.541416566626665,19.159993888017254,13132720.0,-8.60712633040259,0.01334017444843516,4.850631364055001,4.850631364055001,403.25,409.04999999999995,420.94842264187827,415.4,395.0,0,1155.0,2.3753027713358223,7099214.004278991
2016-01-28,379.7,395.0,395.4,376.7,77320.0,1237.6,0.1,388.1666666666667,40.44411370802274,-1.3119089841007998,457.11360996489094,353.64639003510905,402.14193649129095,36.76286072772898,19.12713718173031,13055400.0,-11.512467956187376,-0.0387341772151899,5.037434074724864,5.037434074724864,403.25,409.04999999999995,418.1264857362031,415.4,395.0,0,1156.0,2.375348352555781,7110031.045814702
2016-01-29,380.3,379.7,385.8,363.5,138460.0,1237.6,0.1,385.0,40.70387421860832,-1.406148712552751,450.8420752731549,353.11792472684505,400.06175206354897,39.707835325365245,19.353770240178143,13193860.0,2.1488047273704,0.0015801948907032681,5.08907973709654,5.08907973709654,400.04999999999995,409.04999999999995,415.417426306755,415.4,395.0,0,1157.0,2.3753940684444865,7120868.048660034
2016-01-30,377.8,380.3,381.8,375.0,36180.0,1237.6,0.1,379.2666666666667,39.92253435539633,-1.4671571786664117,444.0195380530803,353.1004619469197,397.9415852003538,22.990353697749217,18.457072365879704,13157680.0,-1.870129870129867,-0.006573757559821147,4.885408249306432,4.885408249306432,397.075,409.04999999999995,412.81672925448476,415.4,395.0,0,1158.0,2.375435815645492,7131502.295103425
2016-01-31,369.8,377.8,380.5,366.9,39020.0,1237.6,0.1,375.9666666666667,37.44546522600455,-1.851791971749254,435.7547201255916,353.57527987440847,395.2614342288915,10.128617363344071,18.110138625459726,13118660.0,-3.3202614379084934,-0.021175224986765495,4.897279238902035,4.897279238902035,395.54999999999995,409.04999999999995,410.32006008430534,415.4,395.0,0,1159.0,2.3754661732005276,7141529.321239015
2016-02-01,372.2,369.8,379.8,365.3,74350.0,1237.6,0.1,373.2666666666667,38.67478548217324,-1.7511819732739156,426.09036040025023,355.9596395997497,393.0651071594733,13.98713826366558,17.85227158078403,13193010.0,-3.173777315296563,0.006489994591671211,4.7964190168683585,4.7964190168683585,395.54999999999995,409.04999999999995,407.92325768093315,415.4,395.0,0,1160.0,2.3754991410608257,7151708.63836257
2016-02-02,373.9,372.2,376.6,371.4,50980.0,1237.6,0.1,371.9666666666667,39.580529588087074,-1.3923851493015356,418.3617371401947,357.85826285980534,391.2398588585711,16.720257234726656,16.948537896442318,13243990.0,-1.4756258234519164,0.0045674368619021966,4.53290663183801,4.53290663183801,395.15,408.25,405.62232737369584,415.4,395.0,0,1161.0,2.375533755971314,7161988.362285513
2016-02-03,368.0,373.9,375.9,366.2,59810.0,1237.6,0.1,371.36666666666673,37.50991036988844,-1.3724112650222438,410.0085949313807,360.10140506861933,389.0265389672786,7.512520868113525,16.43078518955358,13184180.0,-11.239749155812836,-0.015779620219309898,4.464887279769994,4.464887279769994,391.525,408.25,403.413434278748,368.0,395.0,0,1162.0,2.375559763733527,7171808.918358778
2016-02-04,390.6,368.0,391.8,368.0,101870.0,1237.6,0.1,377.5,48.60184455823412,0.25607932241593545,410.3204496878277,361.61955031217224,389.17639239896636,56.45833333333338,16.957157676014038,13286050.0,-4.778156996587023,0.06141304347826093,4.341310208912963,4.341310208912963,390.6,408.25,401.2928969075981,368.0,395.0,0,1163.0,2.3756149898051433,7183237.005596159
2016-02-05,386.5,390.6,391.1,384.5,60920.0,1237.6,0.1,381.70000000000005,46.9729097598647,1.1028735691935765,410.3922770551335,361.6977229448664,388.92149788477906,54.892601431980935,16.217360699155893,13225130.0,1.019341348667009,-0.010496671786994427,4.195953609095962,4.195953609095962,390.1,408.25,399.2571810312942,368.0,395.0,0,1164.0,2.3756642663379623,7194353.573611104
2016-02-06,376.7,386.5,386.4,372.9,78850.0,1237.6,0.1,384.6000000000001,43.24224611037794,1.0490509842294848,410.4006060992508,361.1093939007492,387.7575457052763,31.503579952267295,16.030406363501903,13146280.0,-3.062274832732896,-0.02535575679172064,4.255483505044307,4.255483505044307,388.525,408.25,397.3028937900424,368.0,395.0,0,1165.0,2.3757000367082557,7204742.418563893
2016-02-07,377.9,376.7,382.6,375.3,40740.0,1237.6,0.1,380.3666666666666,43.83051908337298,1.1331639884185662,410.3088343778287,360.5511656221713,386.8187318285833,35.732009925558245,15.406805908966053,13187020.0,-6.018403382243235,0.0031855588001061808,4.076953138122798,4.076953138122798,387.79999999999995,408.25,395.4267780384407,368.0,395.0,0,1166.0,2.3757367590076033,7215194.671174087
2016-02-08,372.6,377.9,380.9,372.1,62240.0,1237.6,0.1,375.73333333333335,41.77126186270387,0.8819254802027405,410.46942632795606,359.7005736720439,385.4645668925277,26.608187134502998,14.934891201182761,13124780.0,-5.142566191446026,-0.014024874305371693,4.008290714219743,4.008290714219743,385.29999999999995,408.2,393.6257069169031,368.0,395.0,0,1167.0,2.375765783997738,7225234.568710415
2016-02-09,375.3,372.6,377.6,371.4,55360.0,1237.6,0.1,375.26666666666665,43.23442122847688,0.9421967025792828,404.8880132304128,361.3519867695872,384.4965129027632,34.80825958702071,14.310970401098283,13180140.0,-3.719856336582863,0.007246376811594235,3.81320820706056,3.81320820706056,384.4,406.65,391.896678640227,368.0,395.0,0,1168.0,2.375797788338682,7235448.683464915
2016-02-10,381.9,375.3,385.4,374.1,97490.0,1237.6,0.1,376.6000000000001,46.756398370419745,1.441298104091267,399.5787209332424,363.8312790667577,384.2492259596429,57.68025078369903,14.095901086734116,13277630.0,-3.3164556962025373,0.017585931254995968,3.69099269094897,3.69099269094897,383.525,406.65,390.2368114946179,368.0,395.0,0,1169.0,2.3758378649690384,7246118.8709224
2016-02-11,379.5,381.9,383.2,372.8,62650.0,1237.6,0.1,378.90000000000003,45.647303790585774,1.6116420558560378,399.44374192279037,363.65625807720966,383.79691872539115,56.53710247349821,13.831908151967392,13214980.0,-0.05267316302343657,-0.00628436763550666,3.644771581546085,3.644771581546085,386.8,406.65,388.64333903483316,368.0,395.0,0,1170.0,2.3758741536450065,7256591.501677305
2016-02-12,384.0,379.5,386.4,379.3,53760.0,1237.6,0.1,381.8,48.13167076282041,2.0036661178726494,398.9618366390642,363.6781633609359,383.8162597991634,70.56603773584901,13.351057569684004,13268740.0,0.9729161188535337,0.011857707509881354,3.4768379087718757,3.4768379087718757,387.25,406.65,387.11360547343986,368.0,395.0,0,1171.0,2.375915685351096,7267365.649491359
2016-02-13,390.1,384.0,392.6,383.3,48160.0,1237.6,0.1,384.53333333333336,51.37615702323167,2.611625930943565,396.1747856665637,365.26521433343623,384.4147112468621,90.84249084249083,13.061696314706577,13316900.0,3.255690841715196,0.015885416666666652,3.3482943641903553,3.3482943641903553,388.3,406.65,350.4,368.0,395.0,0,1172.0,2.375964430271184,7278551.931610177
2016-02-14,405.5,390.1,405.9,390.1,73590.0,1237.6,0.1,393.20000000000005,58.44352843616995,3.910611681127526,399.54460967144223,363.1653903285577,386.42283398525615,99.01477832512322,13.257289435084674,13390490.0,9.653866955110868,0.03947705716482952,3.2693685413279097,3.2693685413279097,391.625,406.65,351.24399999999997,368.0,395.0,0,1173.0,2.3760318125950457,7290786.911723889
2016-02-15,401.1,405.5,410.9,396.6,86130.0,1237.6,0.1,398.90000000000003,55.94168119864582,4.302121303153483,401.7516514692909,362.08834853070914,387.82065931999364,78.07606263982113,13.33176876115005,13304360.0,7.764642665233755,-0.01085080147965467,3.323801735514847,3.323801735514847,392.29999999999995,406.65,353.43023999999997,368.0,395.0,0,1174.0,2.3760930813615437,7302698.547544997
2016-02-16,406.4,401.1,409.8,398.0,68330.0,1237.6,0.1,404.3333333333333,58.25955259761635,4.713544821810433,404.3447843732082,360.6352156267918,389.5901203371371,89.93288590604027,13.22235670678219,13372690.0,8.692163680128377,0.013213662428321893,3.253532654227901,3.253532654227901,389.325,406.65,356.87842559999996,368.0,395.0,0,1175.0,2.376160213375575,7314952.743669144
2016-02-17,417.1,406.4,421.5,405.0,90320.0,1237.6,0.1,408.20000000000005,62.543828151940716,5.449754746900626,410.848820283271,357.87117971672905,392.21010887645735,91.77570093457948,13.456474084869175,13463010.0,13.342391304347831,0.026328740157480324,3.2261985338933528,3.2261985338933528,394.475,406.65,360.119720064,368.0,395.0,0,1176.0,2.376239595644388,7327907.914527618
2016-02-18,421.4,417.1,425.5,414.8,77350.0,1237.6,0.1,414.9666666666667,64.13690745075971,5.9300870167091055,417.3320034123527,355.4979965876473,394.99009850727094,92.42144177449164,13.259583078807092,13540360.0,7.885304659498196,0.010309278350515427,3.146555073281227,3.146555073281227,396.825,406.65,365.03014245888,368.0,395.0,0,1177.0,2.376323381628197,7341128.804753834
2016-02-19,420.0,421.4,424.3,416.4,52240.0,1237.6,0.1,419.5,63.19450248056419,5.84758376646116,422.41894488694743,354.6310551130525,397.37199388753083,89.83364140480592,12.87675571603516,13488120.0,8.667529107373868,-0.0033222591362125353,3.0658942181036095,3.0658942181036095,396.825,406.65,371.07712821299197,368.0,395.0,0,1178.0,2.3764048114017475,7354237.880974359
2016-02-20,440.1,420.0,442.7,419.5,111630.0,1237.6,0.1,427.1666666666667,70.0082247895896,6.775383018717392,431.5526511385839,352.52734886141616,401.44132780300407,96.35343618513329,13.614130307746933,13599750.0,16.830368993894353,0.04785714285714282,3.093417475061789,3.093417475061789,407.05,406.65,376.51941539169275,368.0,440.1,0,1179.0,2.37650876521973,7368631.794283742
2016-02-21,437.9,440.1,447.6,425.5,100500.0,1237.6,0.1,432.6666666666667,68.51317000795976,6.849207165259861,438.4525723870407,352.1974276129593,404.91358229795605,87.27034120734903,14.220263857193583,13499250.0,15.877216194760518,-0.004998863894569494,3.2473769941067787,3.2473769941067787,410.5,406.65,384.46108554468964,368.0,440.1,0,1180.0,2.3766094999119276,7382869.25405745
2016-02-22,437.8,437.9,440.2,431.3,56010.0,1237.6,0.1,438.6000000000001,68.44162318651895,6.502312641472853,444.21654691548844,352.8234530845115,408.0456220791031,87.13910761154855,13.840245010251182,13443240.0,17.49865807836822,-0.0002283626398720262,3.1613168136708962,3.1613168136708962,412.20000000000005,406.65,393.3005335684331,368.0,440.1,0,1181.0,2.3767093957503924,7397083.442675403
2016-02-23,419.9,437.8,440.8,414.4,93720.0,1237.6,0.1,431.8666666666666,56.972740575813575,4.759130088204413,445.458715451002,356.7712845489979,409.17461045252185,62.96791443850262,14.737370366661816,13349520.0,11.883826272315472,-0.04088624942896313,3.5097333571473723,3.5097333571473723,413.82500000000005,406.65,400.9024588688525,368.0,440.1,0,1182.0,2.3767878610822186,7410110.684286419
2016-02-24,422.7,419.9,425.2,410.4,66510.0,1237.6,0.1,426.8,58.1539977641135,3.5423403794478396,447.7436648885832,357.69633511141683,410.4627427903769,66.71122994652403,14.74184391190026,13416030.0,10.683424980361353,0.00666825434627305,3.487542917411938,3.487542917411938,414.625,406.65,407.4401146272131,368.0,440.1,0,1183.0,2.3768689300369172,7423304.590334128
2016-02-25,423.5,422.7,427.2,417.5,53540.0,1237.6,0.1,422.03333333333336,58.50452211108787,2.5835605969880167,449.81582190655223,359.32417809344787,411.7043863341505,64.71449487554902,14.381712203907384,13469570.0,11.594202898550725,0.001892595221197002,3.395917875775061,3.395917875775061,416.375,406.65,410.4,368.0,440.1,0,1184.0,2.3769502413225236,7436532.104240846
2016-02-26,427.3,423.5,427.6,419.1,53210.0,1237.6,0.1,424.5,60.20951187046869,2.022321792605074,451.4797701661403,362.7202298338597,413.1896828737552,68.42923794712284,13.961589903628285,13522780.0,11.27604166666667,0.008972845336481683,3.267397590364682,3.267397590364682,417.725,406.65,410.4,368.0,440.1,0,1185.0,2.3770352825696044,7449991.460054705
2016-02-27,431.3,427.3,434.1,427.3,42790.0,1237.6,0.1,427.36666666666673,61.98039415160976,1.7478292894855407,453.21707585096425,366.3229241490357,414.9144749810166,71.65217391304346,13.450047767654837,13565570.0,10.561394514227118,0.009361104610344118,3.1184900921991274,3.1184900921991274,417.95,406.65,415.608,368.0,440.1,0,1186.0,2.377124237158085,7463694.312794665
2016-02-28,432.5,431.3,435.6,421.2,50850.0,1237.6,0.1,430.36666666666673,62.519313652462706,1.4847800482000846,453.7378824956147,371.7921175043854,416.58928688758647,70.39215686274505,13.517901498536636,13616420.0,6.658446362515413,0.002782286111755239,3.1255263580431527,3.1255263580431527,417.95,406.65,419.1,368.0,440.1,0,1187.0,2.377213862068217,7477457.019082161
2016-02-29,436.2,432.5,441.3,429.8,68770.0,1237.6,0.1,433.3333333333333,64.20413668571723,1.398852743110039,454.16105735177916,377.45894264822095,418.4569738506735,77.01612903225801,13.37376567721259,13685190.0,8.75093492894539,0.008554913294797739,3.0659710401679483,3.0659710401679483,418.4,402.45,421.2,368.0,440.1,0,1188.0,2.3773069950574746,7491441.96900353
2016-03-01,434.0,436.2,439.0,428.5,67460.0,1237.6,0.1,434.23333333333335,62.40778580807509,1.048734002641524,454.1900904960344,382.63990950396555,419.9372620553712,68.07511737089199,13.168496700268834,13617730.0,6.791338582677171,-0.005043558000916937,3.034215829555031,3.034215829555031,417.675,400.75,421.2,368.0,440.1,0,1189.0,2.377396919237943,7505265.826211009
2016-03-02,425.4,434.0,435.9,423.9,57750.0,1237.6,0.1,431.8666666666666,55.83167298962877,0.14055566627342841,451.78525703834885,389.634742961651,420.45752281200254,40.32258064516124,13.085032650249632,13559980.0,1.9899304723087878,-0.019815668202765035,3.0759362130347045,3.0759362130347045,417.675,400.75,447.6,368.0,440.1,0,1190.0,2.3774762506884923,7518504.08142553
2016-03-03,419.6,425.4,425.8,414.9,78900.0,1237.6,0.1,426.3333333333333,51.86251589977348,-0.8914263004130145,448.6380324307481,396.3419675692518,420.37585397276416,24.731182795699016,12.928958889517517,13481080.0,-0.4271476032273267,-0.013634226610249045,3.0812580766247653,3.0812580766247653,417.675,399.4,447.12600000000003,368.0,440.1,0,1191.0,2.377548114966506,7531333.005399067
2016-03-04,409.5,419.6,423.4,407.2,75270.0,1237.6,0.1,418.1666666666667,45.76157679773639,-2.2192919977053958,445.90730718815644,401.01269281184364,419.3400583563104,5.693069306930717,13.162604683123407,13405810.0,-2.5,-0.02407054337464254,3.214311277930014,3.214311277930014,416.875,399.0,445.83696000000003,368.0,440.1,0,1192.0,2.37760727673534,7543449.051559909
2016-03-05,399.0,409.5,410.1,386.9,129150.0,1237.6,0.1,409.36666666666673,40.43602975727976,-3.6834718212227466,446.76982811444714,399.50017188555296,417.40290994142373,19.93410214168042,13.879561491471737,13276660.0,-9.33878663940014,-0.02564102564102566,3.478586839967854,3.478586839967854,411.8,399.0,443.5187424,399.0,440.1,0,1193.0,2.3776529666315014,7554804.229189049
2016-03-06,406.0,399.0,412.0,393.1,62590.0,1237.6,0.1,404.8333333333333,45.02896754548844,-4.031131478243806,446.18303488572207,400.5769651142779,416.316918518431,35.11029411764708,14.238164242080897,13339250.0,-7.284768211920525,0.01754385964912286,3.5069370054386444,3.5069370054386444,412.15000000000003,399.0,438.989243008,399.0,440.1,0,1194.0,2.3777065957499026,7566630.931154499
2016-03-07,414.9,406.0,416.6,402.0,61770.0,1237.6,0.1,406.6333333333334,50.27857841175098,-3.530311706487179,445.62182607529013,401.9881739247099,416.1819738976281,51.47058823529409,14.264009653360834,13401020.0,-5.230698949291922,0.021921182266009698,3.437939178925243,3.437939178925243,412.15000000000003,399.0,434.82210356736,399.0,440.1,0,1195.0,2.377770264458724,7579052.875722864
2016-03-08,411.9,414.9,416.7,408.4,53770.0,1237.6,0.1,410.93333333333334,48.59399787019329,-3.275319171494183,445.79489662896117,401.29510337103875,415.7741668597588,45.955882352941146,13.838008963835062,13347250.0,-1.9052155275065492,-0.007230657989877098,3.359555465849736,3.359555465849736,413.77500000000003,405.55,430.98833528197116,399.0,440.1,0,1196.0,2.3778296963852896,7591245.994729701
2016-03-09,412.8,411.9,414.9,408.9,50920.0,1237.6,0.1,413.2,49.144492041098836,-2.931419512269537,445.84139654673515,400.38860345326475,415.4909128731151,47.61029411764709,13.278151180703986,13398170.0,-2.3420865862313645,0.002184996358339575,3.2166063906744156,3.2166063906744156,414.20000000000005,405.55,427.4612684594135,399.0,440.1,0,1197.0,2.3778895478796813,7603479.257670915
2016-03-10,415.8,412.8,417.5,410.3,55740.0,1237.6,0.1,413.5,51.027092716509706,-2.4091239863466813,445.81949104823104,399.990508951769,415.52034974234226,53.125000000000036,12.843997524939414,13453910.0,-1.8181818181818157,0.007267441860465018,3.088984493732423,3.088984493732423,414.325,405.55,424.2163669826604,399.0,440.1,0,1198.0,2.3779523078657423,7615897.46837908
2016-03-11,419.1,415.8,422.4,415.1,60630.0,1237.6,0.1,415.90000000000003,53.08447121975553,-1.7777568017751006,443.40554291658236,400.3044570834177,415.86126881450014,59.19117647058828,12.447997701729452,13514540.0,-1.9190264451205215,0.007936507936507908,2.9701736343902296,2.9701736343902296,411.8,405.55,386.9,399.0,440.1,0,1199.0,2.378018297542067,7628520.205707194
2016-03-12,410.4,419.1,420.7,407.0,59640.0,1237.6,0.1,415.1000000000001,47.42756318483491,-1.872883024189266,441.25542779341635,399.7045722065837,415.34114797502394,43.19852941176468,12.537426437320205,13454900.0,-4.845814977973576,-0.020758768790264948,3.0549284691326037,3.0549284691326037,411.2,405.55,387.60999999999996,399.0,440.1,0,1200.0,2.378073310746409,7640519.921420891
2016-03-13,412.4,410.4,415.9,409.6,34980.0,1237.6,0.1,413.9666666666667,48.77887678270203,-1.7312568837119686,438.65807445480027,399.7619255451998,415.0610386440693,46.87499999999997,12.091895977511616,13489880.0,-4.647398843930641,0.004873294346978474,2.9320795289795383,2.9320795289795383,410.95,405.55,388.3058,399.0,440.1,0,1201.0,2.3781300666190597,7652636.4508370375
2016-03-14,414.3,412.4,416.1,411.2,49330.0,1237.6,0.1,412.3666666666666,50.091325561692635,-1.4510991068861507,438.4911962824223,399.3688037175777,414.98855877320557,52.59117082533594,11.578189121975074,13539210.0,-5.020632737276474,0.004607177497575332,2.7946389384443817,2.7946389384443817,412.5,405.55,388.987684,399.0,440.1,0,1202.0,2.378188431925389,7664862.516929817
2016-03-15,415.1,414.3,417.4,412.3,48600.0,1237.6,0.1,413.9333333333334,50.66453529739258,-1.165690799608504,438.0987595514256,399.00124044857444,414.9991722233765,57.55102040816336,11.11546132754828,13587810.0,-4.354838709677414,0.0019309678976586753,2.677779168284336,2.677779168284336,414.725,405.55,389.65593032,399.0,440.1,0,1203.0,2.3782470942307534,7677121.68300052
2016-03-16,415.9,415.1,417.0,413.3,44540.0,1237.6,0.1,415.09999999999997,51.26729296363142,-0.8892962915184786,437.6142896501634,398.7257103498365,415.0849653449597,74.5501285347043,10.585785518437687,13632350.0,-2.233192289609779,0.0019272464466393302,2.5452718245822763,2.5452718245822763,415.975,405.55,390.3108117136,399.0,440.1,0,1204.0,2.3783060513920167,7689413.926671386
2016-03-17,418.2,415.9,419.6,415.3,43820.0,1237.6,0.1,416.40000000000003,53.04353225203288,-0.5352871331061706,436.7039731159811,398.72602688401895,415.38163531210637,85.75342465753427,10.13680083854928,13676170.0,-0.3336510962821816,0.0055301755229622,2.4239122043398567,2.4239122043398567,415.975,405.55,390.952595479328,399.0,440.1,0,1205.0,2.3783670635900513,7701842.859464486
2016-03-18,408.2,418.2,418.6,402.5,66070.0,1237.6,0.1,414.09999999999997,45.310700529156314,-0.9349255978774103,434.9023444520992,398.2176555479009,414.6976700442867,60.00000000000003,10.562743635795764,13610100.0,-0.3174603174603202,-0.023912003825920625,2.587639303232671,2.587639303232671,413.275,405.55,391.5815435697414,399.0,440.1,0,1206.0,2.3784155592309766,7713550.806573991
2016-03-19,408.7,408.2,410.5,402.1,37000.0,1237.6,0.1,411.7,45.73665907878072,-1.1137697289457384,432.46726293882887,398.27273706117114,414.1264633734023,53.24232081911259,10.408261947524636,13647100.0,2.431077694235586,0.0012248897599216324,2.5466752991251864,2.5466752991251864,413.175,405.55,392.1979126983466,399.0,440.1,0,1207.0,2.378464021316634,7725270.649880885
2016-03-20,411.5,408.7,413.5,407.2,30540.0,1237.6,0.1,409.4666666666667,48.17115590509295,-0.9955298109842812,428.36289865016795,399.90710134983215,413.8763240045069,46.56862745098044,10.114814665558592,13677640.0,1.354679802955665,0.006850990946904778,2.4580351556642994,2.4580351556642994,412.75,405.55,392.8019544443797,399.0,440.1,0,1208.0,2.378515194386333,7737164.557409446
2016-03-21,411.1,411.5,413.1,407.3,43160.0,1237.6,0.1,410.4333333333334,47.840946763225865,-0.8992292088495,423.94936129523296,402.03063870476717,413.61191219455384,44.33497536945823,9.806613618018693,13634480.0,-0.9158833453844192,-0.000972053462940381,2.385456973490317,2.385456973490317,412.475,406.45000000000005,393.3939153554921,399.0,440.1,0,1209.0,2.3785652552918637,7749007.051242187
2016-03-22,416.2,411.1,417.9,410.8,49080.0,1237.6,0.1,412.93333333333334,52.32799096480452,-0.4686813052732948,422.04422093497146,403.0157790650286,413.85839674745347,69.45812807881772,9.613284073874498,13683560.0,1.0439427045399396,0.012405740695694334,2.3097751258708548,2.3097751258708548,412.475,406.45000000000005,393.97403704838223,399.0,440.1,0,1210.0,2.3786207145082945,7761183.747315922
2016-03-23,417.0,416.2,419.6,414.2,40610.0,1237.6,0.1,414.76666666666665,53.010852590083836,-0.12455143606873809,421.58977692870985,403.2102230712901,414.1575970572198,73.39901477832518,9.312335211454894,13724170.0,1.0174418604651136,0.001922152811148603,2.2331739116198785,2.2331739116198785,412.475,406.45000000000005,394.5425563074146,399.0,440.1,0,1211.0,2.3786764715617763,7773393.382833861
2016-03-24,414.7,417.0,417.7,412.9,38830.0,1237.6,0.1,415.9666666666667,50.75967072646589,-0.050177452921999516,421.80098462964736,403.5190153703527,414.2092544803417,62.06896551724135,8.990025553493831,13685340.0,-0.26455026455027,-0.0055155875299760515,2.167838329754963,2.167838329754963,412.475,406.9,395.0997051812663,399.0,440.1,0,1212.0,2.378728884156204,7785419.448657079
2016-03-25,415.7,414.7,417.3,412.4,34590.0,1237.6,0.1,415.8,51.71967425874576,0.06193261495324165,420.225371460733,406.764628539267,414.3512302441187,73.11827956989242,8.697880871101416,13719930.0,-0.8112622285850712,0.002411381721726613,2.092345650974601,2.092345650974601,412.475,406.9,395.64571107764095,399.0,440.1,0,1213.0,2.3787818377366103,7797492.438202004
2016-03-26,416.5,415.7,417.7,413.9,28060.0,1237.6,0.1,415.6333333333334,52.517232806151604,0.17891324493514763,419.916303926991,408.12369607300894,414.55587498277407,82.28571428571415,8.348032237451315,13747990.0,1.4863547758284656,0.0019244647582390417,2.004329468775826,2.004329468775826,411.9,407.8,396.18079685608814,399.0,440.1,0,1214.0,2.378835094260197,7809598.319701005
2016-03-27,424.6,416.5,427.4,415.5,61720.0,1237.6,0.1,418.93333333333334,59.764602189841646,0.758275497355284,421.9921823805388,407.0178176194612,415.512458317748,88.93280632411083,8.601744220490506,13809710.0,2.9582929194956464,0.019447779111644747,2.0258464956407223,2.0258464956407223,413.075,409.5,396.7051809189664,399.0,424.6,0,1215.0,2.3788971157199685,7822242.892348147
2016-03-28,422.2,424.6,425.4,419.7,43450.0,1237.6,0.1,421.1000000000001,56.98906644277621,0.9252647329492552,423.1121196234022,406.9278803765978,416.14936704939106,79.44664031620555,8.394476776169755,13766260.0,1.906830798937962,-0.005652378709373629,1.988270198050629,1.988270198050629,412.22499999999997,409.5,397.9329736822077,399.0,424.6,0,1216.0,2.3789557240346717,7834699.7772807
2016-03-29,415.0,422.2,424.5,406.4,69110.0,1237.6,0.1,420.6000000000001,49.55396140341453,0.5165990471100115,423.1579760836372,407.1020239163628,416.0399035208776,50.98814229249012,9.087728435014775,13697150.0,-0.024090580582997526,-0.0170535291331122,2.1898140807264515,2.1898140807264515,412.025,409.5,399.1116547349194,399.0,424.6,0,1217.0,2.379005303062268,7846631.24540514
2016-03-30,412.4,415.0,416.2,408.4,43280.0,1237.6,0.1,416.5333333333333,47.161165639284754,0.06093075918089874,423.0676260396894,406.85237396031044,415.6932460426988,40.71146245059278,8.99574783251372,13653870.0,-0.8415484491464296,-0.00626506024096396,2.1813161572535695,2.1813161572535695,412.025,409.5,400.2431885455226,412.4,424.6,0,1218.0,2.3790511904489167,7858355.258619158
2016-03-31,415.7,412.4,417.2,411.5,41840.0,1237.6,0.1,414.3666666666666,50.43267389016541,-0.023925621538006592,422.68300956539724,406.8969904346029,415.6938892767275,53.75494071146241,8.760337273048453,13695710.0,-0.5978000956480154,0.008001939864209495,2.1073700440337872,2.1073700440337872,413.575,409.5,401.32946100370174,412.4,424.6,0,1219.0,2.379100337413189,7870288.865897005
2016-04-01,415.6,415.7,416.9,412.8,38220.0,1237.6,0.1,414.56666666666666,50.33097858368368,-0.08884149659115337,422.68583656186087,407.41416343813916,415.6849474408487,53.3596837944665,8.427456039259274,13657490.0,1.8128368446839869,-0.00024055809477985246,2.027780567675475,2.027780567675475,415.79999999999995,410.20000000000005,402.37228256355365,412.4,424.6,0,1220.0,2.3791487402626528,7882191.8238567365
2016-04-02,418.5,415.6,420.1,415.1,31310.0,1237.6,0.1,416.6000000000001,53.27359698585296,0.053799427628477114,423.0302784965401,407.6797215034599,415.95304768457737,57.61904761904773,8.182637750740755,13688800.0,2.39784683141669,0.006977863330124956,1.9552300479667277,1.9552300479667277,415.825,410.20000000000005,403.37339126101153,412.4,424.6,0,1221.0,2.379199901733799,7894275.272353975
2016-04-03,419.1,418.5,420.2,417.0,22800.0,1237.6,0.1,417.73333333333335,53.88236704883141,0.17215221307961937,423.4219981474031,407.76800185259685,416.25275742890335,60.476190476190695,7.826735054259272,13711600.0,1.8469015795868828,0.0014336917562725038,1.867510153724474,1.867510153724474,415.825,413.45000000000005,404.33445561057107,412.4,424.6,0,1222.0,2.379251131288735,7906377.424187675
2016-04-04,419.3,419.1,420.4,416.2,33440.0,1237.6,0.1,418.9666666666667,54.097048723494815,0.24315797986453647,423.7913571169496,407.8186428830504,416.54297100710306,61.428571428571594,7.5676825503836085,13745040.0,1.994648504013619,0.0004772130756383053,1.8048372407306483,1.8048372407306483,415.825,415.45000000000005,405.25707738614824,412.4,424.6,0,1223.0,2.3793019644768743,7918470.200683581
2016-04-05,422.1,419.3,423.7,418.0,40890.0,1237.6,0.1,420.1666666666667,57.10743809346503,0.4461370326913441,424.56018205839587,407.66981794160404,417.0722118635694,74.76190476190497,7.434276653927635,13785930.0,1.4175876982220168,0.006677796327211993,1.7612595721221596,1.7612595721221596,415.325,417.25,406.1427942907023,412.4,424.6,0,1224.0,2.3793554046965744,7930735.58354267
2016-04-06,421.3,422.1,422.8,419.5,32670.0,1237.6,0.1,420.90000000000003,55.9778632321115,0.4904334608202965,424.97243644041436,407.5675635595856,417.4748583527533,70.95238095238112,7.138971178647091,13753260.0,1.031175059952041,-0.0018952854773750527,1.6945101302271757,1.6945101302271757,415.1,417.25,406.99308251907416,412.4,424.6,0,1225.0,2.3794072930875174,7942921.808314407
2016-04-07,420.1,421.3,422.0,417.9,36060.0,1237.6,0.1,421.16666666666674,54.24463762926649,0.406303739434291,424.8790564010652,408.8509435989349,417.7248718429673,65.23809523809545,6.921901808743728,13717200.0,1.302146129732345,-0.002848326608117735,1.6476795545688472,1.6476795545688472,415.4,417.25,407.8093592183112,412.4,424.6,0,1226.0,2.3794571691239117,7955000.429258614
2016-04-08,417.7,420.1,423.5,415.5,46950.0,1237.6,0.1,419.7,50.85328850672165,0.16858196958287275,424.4016846973357,410.22831530266416,417.72250309601804,53.80952380952387,6.998908822404891,13670250.0,0.48111618955977875,-0.005712925493930099,1.6755826723497464,1.6755826723497464,416.175,417.25,408.5929848495788,412.4,424.6,0,1227.0,2.37950364095885,7966886.096535311
2016-04-09,418.0,417.7,418.9,412.4,29430.0,1237.6,0.1,418.6000000000001,51.2634596295184,0.018976907216436967,424.2073129969154,411.0726870030846,417.7489313725877,55.23809523809535,6.963272477947399,13699680.0,0.36014405762304924,0.0007182188173331383,1.6658546597960284,1.6658546597960284,416.4,417.25,409.3452654555956,412.4,424.6,0,1228.0,2.3795498423382138,7978769.0386139015
2016-04-10,420.3,418.0,421.6,416.7,23300.0,1237.6,0.1,418.6666666666667,54.40524673196472,0.06003631000235954,424.028237512065,412.17176248793504,417.9918902894841,73.15789473684228,6.81589587237973,13722980.0,-1.012717852096093,0.005502392344497675,1.6216740119866118,1.6216740119866118,416.4,417.25,410.06745483737177,412.4,424.6,0,1229.0,2.3795980860562636,7990790.511427432
2016-04-11,421.4,420.3,422.4,418.1,36390.0,1237.6,0.1,419.90000000000003,55.870460476131655,0.14173007254392989,424.3874040846334,412.33259591536665,418.3164721666761,82.87292817679548,6.6361890243526025,13759370.0,-0.18948365703458345,0.002617178206043125,1.5747956868420985,1.5747956868420985,416.4,417.25,410.7607566438769,412.4,424.6,0,1230.0,2.3796469761021424,8002865.677914919
2016-04-12,424.7,421.4,426.7,420.7,57710.0,1237.6,0.1,422.1333333333334,60.021168187122505,0.3846859714315265,425.33331541438747,412.15668458561254,418.9244271984212,89.07103825136613,6.590746951184559,13817080.0,2.3373493975903585,0.007831039392501182,1.551859418691914,1.551859418691914,417.15,417.25,411.4263263781218,412.4,424.6,0,1231.0,2.37969902343224,8015148.653456859
2016-04-13,423.5,424.7,426.6,421.4,38090.0,1237.6,0.1,423.2,57.888908450450145,0.42792543920637893,425.8092810930285,412.5607189069714,419.36019603666676,78.94736842105269,6.4914078832428075,13778990.0,2.691561590688657,-0.0028255238992229703,1.5327999724304149,1.5327999724304149,417.15,414.1,412.0652733229969,412.4,424.6,0,1232.0,2.379749076578784,8027324.097572635
2016-04-14,424.0,423.5,425.4,421.8,30660.0,1237.6,0.1,424.06666666666666,58.54965851896962,0.4512345326131275,426.3379522111289,412.86204778887117,419.80208212841274,81.11888111888122,6.284878748725461,13809650.0,1.9966321866730843,0.0011806375442739991,1.482282723756005,1.482282723756005,418.22499999999997,414.1,412.678662390077,412.4,424.6,0,1233.0,2.379799079534294,8039510.983530193
2016-04-15,428.7,424.0,429.5,423.3,54120.0,1237.6,0.1,425.40000000000003,64.23110340626368,0.7278354855476317,427.8619017243727,412.5580982756274,420.64950287808773,95.32163742690052,6.278815980959356,13863770.0,3.1520692974013396,0.011084905660377231,1.4646176769207737,1.4646176769207737,419.45,414.1,413.26751589447395,412.4,424.6,0,1234.0,2.3798537931808594,8052002.535174251
2016-04-16,430.0,428.7,432.0,426.8,29020.0,1237.6,0.1,427.56666666666666,65.6341992275363,0.9300560486634724,429.0575520983237,411.90244790167634,421.540026413508,89.79591836734696,6.2017576966051156,13892790.0,2.7479091995221028,0.0030324236062515553,1.4422692317686316,1.4422692317686316,420.7,414.1,414.2414649408055,412.4,424.6,0,1235.0,2.3799093436805605,8064561.18657647
2016-04-17,426.3,430.0,430.6,423.8,25590.0,1237.6,0.1,428.3333333333333,58.58975803961578,0.7538475834022949,429.60627233075286,411.76372766924703,421.99335723126916,70.91836734693887,6.2444892897047515,13867200.0,1.7179670722977782,-0.008604651162790633,1.4648109992270117,1.4648109992270117,420.7,414.1,415.66214774554106,412.4,424.6,0,1236.0,2.3799600916434467,8076838.743758867
2016-04-18,427.7,426.3,429.1,424.4,32580.0,1237.6,0.1,428.0,60.324939693527725,0.6734361878024435,430.33966739960283,412.30033260039716,422.53684701876733,78.06122448979589,6.134168626154415,13899780.0,2.0033388981636002,0.003284072249589487,1.4342222647076024,1.4342222647076024,421.775,414.1,416.9691759258978,412.4,424.6,0,1237.0,2.380011802994287,8089190.643310063
2016-04-19,434.9,427.7,436.1,426.8,45680.0,1237.6,0.1,429.6333333333334,67.79814918806613,1.0258913906478417,432.307144797125,412.582855202875,423.7142901598371,94.93670886075931,6.360299438571958,13945460.0,3.0324567638000364,0.0168342296001871,1.46247400289077,1.46247400289077,424.175,414.1,418.17164185182594,412.4,424.6,0,1238.0,2.380070951332128,8102018.46935925
2016-04-20,441.2,434.9,442.9,432.5,74360.0,1237.6,0.1,434.6000000000001,72.65220355660486,1.5714085958097024,436.0492497743967,411.39075022560326,425.37959585890025,94.42622950819676,6.648849478673959,14019820.0,4.723474958461898,0.014486088756035853,1.5069921755833997,1.5069921755833997,428.22499999999997,414.9,419.96447766664335,412.4,424.6,0,1239.0,2.3801364072766287,8115254.386274182
2016-04-21,449.3,441.2,450.8,439.5,63130.0,1237.6,0.1,441.8,77.37448105877759,2.320626647290637,441.47776889647406,409.332231103526,427.657729586624,96.09375000000001,6.981074515911534,14082950.0,6.9507260176148495,0.018359020852221297,1.55376686310072,1.55376686310072,432.35,418.85,422.71674034664613,412.4,424.6,0,1240.0,2.3802099963553656,8129013.957522495
2016-04-22,445.3,449.3,450.2,441.9,49710.0,1237.6,0.1,445.2666666666667,70.86672610475443,2.3807622848830414,444.6552735880685,408.8347264119315,429.33794581646936,85.67708333333336,7.075283479060711,14033240.0,6.6076131194637355,-0.008902737591809484,1.58888018842594,1.58888018842594,432.45000000000005,418.85,426.6483966981157,412.4,424.6,0,1241.0,2.3802786248144203,8142483.947959977
2016-04-23,450.1,445.3,451.5,443.1,42360.0,1237.6,0.1,448.23333333333335,73.7228534943278,2.562011208472331,448.5081120810098,408.0818879189901,431.31528431013896,95.97701149425295,7.16990608769923,14075600.0,7.679425837320579,0.010779249943858149,1.5929584731613484,1.5929584731613484,433.17499999999995,419.2,430.02962116037946,412.4,424.6,0,1242.0,2.380351775455903,8156254.68264954
2016-04-24,457.6,450.1,461.8,447.9,74430.0,1237.6,0.1,451.0,77.44384046386114,2.9761385758179726,453.65089588730496,406.7691041126951,433.81859056631623,90.38901601830666,7.650627081435002,14150030.0,8.874613371401383,0.016662963785825324,1.671902771292614,1.671902771292614,438.95000000000005,424.35,433.4648817747188,412.4,424.6,0,1243.0,2.380432234598752,8170501.902313948
2016-04-25,461.7,457.6,466.2,451.8,81660.0,1237.6,0.1,456.4666666666667,79.17955105418021,3.2907571203904826,459.0034966015152,405.37650339848466,436.47396289333375,90.10989010989012,8.132725147046786,14231690.0,9.563360227812058,0.008959790209790208,1.7614739326503763,1.7614739326503763,441.925,426.54999999999995,438.5652030552694,412.4,424.6,0,1244.0,2.3805163279926362,8184997.923471668
2016-04-26,466.0,461.7,468.9,459.2,67560.0,1237.6,0.1,461.76666666666665,80.84440833109197,3.5317758703004083,464.48972185135716,404.36027814864286,439.285966427302,93.8947368421053,8.244673350829158,14299250.0,9.724511419825763,0.00931340697422578,1.7692432083324372,1.7692432083324372,443.65,431.0,444.09216244421555,412.4,466.0,0,1245.0,2.3806042174925297,8199754.186243966
2016-04-27,447.0,466.0,467.9,444.6,90810.0,1237.6,0.1,458.23333333333335,58.561609038296815,2.2190278950811724,465.5565137268441,405.98348627315585,440.0206362913685,53.503184713375816,9.32005382576993,14208440.0,5.548996458087367,-0.04077253218884125,2.085023227241595,2.085023227241595,444.25,435.45,468.9,412.4,466.0,0,1246.0,2.380671423665662,8213232.847002119
2016-04-28,448.5,447.0,450.1,433.9,81940.0,1237.6,0.1,453.8333333333333,59.510432128030835,1.3044299509147006,466.37639984586104,408.24360015413885,440.8281947398096,55.263157894736864,9.81147855250065,14290380.0,5.778301886792453,0.003355704697986628,2.1876206360090635,2.1876206360090635,445.67499999999995,435.5,468.9,412.4,466.0,0,1247.0,2.3807396017755345,8226791.004394639
2016-04-29,455.0,448.5,456.3,445.2,44850.0,1237.6,0.1,450.1666666666667,63.41922001299182,1.0034447276700948,467.7812787974171,410.53872120258285,442.1778904788753,69.179600886918,9.903515798750606,14335230.0,6.134826218801029,0.01449275362318847,2.176596878846287,2.176596878846287,446.025,435.5,467.9,412.4,466.0,0,1248.0,2.380814052720437,8240763.421736042
2016-04-30,448.5,455.0,456.9,446.6,35310.0,1237.6,0.1,450.6666666666667,57.44681065073894,0.27092152986236506,468.09330648740223,413.04669351259776,442.7799961475539,54.76718403547674,9.931836098839844,14299920.0,4.302325581395349,-0.014285714285714235,2.214456209328839,2.214456209328839,446.025,435.5,466.53999999999996,412.4,466.0,0,1249.0,2.3808809478628485,8254278.227872807
2016-05-01,452.2,448.5,454.2,447.5,21750.0,1237.6,0.1,451.90000000000003,59.76932821275587,-0.04335854768348568,468.59772545915337,415.62227454084666,443.6771393715964,62.47191011235957,9.700990663208426,14321670.0,6.075533661740553,0.008249721293199563,2.145287630077051,2.145287630077051,446.025,435.5,465.23439999999994,412.4,466.0,0,1250.0,2.3809511498031712,8268020.656440568
2016-05-02,444.2,452.2,453.9,440.2,73850.0,1237.6,0.1,448.3,53.029933132344276,-0.8255847029427326,468.34463380572817,417.8253661942719,443.7269356219206,41.33016627078383,9.986634187264967,14247820.0,3.857844283376198,-0.01769128704113221,2.24822921820463,2.24822921820463,446.025,435.5,463.98102399999993,444.2,466.0,0,1251.0,2.381012149617693,8281198.5652725715
2016-05-03,450.3,444.2,451.5,441.5,49750.0,1237.6,0.1,448.90000000000003,57.010370340405714,-0.9583940720989848,468.185545027408,420.664454972592,444.35294175316625,48.90109890109896,9.987588888174612,14297570.0,3.5410439181421096,0.01373255290409725,2.2179855403452393,2.2179855403452393,446.025,435.5,462.7777830399999,444.2,466.0,0,1252.0,2.381079062094857,8294769.104796585
2016-05-04,445.8,450.3,450.9,444.2,39440.0,1237.6,0.1,446.76666666666665,53.41425093733728,-1.35148235694518,467.3496765490008,423.6803234509992,444.49075682429327,34.0000000000001,9.752761110447853,14258130.0,1.0426110607434322,-0.009993337774816813,2.1876987686065172,2.1876987686065172,446.025,435.5,461.62267171839994,444.2,466.0,0,1253.0,2.3811405271597086,8308011.396761439
2016-05-05,448.1,445.8,449.2,444.4,41890.0,1237.6,0.1,448.06666666666666,54.97743625890525,-1.4500616706376803,466.92459637565,426.0454036243499,444.8344942695987,40.571428571428704,9.398992459701578,14300020.0,-0.26708212775428186,0.005159264244055661,2.0975211916316843,2.0975211916316843,446.84999999999997,435.5,460.51376484966397,444.2,466.0,0,1254.0,2.3812038309972565,8321388.081591374
2016-05-06,459.6,448.1,461.5,445.7,68430.0,1237.6,0.1,451.16666666666674,61.86728651914636,-0.7684532852924235,467.6897332047734,428.24026679522666,446.24073291058926,73.42857142857156,9.856207284008608,14368450.0,3.2113182124410535,0.025663914304842717,2.144518556137643,2.144518556137643,445.6,435.5,433.9,444.2,466.0,0,1255.0,2.381278638386496,8335516.772713326
2016-05-07,458.5,459.6,460.6,454.6,30970.0,1237.6,0.1,455.40000000000003,60.90716223270381,-0.43592050642523716,467.09697192097656,432.0530280790234,447.40828215719984,70.28571428571435,9.580763906579422,14337480.0,1.8662519440124365,-0.002393385552654559,2.0895886382943125,2.0895886382943125,447.825,435.5,434.452,444.2,466.0,0,1256.0,2.381351655077646,8349551.093817511
2016-05-08,457.9,458.5,460.2,454.9,27600.0,1237.6,0.1,458.6666666666667,60.356941614149555,-0.30671108981222606,465.7838809097663,436.38611909023354,448.4074933803237,68.57142857142857,9.274995056109464,14309880.0,0.06555944055943062,-0.001308615049073092,2.0255503507555064,2.0255503507555064,448.0,435.5,434.99296,444.2,466.0,0,1257.0,2.3814234045188307,8363524.005306576
2016-05-09,460.4,457.9,464.2,455.4,48420.0,1237.6,0.1,458.93333333333334,61.90131368131795,-0.11318037430957162,465.5705109666317,439.14948903336824,449.5496368679119,75.71428571428571,9.241066837815932,14358300.0,-0.28156811782543023,0.005459707359685595,2.0071821976142337,2.0071821976142337,448.775,435.5,435.5231008,444.2,466.0,0,1258.0,2.3814971184040714,8377642.508743232
2016-05-10,449.4,460.4,462.1,446.8,59990.0,1237.6,0.1,455.90000000000003,52.25521342127704,-0.7507600152459251,465.04552035554906,440.49447964445113,449.53538573763456,45.588235294117645,9.673847777971938,14298310.0,-3.5622317596566573,-0.02389226759339702,2.152614102797494,2.152614102797494,449.15,437.65,436.67017676800003,444.2,466.0,0,1259.0,2.3815586360863614,8390996.938226214
2016-05-11,452.5,449.4,456.1,449.6,39970.0,1237.6,0.1,454.09999999999997,54.41128392912956,-0.9743003542196638,465.10343008356705,440.75656991643285,449.8177299530979,61.38613861386144,9.461430079545375,14338280.0,1.2304250559284116,0.0068980863373386825,2.090923774485166,2.090923774485166,449.6,437.65,437.77136969728,444.2,466.0,0,1260.0,2.381622814150434,8404540.010097353
2016-05-12,454.4,452.5,455.3,448.4,49190.0,1237.6,0.1,452.09999999999997,55.7308017199404,-1.0009710950388921,465.05346605169245,441.71653394830764,450.2541366242315,59.16666666666662,9.27847078814928,14387470.0,1.3154960981047887,0.004198895027624161,2.041916986828627,2.041916986828627,450.275,437.65,438.82851490938884,444.2,466.0,0,1261.0,2.3816883663296706,8418189.639273154
2016-05-13,455.4,454.4,457.2,451.5,32390.0,1237.6,0.1,454.09999999999997,56.44533692266412,-0.9580041432623148,465.24853439015027,442.0514656098497,450.74421885049514,63.333333333333286,9.022865731852901,14419860.0,0.08791208791208291,0.0022007042253520126,1.9813056064674797,1.9813056064674797,450.47499999999997,437.65,439.84337431301327,444.2,466.0,0,1262.0,2.3817543398340444,8431884.734795796
2016-05-14,456.4,455.4,457.7,453.6,20360.0,1237.6,0.1,455.40000000000003,57.18948120154042,-0.8714585482578965,465.1183823669888,442.06161763301117,451.2828646742575,67.49999999999996,8.671232465291977,14440220.0,1.7614269788182781,0.002195871761089263,1.8999194709228697,1.8999194709228697,451.4,437.65,440.81763934049275,444.2,466.0,0,1263.0,2.381820731801016,8445625.269951448
2016-05-15,458.1,456.4,460.3,455.0,21200.0,1237.6,0.1,456.6333333333334,58.487946393264444,-0.7154769720549936,464.53149270554536,442.2885072944547,451.93211565766154,74.58333333333347,8.43043014634255,14461420.0,1.3047324192835104,0.0037248028045575587,1.8403034591448482,1.8403034591448482,453.1,437.65,441.752933766873,444.2,466.0,0,1264.0,2.381888268376768,8459458.477689603
2016-05-16,454.9,458.1,459.6,450.7,36600.0,1237.6,0.1,456.4666666666667,55.10014234868337,-0.8352269159684003,462.4047591592405,443.30524084075955,452.2147713093128,59.030837004405214,8.463970850175228,14424820.0,2.4088248536695156,-0.006985374372407871,1.8606223016432684,1.8606223016432684,453.45,437.65,442.6508164161981,444.2,466.0,0,1265.0,2.381951836034464,8473052.696605062
2016-05-17,453.3,454.9,456.3,451.7,34630.0,1237.6,0.1,455.4333333333334,53.43358259159121,-1.0175106317474238,462.3343003005956,444.0056996994043,452.3181264227116,45.500000000000114,8.18797293230557,14390190.0,0.6662225183211192,-0.003517256539898761,1.8063033161935957,1.8063033161935957,453.45,437.65,443.5127837595502,444.2,466.0,0,1266.0,2.382013102958784,8486515.162836004
2016-05-18,454.2,453.3,456.6,452.4,32610.0,1237.6,0.1,454.1333333333334,54.27142634324755,-1.0675704185653991,462.3718323971856,444.5381676028145,452.49735247769144,49.49494949494952,7.903117722855176,14422800.0,1.8842530282637902,0.0019854401058900795,1.7400083053401973,1.7400083053401973,452.925,437.65,444.34027240916816,444.2,454.2,0,1267.0,2.382074695205489,8500016.244247768
2016-05-19,442.7,454.2,455.2,441.1,59390.0,1237.6,0.1,450.06666666666666,43.501068214853255,-1.8210364139767794,462.87262677465367,442.8073732253464,451.56427128933984,6.926406926406789,8.34575217122266,14363410.0,-1.205088149966533,-0.025319242624394556,1.8851936234973257,1.8851936234973257,451.05,437.65,464.2,444.2,454.2,0,1268.0,2.3821234664961657,8512698.197236866
2016-05-20,442.1,442.7,447.8,435.4,48430.0,1237.6,0.1,446.3333333333333,43.021355650448086,-2.276122815210859,463.4537276351433,441.58627236485665,450.66291211892656,23.26388888888904,8.635341301849616,14314980.0,-3.8076588337684942,-0.0013553196295459369,1.953255214170915,1.953255214170915,449.625,438.65,463.738,444.2,454.2,0,1269.0,2.382170992681968,8525313.626071434
2016-05-21,443.6,442.1,445.2,439.7,23000.0,1237.6,0.1,442.8,44.66425745237581,-2.381129447915479,463.69601568151165,440.4839843184883,449.9902538218859,28.47222222222237,8.4113883517175,14337980.0,-3.249727371864772,0.0033928975344945655,1.8961650928127818,1.8961650928127818,449.625,440.2,462.60448,444.2,454.2,0,1270.0,2.382219531145754,8538009.922164716
2016-05-22,439.6,443.6,444.2,436.9,28740.0,1237.6,0.1,441.7666666666667,41.2486885218674,-2.6067783180087036,464.23891756170525,439.48108243829466,449.00070583884917,14.583333333333485,8.332003469451966,14309240.0,-3.996505787289791,-0.00901713255184855,1.8953602068817028,1.8953602068817028,449.375,440.65,461.5163008,439.6,454.2,0,1271.0,2.3822631671412333,8550399.667347064
2016-05-23,443.7,439.6,445.0,438.2,35900.0,1237.6,0.1,442.3,45.822035663486815,-2.3733500666243765,464.3998251736181,438.66017482638193,448.49587671133975,31.086142322097366,8.222574650205397,14345140.0,-3.6272806255430035,0.009326660600545766,1.8531833784551266,1.8531833784551266,448.45,440.65,460.471648768,439.6,454.2,0,1272.0,2.382310620606085,8563053.90007635
2016-05-24,446.1,443.7,447.9,442.0,33220.0,1237.6,0.1,443.1333333333334,48.35626722817807,-1.9674985475679543,464.38874945253514,438.701250547465,448.2676979769264,42.971887550200925,8.05667646090501,14378360.0,-0.7343124165553971,0.005409060175794567,1.806024761467162,1.806024761467162,448.65,440.65,459.46878281728004,439.6,454.2,0,1273.0,2.3823600385661163,8575851.944975717
2016-05-25,449.8,446.1,451.2,445.4,37720.0,1237.6,0.1,446.53333333333336,52.07790876573625,-1.3874035818583577,464.4037386852673,438.8562613147327,448.4136315029334,57.83132530120488,7.895485285126081,14416080.0,-0.5966850828729257,0.008294104460883078,1.7553324333317208,1.7553324333317208,447.9,440.65,458.50603150458886,439.6,454.2,0,1274.0,2.3824127770628105,8588883.727117714
2016-05-26,453.3,449.8,454.3,447.7,37720.0,1237.6,0.1,449.73333333333335,55.355367069439126,-0.738107095464619,463.58794178261644,439.04205821738344,448.87899993122545,71.88755020080325,7.802950621902791,14453800.0,-0.2420774647887249,0.007781236104935418,1.7213656787784668,1.7213656787784668,447.9,440.65,457.5817902444053,439.6,454.2,0,1275.0,2.382468588791813,8602133.983718498
2016-05-27,474.0,453.3,479.2,452.7,135680.0,1237.6,0.1,459.03333333333336,68.90177173841751,1.0198724817475022,467.6083633157461,436.57163668425386,451.2714761282516,88.12785388127857,9.138454148909734,14589480.0,4.084321475625829,0.04566512243547316,1.927943913272096,1.927943913272096,457.29999999999995,445.79999999999995,435.4,439.6,454.2,1,1276.0,2.3825449600333934,8616759.159223245
2016-05-28,524.2,474.0,531.8,467.0,150170.0,1237.6,0.1,483.8333333333334,82.65045193319199,5.260893534098947,490.47752343358695,420.3324765664131,458.21704983032294,92.1161825726142,13.114278852559035,14739650.0,14.855390008764257,0.10590717299578079,2.501770097779289,2.501770097779289,483.59999999999997,472.09999999999997,436.27599999999995,439.6,454.2,1,1277.0,2.3826683902347687,8634521.125459487
2016-05-29,516.0,524.2,548.0,493.2,152570.0,1237.6,0.1,504.7333333333334,76.68643675069659,7.096973339556136,502.100021348048,414.2699786519521,463.7201879417207,71.58081705150977,16.091830363090533,14587080.0,12.639161755075307,-0.015642884395269063,3.1185717757927387,3.1185717757927387,492.075,480.2,440.09695999999997,439.6,454.2,1,1278.0,2.382783653242559,8651774.226903258
2016-05-30,532.3,516.0,544.2,512.8,77530.0,1237.6,0.1,524.1666666666666,79.80587867264214,8.8767895512562,516.5792064458044,408.0807935541955,470.2515986139378,86.05683836589695,17.185271051441216,14664610.0,17.014728511760822,0.03158914728682172,3.2284935283564185,3.2284935283564185,492.075,480.2,446.5711424,439.6,454.2,0,1279.0,2.3829129485159606,8669991.368530096
2016-05-31,528.9,532.3,546.9,513.2,114080.0,1237.6,0.1,525.7333333333333,77.47715525568758,9.25059994938679,527.4002571423134,404.8997428576866,475.83716065070564,83.03730017761988,18.36489454776684,14550530.0,16.677696889477158,-0.0063873755401089305,3.472281064051209,3.472281064051209,492.4,482.35,452.656873856,439.6,454.2,0,1280.0,2.3830385041740016,8687994.18299812
2016-06-01,537.4,528.9,542.3,521.3,72410.0,1237.6,0.1,532.8666666666667,79.11769288877063,9.461903594610233,538.640354110873,401.95964588912705,481.7002882077813,90.5861456483126,18.553116365783495,14622940.0,18.317921620431527,0.016071090943467592,3.452384883845087,3.452384883845087,493.35,483.05,458.37746142464,439.6,454.2,0,1281.0,2.3831708971287116,8706487.544688255
2016-06-02,537.1,537.4,541.5,530.5,52880.0,1237.6,0.1,534.4666666666667,78.89925755874728,8.977113235311332,548.2206357052577,400.5493642947424,486.97645123561165,90.31971580817053,18.013608053941816,14570060.0,21.32369550485657,-0.0005582433941198062,3.3538648396838235,3.3538648396838235,494.2,484.35,463.7548137391616,439.6,454.2,0,1282.0,2.383302314913055,8724951.558495604
2016-06-03,567.0,537.1,573.7,534.3,106250.0,1237.6,0.1,547.1666666666666,83.72277841924287,9.988270941618982,563.4625499341514,396.3674500658486,494.59774159412484,95.10233918128651,19.541207478660265,14676310.0,28.251526803890513,0.0556693353193074,3.4464210720741213,3.4464210720741213,507.625,497.55,468.8095249148119,439.6,454.2,0,1283.0,2.3834586181243553,8745120.81047297
2016-06-04,572.0,567.0,592.7,560.9,87410.0,1237.6,0.1,558.7,84.36636914480054,10.272228237340016,577.5404715532316,393.6795284467684,501.96938525182725,86.71373555840819,20.41683551589882,14763720.0,28.944995491433716,0.008818342151675429,3.5693768384438496,3.5693768384438496,518.375,507.25,477.20076292162696,439.6,454.2,0,1284.0,2.3836183235268655,8765562.249755401
2016-06-05,574.9,572.0,583.6,567.8,64519.99999999999,1237.6,0.1,571.3000000000001,84.74316543271024,9.92807531323151,590.1652210692033,393.0547789307968,508.9151580849865,88.47896440129445,20.08706155047748,14828240.0,30.77797998180163,0.005069930069929951,3.4940096626330632,3.4940096626330632,521.95,508.0,488.75068662946427,439.6,454.2,0,1285.0,2.3837796678884677,8786158.736248333
2016-06-06,583.6,574.9,586.7,571.7,63680.0,1237.6,0.1,576.8333333333334,85.84534413705968,9.555790495078796,602.7302173650986,393.5197826349014,516.0280001721306,93.96151293961512,19.72370001115766,14891920.0,31.53031327473519,0.015133066620281799,3.379660728436885,3.379660728436885,528.5,508.25,499.1456179665179,439.6,454.2,0,1286.0,2.383947348482538,8807228.61567286
2016-06-07,575.6,583.6,591.3,543.6,84690.0,1237.6,0.1,578.0333333333333,80.11406249054302,8.097854370852712,611.9422315189561,396.4477684810439,521.701523965261,88.39103869653766,21.722007153217824,14807230.0,29.029365613091233,-0.013708019191226883,3.773802493609768,3.773802493609768,533.4,508.25,508.5010561698661,439.6,454.2,0,1287.0,2.3841077621436355,8827853.528381776
2016-06-08,580.5,575.6,582.4,567.8,49600.0,1237.6,0.1,579.9000000000001,80.9528570829648,6.84067167640697,619.8404187155726,402.32958128442726,527.3013788257124,91.5862068965517,21.21329235655941,14856830.0,29.057358826144952,0.00851285615010422,3.6543139287785373,3.6543139287785373,533.5,508.55,516.9209505528795,439.6,454.2,0,1288.0,2.3842714239105662,8848744.083243638
2016-06-09,574.7,580.5,580.7,569.3,48610.0,1237.6,0.1,576.9333333333334,76.8222564449641,5.076780659421022,624.9973429087916,410.4326570912085,531.8155332232636,87.14285714285715,20.51234290251946,14808220.0,26.78138098389588,-0.00999138673557265,3.569226188014522,3.569226188014522,535.525,509.75,524.4988554975915,439.6,454.2,0,1289.0,2.3844296035807413,8869307.671759507
2016-06-10,577.9,574.7,579.3,571.1,45500.0,1237.6,0.1,577.7,77.5042620429083,3.6505487285495057,629.0960231402701,419.76397685973006,536.2045300591433,88.2259347653142,19.63288983805378,14853720.0,21.919831223628687,0.005568122498694761,3.3972815085748023,3.3972815085748023,537.825,512.6,531.3189699478323,439.6,454.2,0,1290.0,2.3845896548923653,8890043.49725902
2016-06-11,591.6,577.9,592.6,576.3,42220.0,1237.6,0.1,581.4000000000001,80.19159547325742,3.1724855369666862,632.9610279349197,431.09897206508026,541.4802891011296,98.89447236180902,19.394826278192802,14895940.0,12.857687905379619,0.023706523620003583,3.278368201182015,3.278368201182015,538.775,513.3,537.4570729530491,439.6,454.2,0,1291.0,2.3847599888713713,8911527.907668302
2016-06-12,666.5,591.6,683.8,592.8,217380.0,1237.6,0.1,612.0,88.37086651387847,7.212187293928352,651.5520667822843,434.78793321771565,553.3869282343554,89.88304093567254,24.595195829750455,15113320.0,29.166666666666668,0.1266058147396889,3.6902019249438043,3.6902019249438043,586.65,558.8499999999999,542.9813656577442,439.6,454.2,1,1292.0,2.3849856462049743,8936855.639582492
2016-06-13,700.1,666.5,718.2,652.8,216730.0,1237.6,0.1,652.7333333333333,90.30488347896826,11.219661206207668,674.791824742137,436.948175257863,567.3596017358454,91.17073170731706,27.509824699054,15330050.0,31.523576930302475,0.05041260315078766,3.92941361220597,3.92941361220597,603.85,576.05,559.8796017788148,439.6,454.2,1,1293.0,2.385233595006975,8963786.480647875
2016-06-14,685.1,700.1,702.5,654.7,135650.0,1237.6,0.1,683.9000000000001,83.61906051504795,11.869746586347361,688.7904749072429,446.4795250927571,578.5729729990983,83.18943626206196,28.959122934835854,15194400.0,29.532993004348658,-0.02142551064133691,4.226992108427361,4.226992108427361,603.85,576.05,582.0444575297807,439.6,454.2,0,1294.0,2.3854704974999015,8990033.488210328
2016-06-15,690.8,685.1,695.1,670.5,78620.0,1237.6,0.1,692.0,84.10077302534013,11.675379415676815,700.0670885514393,458.9529114485607,589.2612612848984,85.40223761321253,28.64775701091901,15273020.0,28.54484555266096,0.008319953291490156,4.1470406790560235,4.1470406790560235,604.225,576.05,601.1062334756115,439.6,454.2,0,1295.0,2.38571044190772,9016565.297609156
2016-06-16,761.2,690.8,769.7,687.4,229570.0,1237.6,0.1,712.3666666666668,88.57107594465224,15.064307091814293,728.3503048777018,459.38969512229846,605.6363792577652,96.38912489379778,32.48006008156766,15502590.0,41.724073729286914,0.1019108280254779,4.266954818913249,4.266954818913249,636.025,601.8,617.4993607890259,439.6,761.2,1,1296.0,2.385995102080807,9046278.230195837
2016-06-17,743.9,761.2,771.9,704.2,215870.0,1237.6,0.1,731.9666666666667,82.43710383558746,14.89037764938577,750.2279338632181,459.4820661367819,618.8043431379781,87.73543583004819,34.99577007574139,15286720.0,31.199294532627864,-0.022727272727272818,4.704364844164726,4.704364844164726,637.8249999999999,602.9,641.8514630627818,439.6,761.2,1,1297.0,2.3862680558750253,9075271.011660885
2016-06-18,753.8,743.9,776.0,727.1,120530.0,1237.6,0.1,752.9666666666667,83.15600431436144,14.194338330993382,769.7995063041255,463.69049369587447,631.6610723629326,90.44750430292596,35.988929356045574,15407250.0,31.783216783216776,0.013308240354886314,4.774333955431889,4.774333955431889,641.275,604.95,665.260199711481,439.6,761.2,0,1298.0,2.3865463126082807,9104725.12476615
2016-06-19,761.0,753.8,765.1,740.4,60450.0,1237.6,0.1,752.9,83.6792372529391,13.002878727933094,788.2998126404088,468.0601873595913,643.9790654712248,93.54561101549052,35.18257725918518,15467700.0,32.370847103844156,0.009551605200318392,4.623203319209616,4.623203319209616,643.425,605.7,687.4081597691849,439.6,761.2,0,1299.0,2.3868281209377957,9134521.665858379
2016-06-20,734.0,761.0,764.6,717.4,112290.0,1237.6,0.1,749.6,74.3518943422915,9.351157276117831,798.0782432018332,478.79175679816694,652.5524878072986,81.92771084337349,36.04096459781481,15355410.0,25.771076079506507,-0.03547963206307492,4.910213160465234,4.910213160465234,648.125,605.7,705.1265278153479,439.6,761.2,0,1300.0,2.387092087583808,9163157.747888688
2016-06-21,667.4,734.0,732.2,626.0,248080.0,1237.6,0.1,720.8000000000001,57.36595385334747,1.8003279672268562,798.0465446333151,491.82345536668487,653.9665365875559,47.8386167146974,41.180895697970904,15107330.0,15.948575399583035,-0.09073569482288835,6.170346973025308,6.170346973025308,657.675,605.7,776.0,439.6,761.2,1,1301.0,2.3873106081398343,9188673.250620797
2016-06-22,590.6,667.4,677.8,586.6,202320.0,1237.6,0.1,664.0000000000001,44.68775016695173,-8.45360314122781,794.8489337098025,500.3710662901973,647.9316283411221,10.3047895500726,44.753688862401546,14905010.0,1.7398794142980227,-0.11507341923883718,7.577664893735446,7.577664893735446,651.4,605.7,773.0,590.6,761.2,0,1302.0,2.3874710630431712,9210148.257439708
2016-06-23,620.8,590.6,629.5,539.3,261740.0,1237.6,0.1,626.2666666666667,49.42144572445442,-13.01650057730481,793.4590723635762,507.1409276364237,645.3476637372057,34.431770173215035,47.999853943658586,15166750.0,8.021576474682426,0.0511344395529969,7.731935235769748,7.731935235769748,646.125,605.7,765.544,590.6,761.2,1,1303.0,2.3876541197619345,9233273.04338837
2016-06-24,656.9,620.8,687.4,616.4,196690.0,1237.6,0.1,622.7666666666668,54.44071860241262,-13.366982283442333,793.127011458918,515.9629885410822,646.4478862384242,49.68314321926489,49.64272151911155,15363440.0,13.670185153140682,0.05815077319587636,7.557120036399992,7.557120036399992,651.025,605.7,751.9693599999999,590.6,761.2,0,1304.0,2.3878628487889824,9258278.44533168
2016-06-25,663.5,656.9,688.1,640.8,100460.0,1237.6,0.1,647.0666666666667,55.31382859724336,-12.910985614063257,792.6681093961079,525.2818906038922,648.07189707286,52.47148288973384,49.47538426774644,15463900.0,12.153482082488164,0.010047191353326212,7.456727093857792,7.456727093857792,651.125,605.7,739.2091984,590.6,761.2,0,1305.0,2.3880754469826186,9283624.591164604
2016-06-26,625.4,663.5,665.2,609.9,88930.0,1237.6,0.1,648.6,49.42529583883385,-14.796630846711622,791.2400863260696,530.8899136739306,645.9126687802067,36.37515842839037,49.8914282486217,15374970.0,-6.166541635408856,-0.05742275810097974,7.977522905120195,7.977522905120195,653.15,605.7,727.214646496,590.6,761.2,0,1306.0,2.3882595948985452,9307002.665154561
2016-06-27,644.7,625.4,650.3,615.2,99810.0,1237.6,0.1,644.5333333333334,52.201217629266885,-14.354264801547991,788.9808950634683,540.0591049365319,645.7971765154251,44.52893958597384,48.83489765943443,15474780.0,-7.913155263533778,0.030860249440358256,7.5748251371854245,7.5748251371854245,652.725,605.7,715.93976770624,590.6,761.2,0,1307.0,2.3884571716175227,9331399.218908243
2016-06-28,644.9,644.7,659.3,634.3,76660.0,1237.6,0.1,638.3333333333334,52.2304781559589,-13.662137053453009,786.5430201636291,548.9369798363709,645.7117311330037,44.61343472750317,47.13240496947483,15551440.0,-5.867756531893161,0.0003102218085930808,7.308482705764432,7.308482705764432,653.55,605.7,705.3413816438656,590.6,761.2,0,1308.0,2.388654104904987,9355810.433369568
2016-06-29,636.5,644.9,645.9,621.8,80220.0,1237.6,0.1,642.0333333333333,50.82325883773337,-13.367439123811838,782.8115359780338,558.8484640219663,644.834423406051,41.06463878326997,45.48723318594091,15471220.0,-7.860451650260561,-0.01302527523647079,7.146462401561808,7.146462401561808,646.7,605.7,695.3788987452336,590.6,761.2,0,1309.0,2.3888441321082348,9379784.678209512
2016-06-30,670.0,636.5,673.0,631.2,88200.0,1237.6,0.1,650.4666666666667,55.9235461046064,-10.632863845641403,779.0109677724504,571.8590322275497,647.2311449864271,55.21757498943811,45.22385938694513,15559420.0,-11.98108250131372,0.05263157894736836,6.749829759245542,6.749829759245542,635.675,605.7,686.0141648205196,590.6,761.2,0,1310.0,2.389057311827671,9405490.543524442
2016-07-01,674.6,670.0,685.1,661.1,92230.0,1237.6,0.1,660.3666666666667,56.58932366347329,-8.332467705263852,775.7804733862238,583.3895266137763,649.8377026067675,57.160963244613455,43.70786943073477,15651650.0,-9.315768248420481,0.006865671641790971,6.479079370105954,6.479079370105954,635.675,605.7,539.3,590.6,761.2,0,1311.0,2.3892728737966245,9431436.613870537
2016-07-02,698.1,674.6,700.5,671.5,67380.0,1237.6,0.1,680.9000000000001,59.92008851760601,-5.199651978371357,777.4868620044259,584.843137995574,654.4341118823135,70.32772364924713,42.65730732853943,15719030.0,-7.389227911912966,0.034835458049214285,6.11048665356531,6.11048665356531,656.425,605.7,542.216,590.6,761.2,0,1312.0,2.38950358457479,9458552.54888088
2016-07-03,661.6,698.1,701.5,644.6,99270.0,1237.6,0.1,678.1,53.10470767341983,-5.526527928854314,775.5100867351831,582.9699132648169,655.1165774173312,54.283177984909024,43.67464251935804,15619760.0,-13.061760840998682,-0.05228477295516398,6.601366765320138,6.601366765320138,656.675,605.7,548.54736,590.6,761.2,0,1313.0,2.3897084462503386,9483859.227628326
2016-07-04,675.2,661.6,679.0,644.0,63910.0,1237.6,0.1,678.3000000000001,55.151601650895415,-4.794875187572785,774.9912773306047,582.4987226693953,657.0292843299663,70.45101088646969,43.05502519654675,15683670.0,-8.010899182561301,0.02055622732769047,6.376632878635478,6.376632878635478,656.675,605.7,557.7245184000001,590.6,761.2,0,1314.0,2.389921987851819,9509865.084103215
2016-07-05,663.7,675.2,679.2,657.3,54640.0,1237.6,0.1,666.8333333333334,53.043264971119925,-5.029006486465846,773.6823029114979,581.0976970885021,657.6645905842553,76.6954377311961,41.54395196822198,15629030.0,-0.5543901708120965,-0.01703199052132698,6.259447335877953,6.259447335877953,658.0,605.7,566.351047296,590.6,761.2,0,1315.0,2.3901267273629196,9535294.118358884
2016-07-06,672.7,663.7,678.4,662.2,47050.0,1237.6,0.1,670.5333333333334,54.50893854675322,-4.536474730514513,761.2455816700345,584.6844183299653,659.0965343381358,82.24414303329226,39.73366968477755,15676080.0,13.901117507619373,0.013560343528702834,5.906595761078869,5.906595761078869,659.65,605.7,574.45998445824,590.6,761.2,0,1316.0,2.390336939255899,9561190.359032359
2016-07-07,635.3,672.7,676.2,605.0,153610.0,1237.6,0.1,657.2333333333333,47.82802853928133,-6.565104035700973,750.9190338434142,584.1509661565857,656.8301977345039,31.3989637305699,41.98126470729345,15522470.0,2.3356958762886597,-0.05559684852088609,6.608100851140162,6.608100851140162,655.45,605.7,582.0823853907456,590.6,761.2,0,1317.0,2.3905197511670178,9585134.629197001
2016-07-08,662.8,635.3,663.4,630.2,75890.0,1237.6,0.1,656.9333333333333,52.44357252295955,-5.910874568825594,736.3760151176535,589.5939848823465,657.3987503312179,59.89637305699477,41.35403151391534,15598360.0,0.8981580149185535,0.04328663623484963,6.2392926243082885,6.2392926243082885,655.45,605.7,589.2474422673008,590.6,761.2,0,1318.0,2.3907214966504053,9610534.551900245
2016-07-09,651.8,662.8,663.5,620.7,96010.0,1237.6,0.1,649.9666666666666,50.51835621648581,-6.052884967140702,715.5821055082807,599.4678944917192,656.8655360139591,48.49740932642482,41.4573149772071,15502350.0,-1.763376036171823,-0.016596258298129163,6.360434945874056,6.360434945874056,655.45,605.7,595.9825957312628,590.6,761.2,0,0.0,2.3909146793215377,9635364.32855783
2016-07-10,647.1,651.8,652.0,636.8,29260.0,1237.6,0.1,653.9,49.679183095570615,-6.270671636222691,699.5174837469585,606.8425162530416,655.9354849650106,43.62694300518137,39.58179247883516,15473090.0,3.469779341221626,-0.00721080085915915,6.1167968596561835,6.1167968596561835,655.45,605.7,602.313639987387,590.6,761.2,0,1.0,2.3911037259309635,9659947.895041352
2016-07-11,646.7,647.1,657.5,640.0,45940.0,1237.6,0.1,648.5333333333334,49.60366293262377,-6.235828583221068,698.0888124234335,606.2011875765667,655.0559149683429,43.21243523316067,38.0045215874898,15427150.0,0.3102218085931441,-0.0006181424818419989,5.8766849524493265,5.8766849524493265,655.45,606.45,608.2648215881437,590.6,761.2,0,2.0,2.391291716278502,9684512.346699612
2016-07-12,670.6,646.7,673.2,644.6,66590.0,1237.6,0.1,654.8000000000001,54.094014836060005,-4.4794866995933305,692.9878269816479,619.302173018352,656.5363040189769,67.97927461139898,37.33277004552624,15493740.0,3.9851139711583263,0.036956857893923,5.56706979503821,5.56706979503821,649.875,606.45,613.8589322928551,590.6,761.2,0,3.0,2.391495775495815,9710335.947939035
2016-07-13,661.2,670.6,672.0,656.0,62960.0,1237.6,0.1,659.5000000000001,52.12677679834521,-3.8511315924936245,691.2758607559459,625.054139244054,656.9804655409791,58.23834196891197,35.80900075656008,15430780.0,3.880597014925381,-0.014017297942141349,5.415759340072608,5.415759340072608,649.875,607.1,619.1173963552839,590.6,761.2,0,4.0,2.3916924997822013,9735676.14076184
2016-07-14,657.3,661.2,661.9,646.3,48200.0,1237.6,0.1,663.0333333333334,51.293307062746926,-3.602941498307878,691.293263318991,625.0767366810089,657.0108973942192,54.196891191709796,34.36550070252007,15382580.0,-1.895522388059708,-0.005898366606170713,5.228282474139673,5.228282474139673,646.95,609.0,624.0603525739668,590.6,761.2,0,5.0,2.3918857038429917,9760815.065059256
2016-07-15,664.2,657.3,667.5,656.5,35830.0,1237.6,0.1,660.9,52.73327763880775,-2.9085994023428228,691.3521354578851,625.087864542115,657.6955738328651,61.347150259067405,32.69653636662578,15418410.0,-1.541654313667355,0.010497489730716625,4.922694424364013,4.922694424364013,646.2750000000001,610.7,628.7067314195289,590.6,761.2,0,6.0,2.3920829730713877,9786321.736951211
2016-07-16,660.7,664.2,665.4,655.7,20390.0,1237.6,0.1,660.7333333333333,51.89517806782241,-2.6280908523960598,689.499015314756,630.470984685244,657.9817096583065,57.72020725388606,31.053926626152503,15398020.0,-5.357398653488035,-0.005269497139415824,4.700155384615181,4.700155384615181,641.35,611.85,633.0743275343572,590.6,761.2,0,7.0,2.392277017796298,9811648.5722837
2016-07-17,676.3,660.7,680.9,660.1,46840.0,1237.6,0.1,667.0666666666667,55.30484923067074,-1.3967625439339528,691.020069173228,632.1099308267719,659.7263087384678,93.93939393939391,30.321503295713033,15444860.0,2.221886336154766,0.023611321325866408,4.483439789400123,4.483439789400123,635.5999999999999,614.35,637.1798678822958,590.6,676.3,0,8.0,2.392481091314235,9837796.722347297
2016-07-18,670.4,676.3,680.4,664.6,42580.0,1237.6,0.1,669.1333333333333,53.753037632261,-1.0029233635836077,691.4959871580032,634.1840128419966,660.7428507633756,86.16600790513834,29.284253060304955,15402280.0,-0.7109004739336593,-0.008723939080289789,4.368176172479856,4.368176172479856,639.625,621.5,641.039075809358,590.6,676.3,0,9.0,2.3926803248513457,9863644.211876646
2016-07-19,671.1,670.4,673.2,663.6,30400.0,1237.6,0.1,672.6,53.91824730898568,-0.7311693980826162,690.7249307014882,638.4150692985116,661.7292459287684,87.08827404479584,27.878234984568888,15432680.0,1.1149615790266652,0.0010441527446301002,4.154110413435983,4.154110413435983,656.85,634.6,644.6667312607965,590.6,676.3,0,10.0,2.392879262026403,9889533.940206187
2016-07-20,664.4,671.1,672.3,659.5,37560.0,1237.6,0.1,668.6333333333333,52.00335192378131,-1.020766101281291,690.3260442463837,638.2539557536162,661.9836034593618,78.26086956521739,26.80121819995682,15395120.0,-1.2338338040731482,-0.009983609000149052,4.033897983136186,4.033897983136186,658.0,644.4,648.0767273851487,590.6,676.3,0,11.0,2.393072783385725,9915075.332688466
2016-07-21,664.6,664.4,666.5,657.8,32170.0,1237.6,0.1,666.7,52.0580868482742,-1.204356977967457,689.3953822467007,638.1846177532994,662.2327840822797,72.92358803986716,25.50827404281705,15427290.0,4.611994333385813,0.0003010234798315192,3.8381393383715086,3.8381393383715086,658.425,644.6,651.2821237420399,590.6,676.3,0,12.0,2.393265673794936,9940631.24583694
2016-07-22,651.1,664.6,669.4,645.7,65900.0,1237.6,0.1,660.0333333333333,48.07295334982149,-2.1834383402770126,682.1840979557959,640.6959020442042,661.1725189315864,50.498338870431915,25.379111611187255,15361390.0,-1.765238382619181,-0.020312970207643666,3.8978822932248893,3.8978822932248893,658.275,648.65,701.5,590.6,676.3,0,13.0,2.3934483186156004,9965464.14292453
2016-07-23,655.2,651.1,658.2,648.0,29890.0,1237.6,0.1,656.9666666666667,49.34131571876382,-2.481625284063653,682.0410515988,640.1989484012,660.6037076047686,41.72335600907048,24.29488935324531,15391280.0,0.5216324025774918,0.0062970357855935966,3.708011195550261,3.708011195550261,658.275,653.25,700.384,590.6,676.3,0,14.0,2.39363310696251,9990520.575903637
2016-07-24,659.3,655.2,664.2,651.0,29820.0,1237.6,0.1,655.2000000000002,50.63972607316486,-2.3317532191096006,680.2291578570823,640.4208421429178,660.479544975743,47.18826405867962,23.502397256584935,15421100.0,1.8853345696182866,0.006257631257631013,3.564750076836787,3.564750076836787,658.275,655.15,699.2903200000001,590.6,676.3,0,15.0,2.39382001702588,10015800.269537905
2016-07-25,654.0,659.3,662.5,651.1,34380.0,1237.6,0.1,656.1666666666666,48.895108764153065,-2.503474491753696,679.8639256890265,639.8160743109736,659.8624454542437,25.895316804407685,22.63794030968601,15386720.0,1.1288077934127034,-0.008038829061125408,3.461458762948931,3.461458762948931,658.275,657.65,698.2185136,590.6,676.3,0,16.0,2.3940024461916285,10040794.394060332
2016-07-26,654.4,654.0,657.8,643.5,49390.0,1237.6,0.1,655.9,49.0378093389979,-2.4982957167097455,678.1721166671699,639.67788333283,659.3422125538395,29.144385026737925,22.04237314470843,15436110.0,-2.415747092156285,0.0006116207951070152,3.368333304509235,3.368333304509235,657.6,657.65,697.168143328,590.6,676.3,0,17.0,2.3941844051388403,10065811.151770249
2016-07-27,654.5,654.4,659.1,646.0,29890.0,1237.6,0.1,654.3000000000001,49.07609266533976,-2.3959620766973537,675.9801265916007,643.7898734083993,658.8810494534739,29.41176470588237,21.403632205800687,15466000.0,-1.0133091349062378,0.00015281173594128283,3.2702264638350935,3.2702264638350935,655.8,657.65,695.0214175948801,590.6,676.3,0,18.0,2.3943656836096547,10090834.067393685
2016-07-28,654.1,654.5,658.0,650.8,28110.0,1237.6,0.1,654.3333333333334,48.9177955032318,-2.264546097715773,675.6762133598586,643.2237866401415,658.425711410286,28.342245989304892,20.3890870482435,15437890.0,-0.48684010345351164,-0.0006111535523299905,3.1171207840152118,3.1171207840152118,655.575,657.65,692.9605608910848,590.6,676.3,0,19.0,2.3945459311348616,10115835.581168255
2016-07-29,655.4,654.1,657.4,651.0,27040.0,1237.6,0.1,654.6666666666666,49.488045600559104,-2.008139527742339,675.5904636524021,643.6695363475978,658.1375484188302,31.818181818181777,19.389866544797535,15464930.0,-1.324902137910278,0.001987463690567015,2.9584782643877836,2.9584782643877836,649.7,657.65,690.9821384554414,590.6,676.3,0,20.0,2.3947263451421708,10140908.692236703
2016-07-30,654.7,655.4,657.5,652.1,19350.0,1237.6,0.1,654.7333333333333,49.169748199870156,-1.8098909043419966,675.0970673094425,644.9229326905574,657.810162855132,29.946524064171264,18.39059036302628,15445580.0,-0.9081277433025577,-0.0010680500457734832,2.8090102891440782,2.8090102891440782,649.7,657.65,689.0828529172237,590.6,676.3,0,21.0,2.39490552031663,10165943.647737008
2016-07-31,621.9,654.7,654.9,621.4,62890.0,1237.6,0.1,644.0,37.12160707843281,-3.7029089766485743,680.5991639784864,636.9408360215135,654.3901473451194,0.847457627118644,19.469833908524404,15382690.0,-8.043767558775688,-0.05009928211394543,3.1307017058247952,3.1307017058247952,642.875,657.65,687.2595388005348,590.6,676.3,0,22.0,2.3950603132323227,10189124.187655209
2016-08-01,607.0,621.9,627.9,603.5,66660.0,1237.6,0.1,627.8666666666667,33.14806879888371,-5.65668150292603,686.3162038006594,624.8637961993406,649.8767999789176,5.021520803443325,19.821988629344087,15316030.0,-9.457040572792359,-0.023958835825695468,3.2655664957733253,3.2655664957733253,638.0250000000001,657.65,683.3079664725027,590.6,676.3,0,23.0,2.3952032476928338,10211421.616668953
2016-08-02,513.4,607.0,613.8,471.4,130910.0,1237.6,0.1,580.7666666666668,19.225812995814678,-12.555671180735473,717.2141724575444,579.1858275424557,636.879009504735,20.905923344947738,28.577560870105224,15185120.0,-23.498733422738795,-0.15420098846787478,5.566334411785202,5.566334411785202,571.55,623.7,676.9233291547025,513.4,676.3,1,24.0,2.3952685390671546,10227647.81333036
2016-08-03,566.4,513.4,573.1,514.1,85930.0,1237.6,0.1,562.2666666666668,35.69526154877077,-12.808284295356167,721.1276655020961,566.1823344979039,630.1667228852365,47.97979797979798,30.80059223652628,15271050.0,-14.750150511739916,0.10323334631865988,5.437957668878228,5.437957668878228,570.7,623.7,656.3709962392322,513.4,676.3,0,25.0,2.395378362964127,10247408.7398023
2016-08-04,576.2,566.4,584.9,559.5,44820.0,1237.6,0.1,552.0,38.20425720127026,-11.609565351154076,721.414539312241,557.095460687759,625.0270349914044,52.92929292929296,30.414835648202974,15315870.0,-13.301233824857054,0.017302259887005844,5.278520591496524,5.278520591496524,570.7,623.7,637.873896615309,513.4,676.3,0,26.0,2.3954954136078,10267775.227070538
2016-08-05,574.7,576.2,580.0,565.8,27890.0,1237.6,0.1,572.4333333333334,37.960119768531875,-10.258697470631173,721.0811975243287,548.8288024756712,620.2339840398421,53.578838174273876,29.256633101902764,15287980.0,-11.733988634618333,-0.0026032627559875454,5.090766156586525,5.090766156586525,570.425,623.7,621.2265069537781,513.4,676.3,0,27.0,2.3956106109336126,10288031.396270536
2016-08-06,586.5,574.7,596.7,565.3,25380.0,1237.6,0.1,579.1333333333333,41.146310281065105,-8.011123735505652,716.8639415444406,544.0660584555592,617.0212236550952,59.69917012448131,29.409730737481144,15313360.0,-10.48534798534799,0.020532451713937583,5.014446843560298,5.014446843560298,570.3,623.7,606.2438562584002,513.4,676.3,0,28.0,2.395734475413723,10309011.667330397
2016-08-07,590.8,586.5,596.0,580.9,26200.0,1237.6,0.1,584.0,42.30904239829402,-5.779707179084848,712.4914945222145,540.4785054777856,614.5239642593718,62.480376766091034,28.38760711337535,15339560.0,-10.389807371454573,0.007331628303495208,4.804943654938279,4.804943654938279,570.3,623.7,471.4,513.4,676.3,0,29.0,2.3958610230015704,10330244.300464302
2016-08-08,589.2,590.8,594.2,585.4,24880.0,1237.6,0.1,588.8333333333334,41.97672677875062,-4.038743267136823,707.3015751826551,537.4784248173448,612.1121581394317,62.759722962173704,26.988492319562827,15314680.0,-9.908256880733939,-0.0027081922816518667,4.5805316224648385,4.5805316224648385,569.65,623.7,473.892,513.4,676.3,0,30.0,2.395985659230777,10351364.386993684
2016-08-09,585.3,589.2,591.2,581.1,25970.0,1237.6,0.1,588.4333333333334,41.12873389669062,-2.8340252900893326,702.5157534457186,534.3542465542815,609.5586192690097,60.681939264784205,25.782171439594055,15288710.0,-10.559290953545236,-0.006619144602851512,4.404949844454819,4.404949844454819,562.9,618.25,476.33416,513.4,676.3,0,31.0,2.3961065881648,10372227.543824267
2016-08-10,590.9,585.3,600.5,580.9,49570.0,1237.6,0.1,588.4666666666667,42.91208128318539,-1.4158420601180985,696.8514616191436,532.6485383808564,607.7816079100563,64.0407288317256,25.34058776533734,15338280.0,-9.717341482047367,0.009567743037758536,4.288473136797655,4.288473136797655,559.375,618.0,478.7274768,513.4,590.9,0,32.0,2.39623121623152,10393424.977376262
2016-08-11,587.8,590.9,599.2,585.4,39830.0,1237.6,0.1,588.0,42.150883343189754,-0.4901931382384106,692.7119196999349,530.4580803000649,605.8785976329082,62.54701773240192,24.51626006781325,15298450.0,-10.136064821892688,-0.005246234557454765,4.170850641002595,4.170850641002595,566.7249999999999,601.8,483.598377728,513.4,590.9,0,33.0,2.396352772760132,10414415.383276079
2016-08-12,587.1,587.8,591.1,582.2,25500.0,1237.6,0.1,588.6,41.96984257021822,0.23250041773771102,687.3926909024035,528.9673090975966,604.0901597631074,62.17087587318647,23.400812920112305,15272950.0,-10.421116875190716,-0.0011908812521264078,3.985830849959514,3.985830849959514,577.95,586.45,488.27444261888,513.4,590.9,0,34.0,2.3964731243424966,10435347.36227921
2016-08-13,584.6,587.1,590.1,582.8,19300.0,1237.6,0.1,586.5,41.28778976191088,0.6746989815117672,680.65131141841,528.2386885815898,602.233954071383,61.689373297002746,22.250754854390003,15253650.0,-10.707194134718193,-0.004258218361437582,3.8061503343123504,3.8061503343123504,577.5999999999999,586.45,492.7634649141248,513.4,590.9,0,35.0,2.3965908672507177,10456107.290658621
2016-08-14,569.1,584.6,585.8,559.9,33070.0,1237.6,0.1,580.2666666666668,37.24631101290217,0.08674053376703483,674.3217646848732,526.0782353151269,599.078339397918,62.42811501597446,22.51141522193357,15220580.0,-8.490110950313548,-0.026513855627779637,3.9556168023077793,3.9556168023077793,576.025,586.45,497.07292631755985,513.4,590.9,0,36.0,2.396695677164662,10475860.53737038
2016-08-15,567.0,569.1,575.0,559.3,33770.0,1237.6,0.1,573.5666666666667,36.721847276198886,-0.26111962201941097,666.8973511536748,524.7626488463253,596.0232594552591,67.13483146067418,22.024885563224036,15186810.0,-6.589785831960461,-0.0036900369003690647,3.8844595349601474,3.8844595349601474,575.15,586.45,501.21000926485743,513.4,590.9,0,37.0,2.3967981628834,10495459.01711492
2016-08-16,580.2,567.0,583.4,563.4,37690.0,1237.6,0.1,572.1,42.22847076567951,0.536749985142567,658.1134022533857,526.1165977466143,594.5162823642821,76.50462962962968,21.880250880136604,15224500.0,13.011297234125452,0.023280423280423346,3.7711566494547744,3.7711566494547744,575.15,586.45,505.18160889426315,513.4,590.9,0,38.0,2.3969105232752512,10515890.208479928
2016-08-17,572.3,580.2,581.1,568.7,32759.999999999996,1237.6,0.1,573.1666666666666,39.98575256127366,0.6631390996799169,648.0164618925036,528.0335381074964,592.4004459486363,31.55339805825239,21.20309010298399,15191740.0,1.0416666666666625,-0.013615994484660665,3.704890809537653,3.704890809537653,573.8499999999999,586.45,508.9943445384926,513.4,590.9,0,39.0,2.397015982579689,10535796.772296473
2016-08-18,573.4,572.3,579.5,570.8,30390.0,1237.6,0.1,575.3000000000001,40.45991709429251,0.9348792701583832,635.5644761785952,532.2855238214047,590.5908796678137,34.2233009708738,20.310012238485136,15222130.0,-0.4859423811176793,0.0019220688450114487,3.542032130883351,3.542032130883351,573.8499999999999,586.45,512.6545707569529,513.4,590.9,0,40.0,2.397121682680581,10555756.490318105
2016-08-19,574.6,573.4,577.9,566.3,25530.0,1237.6,0.1,573.4333333333334,41.0074935851478,1.2877285852355342,620.1449474828706,539.6950525171293,589.0679387470697,37.13592233009721,19.687868507164772,15247660.0,-0.017400382808425742,0.002092779909312892,3.426360686941311,3.426360686941311,573.1,586.45,516.1683879266748,513.4,590.9,0,41.0,2.397227701015062,10575775.8413024
2016-08-20,582.6,574.6,583.5,572.3,23120.0,1237.6,0.1,576.8666666666667,44.66139630246812,2.1039437166834496,613.3325903645191,542.577409635481,588.451944580682,56.55339805825253,19.081592185224434,15270780.0,-0.6649616368286406,0.01392272885485557,3.275247542949611,3.275247542949611,570.225,586.45,519.5416524096078,513.4,590.9,0,42.0,2.3973393855048517,10596291.816347148
2016-08-21,580.7,582.6,585.3,577.8,14160.0,1237.6,0.1,579.3000000000001,43.964906782596344,2.531210033913492,609.4644055543997,543.8155944456003,587.7136641444266,51.9417475728157,18.254335600565547,15256620.0,-1.7095463777928082,-0.003261242705114964,3.143505355702694,3.143505355702694,569.975,586.45,522.7799863132235,513.4,590.9,0,43.0,2.397448939987921,10616669.202981988
2016-08-22,587.5,580.7,591.9,577.1,33560.0,1237.6,0.1,583.6,47.142021071166006,3.2417372987444963,596.0377339874129,564.6522660125871,587.6933151782907,68.4466019417476,18.00759734338229,15290180.0,-0.2885268160217321,0.011710005166178705,3.0651229520650705,3.0651229520650705,570.15,586.45,525.8887868606946,513.4,590.9,0,44.0,2.3975631563770254,10637463.963361736
2016-08-23,583.6,587.5,589.9,578.6,32080.0,1237.6,0.1,583.9333333333334,45.54697704527549,3.4023224466532973,595.576148179589,566.833851820411,587.3034756375012,58.980582524271945,17.52848324742641,15258100.0,-0.2904493422176545,-0.006638297872340382,3.003509809360249,3.003509809360249,570.025,586.45,528.8732353862669,513.4,590.9,0,45.0,2.397673697128644,10657993.383313678
2016-08-24,579.7,583.6,584.5,576.8,28060.0,1237.6,0.1,583.6,43.945703311264836,3.20204180994185,595.5874065191259,567.1725934808741,586.5793351005963,51.12781954887229,16.8264487297531,15230040.0,-1.8954137755965363,-0.006682659355723097,2.9026132016134376,2.9026132016134376,571.05,576.15,531.7383059708162,513.4,590.9,0,46.0,2.39778054877328,10678254.612718193
2016-08-25,578.0,579.7,580.7,570.8,32729.999999999996,1237.6,0.1,580.4333333333334,43.232222040142815,2.919177291894428,595.5128881725086,567.5771118274915,585.7622555672061,57.36196319018415,16.3317023919136,15197310.0,-1.6672337529771954,-0.0029325513196482023,2.8255540470438754,2.8255540470438754,571.125,576.15,534.4887737319835,513.4,590.9,0,47.0,2.3978854315202396,10698387.816954393
2016-08-26,579.4,578.0,582.7,575.8,21170.0,1237.6,0.1,579.0333333333334,44.03801426426219,2.7905603846863087,594.996071128301,567.3839288716991,585.1563264655674,61.65644171779144,15.658009363919776,15218480.0,-1.3115312553227807,0.0024221453287196493,2.70245242732478,2.70245242732478,564.375,576.15,537.1292227827042,513.4,590.9,0,48.0,2.3979907833286274,10718593.591786258
2016-08-27,570.3,579.4,580.4,567.3,18690.0,1237.6,0.1,575.9,40.05780117450659,2.0889194808103007,594.0088831257601,566.3211168742398,583.7414382307514,33.742331288343536,15.47529440935408,15199790.0,-2.44611700307904,-0.015705902657922044,2.7135357547526007,2.7135357547526007,560.8499999999999,576.15,539.664053871396,570.3,590.9,0,49.0,2.3980883132379804,10738185.675304888
2016-08-28,575.0,570.3,576.3,569.2,12830.0,1237.6,0.1,574.9,42.92693585151619,1.9408221033722697,592.8208482708621,566.0891517291379,582.9089203040132,48.159509202454096,14.87705909440021,15212620.0,1.0367246529608112,0.00824127652112927,2.58731462511308,2.58731462511308,568.4499999999999,576.15,542.0974917165402,570.3,590.9,0,50.0,2.39818895038063,10758067.113521867
2016-08-29,574.2,575.0,578.6,571.4,23860.0,1237.6,0.1,573.1666666666667,42.55357299689449,1.7920179164713677,592.1704182300223,565.6295817699777,582.0794993226787,37.8947368421055,14.328697730514483,15188760.0,1.2698412698412778,-0.0013913043478259723,2.4954193191421945,2.4954193191421945,579.75,576.15,544.4335920478785,570.3,590.9,0,51.0,2.3982883324055386,10777876.829019956
2016-08-30,577.3,574.2,579.9,572.5,27480.0,1237.6,0.1,575.5000000000001,44.56561410667545,1.8953757940261795,590.3016555156861,566.138344484314,581.6243089109951,42.968749999999964,13.833790749763446,15216240.0,-0.4998276456394503,0.005398815743643093,2.3962914861880216,2.3962914861880216,579.75,576.15,546.6762483659634,570.3,590.9,0,52.0,2.39838953598718,10797870.492367418
2016-08-31,573.9,577.3,578.3,571.7,24930.0,1237.6,0.1,575.1333333333333,42.79521591886344,1.7322310180141027,588.9009175453986,566.1490824546014,580.8886604432812,29.687500000000064,13.317091410494623,15191310.0,0.27957365018347424,-0.005889485536116346,2.3204550288368395,2.3204550288368395,579.25,576.15,548.8291984313248,570.3,590.9,0,53.0,2.398487438064588,10817621.570136119
2016-09-01,572.0,573.9,705.0,569.4,25870.0,1237.6,0.1,574.4000000000001,41.795986957007166,1.5023782513453732,587.4891604148696,566.0508395851303,580.0421213534449,4.109589041095922,22.05158488117358,15165440.0,-0.2441576560864976,-0.0033106813033628724,3.8551721820233533,3.8551721820233533,634.15,588.2,550.8960304940719,570.3,590.9,0,54.0,2.3985832190141543,10837227.22105614
2016-09-02,575.3,572.0,577.6,569.3,26610.0,1237.6,0.1,573.7333333333332,44.231571559478425,1.5711910982410782,586.4146933682338,566.1953066317664,579.5904907483549,5.8097312999273765,21.069328818232613,15192050.0,0.12182387747997421,0.005769230769230749,3.662320323002367,3.662320323002367,634.15,588.2,560.1422686644275,570.3,590.9,0,55.0,2.3986809913868203,10857030.912957216
2016-09-03,598.8,575.3,605.0,572.6,35700.0,1237.6,0.1,582.0333333333333,57.7804299229593,3.10913022924721,591.3623100465509,564.217689953449,581.4199678199402,22.875816993464046,21.87866247407314,15227750.0,2.780638516992779,0.040848253085346675,3.653751248175207,3.653751248175207,634.15,588.2,568.8337325445619,570.3,590.9,0,56.0,2.3987962764840454,10878336.07275746
2016-09-04,609.5,598.8,615.2,590.8,30690.0,1237.6,0.1,594.5333333333333,62.27459301723077,4.6633155092856535,598.461296126173,561.3687038738269,584.0942565989935,30.646332607116943,22.058758011639352,15258440.0,4.959531599793345,0.017869071476285914,3.6191563595798772,3.6191563595798772,634.15,588.2,569.3,570.3,590.9,0,57.0,2.398918938133767,10900299.245094996
2016-09-05,605.8,609.5,610.6,598.8,25290.0,1237.6,0.1,604.6999999999999,59.90012996107572,5.216607601936529,602.9067917270709,559.4832082729292,586.1614702562323,27.9593318809005,21.32598958223655,15233150.0,3.114893617021269,-0.006070549630845079,3.5203020109337326,3.5203020109337326,634.625,588.2,572.6,570.3,590.9,0,58.0,2.3990381953518902,10922015.861879822
2016-09-06,610.4,605.8,612.0,603.5,24330.0,1237.6,0.1,608.5666666666667,61.84779791949223,5.631351655238278,607.8315183520887,558.3684816479114,588.4699016604006,31.299927378358753,20.409847469219653,15257480.0,4.592186429060993,0.0075932651039947174,3.3436840545903754,3.3436840545903754,634.65,588.2,580.544,570.3,590.9,0,59.0,2.3991602289311444,10944006.116987986
2016-09-07,613.2,610.4,616.5,606.2,30030.0,1237.6,0.1,609.8000000000001,63.02503677619348,5.809808128591966,612.6252791887007,557.5547208112991,590.8251491213149,33.333333333333385,19.68771550713253,15287510.0,5.778851129894773,0.004587155963302836,3.2106515830287883,3.2106515830287883,634.65,588.2,588.01136,570.3,590.9,0,60.0,2.3992836834781643,10966156.845448807
2016-09-08,625.6,613.2,629.3,611.3,36330.0,1237.6,0.1,616.4000000000001,67.76829335164601,6.430216985987873,619.863991062556,555.416008937444,594.1370396811897,42.33841684822081,19.56716439948021,15323840.0,8.235294117647063,0.02022178734507496,3.1277436699936394,3.1277436699936394,634.65,588.2,595.0306783999999,570.3,625.6,0,61.0,2.399415534183014,10989060.323559409
2016-09-09,623.2,625.6,627.6,617.3,28330.0,1237.6,0.1,620.6666666666666,66.00343583031776,6.335952988467605,625.3031923913602,554.0368076086397,596.9049406639335,40.59549745824261,18.905224085231627,15295510.0,7.559544356230595,-0.0038363171355498826,3.033572542559632,3.033572542559632,634.65,588.2,601.6288376959999,570.3,625.6,0,62.0,2.3995449890058795,11011804.091053054
2016-09-10,624.5,623.2,627.5,621.1,15280.0,1237.6,0.1,624.4333333333334,66.51216537673017,6.020371803146993,630.2927152306429,553.4272847693571,599.5330415530827,40.721649484536066,18.011993793429365,15310790.0,9.503769945642652,0.0020860077021822576,2.8842263880591457,2.8842263880591457,616.75,588.2,607.8311074342399,570.3,625.6,0,63.0,2.3996747281751527,11034615.168219293
2016-09-11,605.6,624.5,630.8,592.8,36540.0,1237.6,0.1,617.7666666666668,53.88695290042485,4.279778125094987,631.594796548523,553.9352034514772,600.1108471194559,26.75018422991898,19.439708522470124,15274250.0,5.3217391304347865,-0.030264211369095295,3.2099914997473786,3.2099914997473786,618.675,588.2,705.0,570.3,625.6,0,64.0,2.39978994483884,11056230.249369372
2016-09-12,608.0,605.6,610.6,603.0,27950.0,1237.6,0.1,612.7,55.05367105481057,3.0868207797356675,633.1183757807793,554.8516242192208,600.8621950128411,28.518791451731786,18.5940150565794,15302200.0,5.886450714036912,0.003963011889035695,3.0582261606216123,3.0582261606216123,623.2249999999999,588.2,702.756,570.3,625.6,0,65.0,2.399906309091515,11077981.667325748
2016-09-13,608.6,608.0,612.0,604.9,27520.0,1237.6,0.1,607.4000000000001,55.35776846559417,2.1777407897133854,634.4809462113234,556.3790537886765,601.5991288211419,28.960943257185008,17.773013981109447,15329720.0,5.421791096483643,0.0009868421052632304,2.9203112029427287,2.9203112029427287,623.7249999999999,588.2,700.55688,570.3,625.6,0,66.0,2.400022480718543,11099755.256532138
2016-09-14,609.5,608.6,612.2,606.4,24240.0,1237.6,0.1,608.7000000000002,55.840404259919275,1.5084268890322754,635.6558201724059,558.3541798275938,602.3515927429379,29.624170965364797,16.91779869674449,15353960.0,6.203171284195856,0.0014788038120274738,2.7756847738711223,2.7756847738711223,623.9749999999999,588.2,698.4017424,570.3,625.6,0,67.0,2.400138681659154,11121570.033860266
2016-09-15,608.1,609.5,610.7,605.1,22690.0,1237.6,0.1,608.7333333333335,54.847065822702994,0.8742616319874035,636.4962951428495,560.3837048571504,602.8990601007533,63.089430894309054,16.109384504119884,15331270.0,6.311188811188815,-0.0022969647251845915,2.6491341069100285,2.6491341069100285,623.9749999999999,588.2,696.289707552,570.3,625.6,0,68.0,2.400253210761944,11143279.741968289
2016-09-16,607.8,608.1,610.4,605.2,21850.0,1237.6,0.1,608.4666666666667,54.62283216364898,0.36357766560927907,636.2784411590391,564.351558840961,603.3658162816339,60.481099656357344,15.330142753825601,15309420.0,5.649226490526682,-0.0004933399111989312,2.522234740675486,2.522234740675486,623.9749999999999,588.2,694.21991340096,570.3,625.6,0,69.0,2.400366884325202,11164953.937319575
2016-09-17,607.1,607.8,609.6,604.5,15890.0,1237.6,0.1,607.6666666666666,54.06738311959594,-0.06929545519729352,636.0389448840326,567.8010551159673,603.7214528262402,40.75000000000017,14.599418271409489,15293530.0,1.3861055444221893,-0.0011516946363934188,2.404779817395732,2.404779817395732,623.9749999999999,588.2,692.1915151329408,570.3,625.6,0,70.0,2.400479407571398,11186566.780708125
2016-09-18,610.7,607.1,612.4,605.2,16329.999999999998,1237.6,0.1,608.5333333333334,56.51636192109667,-0.1561324283894141,635.5650864235103,571.9249135764898,604.3860763665983,47.105263157894974,14.070888394880233,15309860.0,0.19688269073011413,0.005929830340965392,2.304059013407603,2.304059013407603,623.9749999999999,588.2,690.203684830282,570.3,625.6,0,71.0,2.400593960370727,11208392.919029905
2016-09-19,609.8,610.7,612.4,607.0,21240.0,1237.6,0.1,609.1999999999999,55.71657746376237,-0.308352140257786,634.8559356303927,575.8840643696074,604.9016881412081,44.73684210526316,13.451539223817358,15288620.0,0.6602839220864972,-0.0014737186834781202,2.2058936083662446,2.2058936083662446,623.9749999999999,588.2,688.2556111336763,570.3,625.6,0,72.0,2.4007072181155493,11230145.184509043
2016-09-20,609.2,609.8,611.3,605.9,22610.0,1237.6,0.1,609.9000000000001,55.15619251078624,-0.47372478118071903,632.8608838526426,581.4091161473574,605.3110511753787,43.157894736842344,12.876429279258973,15266010.0,-0.19659239842724965,-0.0009839291571005493,2.1136620615986494,2.1136620615986494,621.925,588.2,686.3464989110028,570.3,625.6,0,73.0,2.4008194036853707,11251842.331506595
2016-09-21,597.2,609.2,608.8,591.7,36860.0,1237.6,0.1,605.4000000000001,45.33525818313105,-1.3651139690384966,629.090842577669,587.6991574223312,604.5385701110569,14.066496163682897,13.206684330740474,15229150.0,-2.609262883235486,-0.019697964543663793,2.2114340808339708,2.2114340808339708,619.0999999999999,588.2,684.4755689327827,570.3,625.6,0,74.0,2.4009220250071754,11272744.599868998
2016-09-22,595.6,597.2,599.8,592.8,22440.0,1237.6,0.1,600.6666666666667,44.20506170583537,-1.9980130944855032,624.8334756134814,593.9865243865188,603.6872777195276,9.974424552429632,12.763349735687584,15206710.0,-4.79539641943734,-0.0026791694574682667,2.142939848167828,2.142939848167828,619.575,588.2,680.7645461754714,595.6,625.6,0,75.0,2.4010228271906593,11293522.746682223
2016-09-23,602.9,595.6,603.7,594.1,25920.0,1237.6,0.1,598.5666666666667,50.2936585169632,-1.8631869546498958,624.5708383248701,594.6591616751299,603.6122988890965,28.64450127877227,12.537396183138473,15232630.0,-3.2573812580231167,0.01225654801880438,2.0795150411574843,2.0795150411574843,619.5999999999999,609.55,677.2019643284526,595.6,625.6,0,76.0,2.401128484770633,11314759.160539486
2016-09-24,602.6,602.9,605.9,600.5,13470.0,1237.6,0.1,600.3666666666667,50.05193086791447,-1.7350009659457029,624.5356608111033,594.0043391888969,603.5158894710872,27.87723785166241,12.027582170057153,15219160.0,-3.5068054443554804,-0.0004975949577044059,1.9959479206865502,1.9959479206865502,619.5999999999999,632.15,673.7818857553145,595.6,625.6,0,77.0,2.401233301336344,11335957.603879377
2016-09-25,601.5,602.6,604.9,598.3,13280.0,1237.6,0.1,602.3333333333334,49.11969696669889,-1.664796329572813,624.6281146531338,593.4818853468661,603.3238999976504,47.34299516908206,11.639897729338786,15205880.0,-0.6770145310435969,-0.0018254231662795384,1.9351450921593991,1.9351450921593991,619.5999999999999,632.15,670.4986103251019,595.6,625.6,0,78.0,2.4013366825081426,11357065.56496928
2016-09-26,606.5,601.5,608.5,598.2,27510.0,1237.6,0.1,603.5333333333334,53.37100087788774,-1.2415313677255573,624.458512749607,593.261487250393,603.6263857121598,71.49758454106282,11.544190748671726,15233390.0,-0.24671052631578946,0.00831255195344971,1.9034115001931948,1.9034115001931948,619.5999999999999,632.15,667.3466659120978,595.6,625.6,0,79.0,2.4014431600536343,11378480.674549438
2016-09-27,605.5,606.5,609.0,601.7,25550.0,1237.6,0.1,604.5,52.42749150108742,-0.9992395642812086,624.0059851586966,592.9440148413034,603.8048251681446,66.66666666666667,11.241034266623743,15207840.0,-0.5093657574761785,-0.0016488046166529546,1.856487905305325,1.856487905305325,601.05,632.15,664.3207992756139,595.6,625.6,0,80.0,2.401548280907063,11399812.417922286
2016-09-28,604.7,605.5,606.9,602.6,18940.0,1237.6,0.1,605.5666666666667,51.640971185277635,-0.8680385653399845,620.885125417463,593.9748745825372,603.8900799140356,62.801932367149966,10.745246104722042,15188900.0,-0.7875307629204192,-0.0013212221304705896,1.776954870964452,1.776954870964452,601.6,632.15,661.4159673045893,595.6,625.6,0,81.0,2.401652194577144,11421073.350119077
2016-09-29,604.7,604.7,607.2,602.0,25320.0,1237.6,0.1,604.9666666666668,51.640971185277635,-0.7603123371080511,617.8790889744919,595.1309110255081,603.967215160318,62.801932367149966,10.3491570972419,15214220.0,-0.559118566025321,0.0,1.7114531333292375,1.7114531333292375,605.575,632.15,658.6273286124058,595.6,625.6,0,82.0,2.401755495149681,11442315.429390667
2016-09-30,608.1,604.7,608.8,602.3,23950.0,1237.6,0.1,605.8333333333334,54.97066783504751,-0.4542338646762607,613.5859556383807,597.7840443616194,604.3608137164782,79.22705314009677,10.074217304581765,15238170.0,0.04935834155973482,0.005622622788159282,1.6566711568133143,1.6566711568133143,606.075,632.15,655.9502354679096,595.6,625.6,0,83.0,2.401860692330716,11463760.684139863
2016-10-01,613.4,608.1,615.0,607.1,16930.0,1237.6,0.1,608.7333333333335,59.63619607477405,0.08241166451630932,614.6610060563488,597.4889939436513,605.2216886006232,93.13304721030032,9.91891606854021,15255100.0,1.0377203096689103,0.008715671764512267,1.6170388113042402,1.6170388113042402,607.9,632.15,653.3802260491932,595.6,625.6,0,84.0,2.4019691562551975,11485531.732559381
2016-10-02,610.7,613.4,614.2,607.7,16540.0,1237.6,0.1,610.7333333333333,56.42861749471053,0.22471116926039514,614.9954197395263,597.4245802604736,605.743432543421,81.54506437768256,9.674707777930195,15238560.0,0.0,-0.004401695467883826,1.5841997343917134,1.5841997343917134,608.925,632.15,650.9130170072254,595.6,625.6,0,85.0,2.4020750305656255,11507109.592170004
2016-10-03,611.6,610.7,613.2,608.5,21950.0,1237.6,0.1,611.9000000000001,57.253945970710454,0.3416140779892487,615.4022121187052,597.3177878812949,606.301200872619,85.40772532188848,9.31937150807804,15260510.0,0.2951787471302178,0.0014737186834778981,1.52376904971845,1.52376904971845,608.925,632.15,648.5444963269364,595.6,625.6,0,86.0,2.4021809489628816,11528727.6146454
2016-10-04,609.0,611.6,612.7,606.5,24990.0,1237.6,0.1,610.4333333333334,54.06770271917246,0.21233021775408334,615.3450554937059,597.3249445062942,606.558229360941,74.24892703862656,9.09655925750104,15235520.0,-0.03282994090611383,-0.004251144538914398,1.4936878912152776,1.4936878912152776,608.925,632.15,646.2707164738589,595.6,625.6,0,87.0,2.402284351339532,11550157.362992426
2016-10-05,611.8,609.0,613.7,608.0,23400.0,1237.6,0.1,610.8000000000001,56.852529652179555,0.27964997484656084,615.8148587939602,597.22514120604,607.0574456122799,85.5855855855854,8.853947881965254,15258920.0,2.444742129939703,0.0045977011494251485,1.4471964501414276,1.4471964501414276,609.8,632.15,644.0878878149045,595.6,625.6,0,88.0,2.4023891917189837,11571751.210788464
2016-10-06,611.0,611.8,612.7,608.5,21630.0,1237.6,0.1,610.6,55.811365207985475,0.2362870889240618,616.1656944922162,597.194305507784,607.4329269825389,80.86124401913874,8.521523033253454,15237290.0,2.585627938213562,-0.0013076168682575329,1.3946846208270791,1.3946846208270791,609.875,634.2,641.9923723023084,595.6,625.6,0,89.0,2.4024928371585945,11593274.033827005
2016-10-07,616.0,611.0,619.4,609.1,32729.999999999996,1237.6,0.1,612.9333333333334,60.66048822301619,0.49542752484356045,617.446022236177,596.8039777638232,608.2488386984876,83.96226415094345,8.648557102306775,15270020.0,2.1728313153093417,0.008183306055646433,1.4039865425822686,1.4039865425822686,608.125,635.65,639.980677410216,595.6,625.6,0,90.0,2.4025995083726404,11615104.186836597
2016-10-08,617.7,616.0,619.6,614.9,13620.0,1237.6,0.1,614.9000000000001,62.18011326497194,0.7188591424281388,618.6929989302753,596.2570010697248,609.1489492986316,91.1214953271029,8.366517309284864,15283640.0,2.5058081646199835,0.002759740259740351,1.3544628961121683,1.3544628961121683,608.3000000000001,635.65,638.0494503138074,595.6,625.6,0,91.0,2.4027067955397152,11637026.536556702
2016-10-09,615.8,617.7,618.3,613.0,13430.0,1237.6,0.1,616.5,59.41755397141559,0.6768144947387169,619.5335500806715,596.0164499193287,609.7823826987619,82.24299065420527,8.147480358621657,15270210.0,2.3773898586866093,-0.0030759268253198746,1.3230724843490838,1.3230724843490838,609.35,635.65,636.1954723012551,595.6,625.6,0,92.0,2.4028120969838227,11658806.985775294
2016-10-10,617.3,615.8,618.8,612.8,25230.0,1237.6,0.1,616.9333333333334,60.894682405534965,0.686015976853874,620.6438035927905,595.7161964072096,610.4983462512607,87.15083798882642,7.994088904434396,15295440.0,1.7807089859851533,0.002435855797336739,1.2950087322913326,1.2950087322913326,609.35,636.15,634.4156534092049,595.6,625.6,0,93.0,2.4029178721397613,11680666.638685415
2016-10-11,640.5,617.3,642.3,615.6,55770.0,1237.6,0.1,624.5333333333333,75.65448213493359,2.110134919096032,628.2726852939708,592.4173147060293,613.3556466082836,95.53349875930532,9.330225411260505,15351210.0,5.780346820809249,0.037583022841406244,1.4567096660828267,1.4567096660828267,620.7,636.15,591.7,595.6,640.5,1,94.0,2.4030394624660354,11703993.876411414
2016-10-12,636.0,640.5,642.5,632.2,26950.0,1237.6,0.1,631.2666666666668,70.12568120898547,2.573883333575945,632.1951058998598,592.5348941001403,615.5122516932089,83.95061728395062,9.399495024741896,15324260.0,5.1761203902761626,-0.007025761124121788,1.4779080227581598,1.4779080227581598,620.8,636.15,592.712,595.6,640.5,0,95.0,2.4031572846782954,11727021.87177479
2016-10-13,635.6,636.0,639.5,632.3,25620.0,1237.6,0.1,637.3666666666667,69.63851411405996,2.6671656694205774,635.7392732169144,592.2607267830856,617.42537057957,82.83582089552246,9.242388237260334,15298640.0,5.109971886886055,-0.0006289308176100628,1.4541202387130796,1.4541202387130796,621.175,636.15,594.70352,595.6,640.5,0,96.0,2.403274201916418,11750008.73630795
2016-10-14,637.9,635.6,640.5,630.7,31420.0,1237.6,0.1,636.5,70.89074516858943,2.689585712345348,639.1826237052279,592.3473762947723,619.3753352862776,87.22222222222216,9.282217648884593,15330060.0,4.900509784574898,0.003618628067967311,1.455121123825771,1.455121123825771,621.3,636.15,596.6153792,595.6,640.5,0,97.0,2.4033921016505717,11773125.863813085
2016-10-15,637.0,637.9,641.4,635.1,12380.0,1237.6,0.1,636.8333333333334,69.67968153900318,2.456068713099034,641.7323458969908,593.3476541030092,621.0538747828226,84.72222222222223,9.06920210253569,15317680.0,3.8474078904466946,-0.001410879448189295,1.423736593804661,1.423736593804661,621.45,636.15,598.450764032,595.6,640.5,0,98.0,2.403508749611327,11796170.05847611
2016-10-16,640.1,637.0,642.2,636.4,12890.0,1237.6,0.1,638.3333333333334,71.48656768022042,2.3240494589752227,644.7424293514479,593.6975706485522,622.8677914701728,93.3333333333334,8.835687666640288,15330570.0,4.814147699361385,0.004866562009419262,1.380360516581829,1.380360516581829,622.375,636.15,600.2127334707201,595.6,640.5,0,99.0,2.4036269319284425,11819395.35486855
2016-10-17,637.4,640.1,641.3,634.9,27690.0,1237.6,0.1,638.1666666666666,67.70225579737905,1.8871282636425564,646.6930428162497,594.9369571837505,624.2518113301563,85.83333333333327,8.66170997616598,15302880.0,4.218443427076513,-0.004218090923293283,1.358912766891431,1.358912766891431,622.65,636.15,601.9042241318913,595.6,640.5,0,100.0,2.403742613595114,11842433.118016494
2016-10-18,635.3,637.4,639.3,632.2,24600.0,1237.6,0.1,637.6,64.82774715060464,1.3159940207804341,647.84664504497,596.84335495503,625.3040197749034,79.13043478260856,8.550159263582689,15278280.0,4.318555008210173,-0.003294634452463141,1.3458459410644874,1.3458459410644874,622.9749999999999,637.1,603.5280551666157,595.6,640.5,0,101.0,2.403856210603068,11865320.213585405
2016-10-19,629.1,635.3,637.3,624.1,35290.0,1237.6,0.1,633.9333333333334,57.117211415716724,0.4260256024074103,647.8803675686723,599.2496324313275,625.665541701103,60.588235294117716,8.882290744755348,15242990.0,2.8277214776070725,-0.009759168896584236,1.4119044261254725,1.4119044261254725,624.7,637.15,605.086932959951,595.6,640.5,0,102.0,2.403964840122457,11887790.496689236
2016-10-20,628.3,629.1,630.8,625.5,20940.0,1237.6,0.1,630.9,56.188556250304195,-0.2734838991459787,647.8946805295366,601.2553194704635,625.9164424914742,57.485029940119595,8.626412834415678,15222050.0,2.8314238952536748,-0.00127165792401851,1.3729767363386407,1.3729767363386407,626.825,637.15,606.583455641553,628.3,640.5,0,103.0,2.4040722956124756,11910190.828224381
2016-10-21,630.5,628.3,633.3,627.6,28090.0,1237.6,0.1,629.3000000000001,58.20120780262455,-0.6248716809037598,648.2976277737688,602.5623722262311,626.3529717780004,59.595959595959656,8.417383346243124,15250140.0,2.353896103896104,0.003501512016552688,1.3350330446063639,1.3350330446063639,626.75,637.15,608.0201174158908,628.3,640.5,0,104.0,2.404180692606871,11932715.910645928
2016-10-22,655.5,630.5,659.9,629.7,37100.0,1237.6,0.1,638.1,73.24346277812514,0.7168237592302873,652.974236799391,602.3657632006092,629.1288792277147,90.6581740976646,9.97328453579718,15287240.0,6.119475473530833,0.03965107057890571,1.5214774272764577,1.5214774272764577,636.4,637.15,609.3993127192551,628.3,640.5,0,105.0,2.4043057086644724,11956816.340147825
2016-10-23,653.0,655.5,661.2,648.8,21910.0,1237.6,0.1,646.3333333333334,70.51077881440843,1.292757529023623,656.1944438610915,603.2855561389085,631.4023193012656,83.05785123966936,10.146621354668818,15265330.0,6.040922377395265,-0.0038138825324179892,1.5538470680962968,1.5538470680962968,637.125,615.25,612.4293539560998,628.3,640.5,0,106.0,2.4044284024838913,11980746.013427218
2016-10-24,650.5,653.0,654.3,645.7,33240.0,1237.6,0.1,653.0,67.78712179532162,1.3555888633115085,657.9450803672632,605.6849196327366,633.2211460344785,76.53508771929816,10.036148400763896,15232090.0,5.378260165235712,-0.003828483920367498,1.5428360339375704,1.5428360339375704,637.125,616.9000000000001,616.3310056396118,628.3,640.5,0,107.0,2.404548771844008,12004503.472470744
2016-10-25,651.0,650.5,662.5,647.7,36740.0,1237.6,0.1,651.5,68.05291436185935,1.2818871393296138,659.4831212849099,608.0668787150901,634.914370221671,70.05208333333331,10.376423514995043,15268830.0,1.639344262295082,0.000768639508070823,1.5939206628256593,1.5939206628256593,637.8499999999999,626.65,619.9205251884429,628.3,640.5,0,108.0,2.404668858144739,12028277.452380981
2016-10-26,674.7,651.0,678.4,651.4,47670.0,1237.6,0.1,658.7333333333333,77.52086401464945,2.6041208261465165,666.1415284041057,607.7784715958942,638.7034778196071,93.18600368324137,11.592393263923967,15316500.0,6.084905660377365,0.036405529953917215,1.7181552191972678,1.7181552191972678,646.85,635.05,624.1784726695986,628.3,640.5,0,109.0,2.404804136736747,12053511.093396628
2016-10-27,682.3,674.7,687.9,672.3,46560.0,1237.6,0.1,669.3333333333334,79.60792893949927,3.698586404352035,673.9036113302292,606.6463886697708,642.855527551073,91.22257053291531,11.878650887929398,15363060.0,7.347388294524848,0.011264265599525647,1.7409718434602663,1.7409718434602663,651.6,639.8,630.6850559492467,628.3,640.5,0,110.0,2.4049437252517785,12079196.41116855
2016-10-28,686.2,682.3,688.4,678.6,38970.0,1237.6,0.1,681.0666666666667,80.60315804864457,4.348362467865474,681.168066403267,606.2319335967331,646.983572546209,96.57853810264395,11.730175824505865,15402030.0,7.5717197052829714,0.005715960721090596,1.7094397878906826,1.7094397878906826,652.2,640.05,638.6951481163521,628.3,640.5,0,111.0,2.405085185303175,12105107.719340978
2016-10-29,715.0,686.2,720.2,685.2,54030.0,1237.6,0.1,694.5,86.02661253585555,6.264502455096194,695.2057366468681,602.1142633531318,653.4613275418081,94.5889698231009,13.392306122755446,15456060.0,12.244897959183673,0.04197027105800055,1.8730498073783841,1.8730498073783841,668.625,655.95,646.6479244177358,628.3,640.5,0,112.0,2.405244155096267,12132714.517373132
2016-10-30,697.3,715.0,714.9,689.5,39330.0,1237.6,0.1,699.5,72.59267733784405,5.8921281559698855,701.4348459761751,603.8851540238251,657.6364392044931,76.17065556711749,14.257141399701485,15416730.0,8.936103733791583,-0.02475524475524482,2.0446208804964128,2.0446208804964128,669.5250000000001,655.95,659.8872980225434,628.3,640.5,0,113.0,2.4053913868406696,12159275.751516888
2016-10-31,698.7,697.3,707.2,682.2,38050.0,1237.6,0.1,703.6666666666666,72.95245789107797,5.310365941118832,707.910007642334,603.2299923576659,661.5472545183509,77.62747138397502,15.024488442579951,15454780.0,9.617194854094771,0.0020077441560304443,2.1503489970774226,2.1503489970774226,673.6500000000001,655.95,670.7435843784856,628.3,640.5,0,114.0,2.405538848027528,12185912.781036232
2016-11-01,726.8,698.7,734.4,695.2,68070.0,1237.6,0.1,707.6,78.93081417666569,6.319688599603737,720.069783188397,600.1502168116031,667.7618017070794,93.10970081595646,16.75131069668138,15522850.0,14.402644419959076,0.040217546872763466,2.304803342966618,2.304803342966618,680.9,663.05,679.6457391903582,628.3,640.5,1,115.0,2.4057030458963182,12214186.361413978
2016-11-02,733.5,726.8,735.8,718.1,39040.0,1237.6,0.1,719.6666666666666,80.06238159414323,6.893260216316765,731.761287344336,598.2487126556638,674.0225824968813,97.91477787851319,16.81907421834699,15561890.0,16.595135908440625,0.00921849201981284,2.292988986823039,2.292988986823039,683.025,663.75,682.2,628.3,733.5,0,116.0,2.4058706125213765,12242840.963397194
2016-11-03,684.9,733.5,744.4,670.4,96410.0,1237.6,0.1,715.0666666666666,56.40001994039824,3.6188160065044848,733.434784351945,601.275215648055,675.0585270209879,49.05821917808217,20.903426059893636,15465480.0,9.008435460767155,-0.0662576687116565,3.052040598612007,3.052040598612007,688.25,668.05,735.8,628.3,733.5,1,117.0,2.406007285790574,12268624.62200161
2016-11-04,702.1,684.9,706.6,681.3,48240.0,1237.6,0.1,706.8333333333334,60.81406404578809,2.2951160668341544,736.8015070080713,604.4184929919287,677.6339053999415,63.12118570183088,21.217467055615522,15513720.0,11.356066613798577,0.02511315520513957,3.022000720070577,3.022000720070577,693.0,668.05,735.8,628.3,733.5,0,118.0,2.406154245083908,12295437.496879192
2016-11-05,702.1,702.1,706.4,694.0,22020.0,1237.6,0.1,696.3666666666668,60.81406404578809,1.1606005302055884,739.7026329221644,607.7173670778354,679.9640096475661,57.14285714285717,20.58764798021441,15535740.0,7.109077040427159,0.0,2.9322956815573864,2.9322956815573864,693.7,668.05,744.4,628.3,733.5,0,119.0,2.4063005513686697,12322242.652959654
2016-11-06,709.9,702.1,714.1,697.6,25810.0,1237.6,0.1,704.7000000000002,62.79507264661211,0.6992678258249043,742.9149138456246,611.7550861543755,682.8150563477978,65.04559270516714,20.295673124484807,15561550.0,8.713629402756505,0.01110952855718561,2.8589481792484586,2.8589481792484586,695.825,668.05,742.92,628.3,733.5,0,120.0,2.406451068570708,12349504.832605127
2016-11-07,705.4,709.9,711.7,698.3,30740.0,1237.6,0.1,705.8000000000001,60.88278490546063,-0.10249413612136848,744.5245789810966,617.1554210189034,684.9660033622932,59.669079627714545,19.803125044164467,15530810.0,8.439661798616445,-0.006338920974785167,2.807361077993262,2.807361077993262,695.825,668.05,741.4696,628.3,733.5,0,121.0,2.406598131447223,12376492.304954646
2016-11-08,710.9,705.4,714.6,701.0,39730.0,1237.6,0.1,708.7333333333332,62.39030244534311,-0.4371906315598082,745.2137324657285,624.6462675342716,687.4359078039796,63.97849462365591,19.36004468386701,15570540.0,9.20122887864823,0.007796994612985442,2.723314767740471,2.723314767740471,695.825,668.05,740.048208,628.3,733.5,0,122.0,2.406747957890948,12403800.14430022
2016-11-09,721.4,710.9,741.2,707.1,70700.0,1237.6,0.1,712.5666666666666,65.15145492072625,-0.14150943283002348,745.9061603218497,633.2638396781501,690.6705832512196,68.91891891891892,20.412898635019367,15641240.0,6.921594782866449,0.014770009846673204,2.8296227661518394,2.8296227661518394,695.825,668.05,670.4,628.3,733.5,0,123.0,2.4069035740151694,12431721.571417553
2016-11-10,714.6,721.4,723.0,707.3,33330.0,1237.6,0.1,715.6333333333333,61.97799951374825,-0.5699428602920129,744.072080306999,643.5079196930011,692.9495753225319,59.72972972972979,20.076263018232275,15607910.0,4.7339879818261865,-0.009426115885777575,2.8094406686583087,2.8094406686583087,695.825,668.05,671.816,628.3,733.5,0,124.0,2.407054367035488,12459236.526098663
2016-11-11,715.0,714.6,719.8,711.7,25580.0,1237.6,0.1,717.0,62.094960493367005,-0.968991924245973,744.6151107626669,648.9148892373331,695.0496157680051,60.270270270270295,19.220815659787103,15633490.0,4.197027105800051,0.0005597537083683601,2.688225966403791,2.688225966403791,695.825,668.05,673.2036800000001,628.3,733.5,0,125.0,2.407204750515976,12486768.76399686
2016-11-12,704.3,715.0,717.4,701.1,27600.0,1237.6,0.1,711.3000000000001,57.04025387575773,-2.03487216686689,742.8224867074703,655.8375132925296,695.9306047424808,45.81081081081078,19.01218596980231,15605890.0,-1.496503496503503,-0.014965034965034985,2.6994442666196665,2.6994442666196665,697.75,668.5999999999999,674.5636064,628.3,733.5,0,126.0,2.4073478608579566,12513652.902096665
2016-11-13,702.0,704.3,705.6,685.0,36140.0,1237.6,0.1,707.1,55.985278833125456,-2.9221278086587645,739.1826863552376,664.6273136447624,696.5086423860541,42.70270270270273,19.125601257673573,15569750.0,0.6740283952387847,-0.0032656538406927726,2.724444623600224,2.724444623600224,698.675,669.25,675.896334272,702.0,733.5,0,127.0,2.407488891628014,12540388.826190246
2016-11-14,704.6,702.0,708.0,696.1,37750.0,1237.6,0.1,703.6333333333333,56.95449082858546,-3.331546931253282,733.6381426871425,675.5318573128574,697.2792478730966,46.216216216216274,18.60948688212546,15607500.0,0.8444253613854268,0.0037037037037037646,2.6411420496913793,2.6411420496913793,699.0250000000001,671.3,677.20240758656,702.0,733.5,0,128.0,2.4076309026250944,12567273.160769561
2016-11-15,711.1,704.6,716.9,697.9,41400.0,1237.6,0.1,705.9,59.36362232568565,-3.1635227956591265,732.1091222374828,680.7008777625172,698.5955099804207,55.000000000000064,18.637380676259358,15648900.0,-2.160154100165098,0.009225092250922495,2.620922609514746,2.620922609514746,699.55,671.3,678.4823594348287,702.0,733.5,0,129.0,2.4077762973114782,12594541.117169337
2016-11-16,740.3,711.1,746.0,708.1,79570.0,1237.6,0.1,718.6666666666666,68.02202521314057,-1.1865052385747887,736.5194428566789,682.090557143321,702.5673661727617,92.46031746031741,20.013282056526545,15728470.0,0.9270620313565037,0.04106314161158764,2.7034016015840265,2.7034016015840265,701.675,672.1,679.7367122461321,702.0,733.5,0,130.0,2.407938680365153,12623525.346217029
2016-11-17,737.5,740.3,751.9,730.1,62770.0,1237.6,0.1,729.6333333333333,66.55755670730298,-0.2187451348569951,739.5563215324722,684.1836784675278,705.8942836801177,79.6033994334278,20.140904766774646,15665700.0,7.679953277850784,-0.0037822504390111478,2.730970137867749,2.730970137867749,708.625,676.8,682.3872437562868,702.0,733.5,0,131.0,2.4080987359161603,12652344.220179984
2016-11-18,747.0,737.5,751.4,731.0,39710.0,1237.6,0.1,741.6,68.99644667371076,0.851156195239259,745.1110556081719,681.8289443918281,709.8091138058207,92.67563527653216,20.159411569147885,15705410.0,6.395100413046571,0.012881355932203409,2.6987164081857946,2.6987164081857946,708.625,676.95,686.5580091309096,702.0,733.5,0,132.0,2.408263730966824,12681710.251836738
2016-11-19,747.9,747.0,755.3,737.4,25630.0,1237.6,0.1,744.1333333333333,69.22542263585206,1.3782198056014892,750.0638224513839,681.9361775486159,713.4368172528854,89.47368421052634,19.99802502849446,15731040.0,6.523287281014094,0.00120481927710836,2.6738902297759677,2.6738902297759677,710.825,678.65,690.478528583055,702.0,733.5,0,133.0,2.40842858277546,12711126.43861933
2016-11-20,728.5,747.9,752.3,712.8,47420.0,1237.6,0.1,741.1333333333333,59.09409398530741,0.23877388714118908,750.9990375868871,683.9809624131129,714.8714060859439,61.877667140825075,21.391023240744858,15683620.0,2.620087336244545,-0.025939296697419456,2.936310671344524,2.936310671344524,711.75,678.8,695.6642462964106,702.0,733.5,0,134.0,2.408581268440038,12739405.969548494
2016-11-21,736.2,728.5,744.3,726.5,32509.999999999996,1237.6,0.1,737.5333333333333,61.502381482821924,-0.15656180496852556,752.2331615115882,683.6868384884119,716.9027007444255,72.83072546230453,21.13452158069165,15716130.0,4.366316983271912,0.010569663692518994,2.870758160919811,2.870758160919811,716.5,680.9,700.4351065926978,702.0,733.5,0,135.0,2.4087378981808114,12768134.591601472
2016-11-22,749.3,736.2,754.0,730.6,44440.0,1237.6,0.1,738.0,65.25067772546291,0.28019274786739246,755.0858500657326,682.4141499342674,719.988157816385,91.4651493598862,21.296341467785105,15760570.0,5.4016036010690645,0.017794077696278165,2.842164882928748,2.842164882928748,719.275,680.9,704.8242980652819,702.0,749.3,0,136.0,2.4089015786498345,12797623.218494147
2016-11-23,741.1,749.3,750.9,731.3,37870.0,1237.6,0.1,742.2000000000002,61.23180419937513,-0.14436490465999086,755.6106916229229,687.509308377077,721.9988094529197,79.8008534850641,21.17517422008617,15722700.0,2.7308012198502976,-0.010943547310823365,2.8572627472792025,2.8572627472792025,719.7249999999999,680.9,708.8623542200594,702.0,749.3,0,137.0,2.409059785244557,12826631.887592627
2016-11-24,735.3,741.1,744.2,726.2,37240.0,1237.6,0.1,741.9,58.48780814120223,-0.9330289174427406,756.5433611749984,689.8966388250017,723.2655895050226,71.55049786628732,20.948376061508586,15685460.0,2.8967254408060357,-0.007826204290918959,2.8489563527143464,2.8489563527143464,722.275,680.9,712.5773658824546,702.0,749.3,0,138.0,2.4092139018056518,12855294.81467224
2016-11-25,740.4,735.3,741.3,729.0,28850.0,1237.6,0.1,738.9333333333334,60.17770268381573,-1.2108255749178518,757.7784848017085,692.4915151982915,724.8974381235919,78.80512091038409,20.330634914257967,15714310.0,3.552447552447549,0.006935944512443948,2.7458988268851927,2.7458988268851927,723.4499999999999,681.65,715.9951766118583,702.0,749.3,0,139.0,2.409370382069172,12884253.785588318
2016-11-26,734.1,740.4,741.0,725.6,22580.0,1237.6,0.1,736.6,57.086196609187354,-1.8786195625207185,758.4291689934362,694.2608310065639,725.7738725880117,69.84352773826465,19.978446706096683,15691730.0,4.231151497941228,-0.008508914100486153,2.7214884492707645,2.7214884492707645,723.4499999999999,681.9,719.1395624829096,702.0,749.3,0,140.0,2.4095224781140563,12912835.151194772
2016-11-27,729.4,734.1,738.3,727.1,21350.0,1237.6,0.1,734.6333333333333,54.82341531996244,-2.6494594407395144,758.1678982952195,696.9221017047804,726.1192180558202,56.249999999999986,19.35141479851834,15670380.0,3.9031339031339,-0.006402397493529555,2.6530593362377766,2.6530593362377766,723.4499999999999,682.2,722.0323974842768,702.0,749.3,0,141.0,2.4096711232789563,12941129.667502748
2016-11-28,733.3,729.4,738.1,727.7,34120.0,1237.6,0.1,732.2666666666668,56.368880617459716,-2.889607223869186,758.3964160443016,698.9335839556983,726.803102050504,61.672473867595805,18.7120280271956,15704500.0,4.073233040022698,0.005346860433232736,2.551756174443693,2.551756174443693,723.125,684.05,724.6938056855346,702.0,749.3,0,142.0,2.409821448189208,12969650.939176338
2016-11-29,732.6,733.3,737.0,727.8,32570.0,1237.6,0.1,731.7666666666668,55.998591386873265,-3.071513793584799,758.8095145303985,699.6404854696016,727.3551875695036,51.906779661017026,18.03259745382449,15671930.0,3.023484741949093,-0.0009545888449473683,2.4614520138990565,2.4614520138990565,729.05,684.05,727.1,702.0,749.3,0,143.0,2.409970710384737,12998123.874308262
2016-11-30,742.5,732.6,745.4,730.6,39280.0,1237.6,0.1,736.1333333333333,60.0005913426751,-2.523912218375324,759.9445017007852,701.2954982992148,728.7975506581223,69.88235294117658,17.801697635694165,15711210.0,0.29717682020802993,0.013513513513513375,2.3975350351103253,2.3975350351103253,729.9749999999999,684.05,727.7,702.0,749.3,0,144.0,2.410125174088264,13027180.515405184
2016-12-01,752.6,742.5,755.5,741.1,54030.0,1237.6,0.1,742.5666666666667,63.63447656162476,-1.5292592110451295,762.3934106451462,702.6065893548538,731.064450595444,93.208430913349,17.55871923314458,15765240.0,2.047457627118647,0.013602693602693616,2.333074572567709,2.333074572567709,730.4,685.55,727.8,702.0,749.3,0,145.0,2.4102848687628358,13056827.569048136
2016-12-02,770.9,752.6,779.0,752.3,63220.0,1237.6,0.1,755.3333333333334,69.1102602445205,0.22024595326653262,767.2166914471616,704.4433085528385,734.858312443497,87.76435045317217,18.21166785934854,15828460.0,3.1994645247657263,0.024315705554079026,2.362390434472505,2.362390434472505,742.15,701.55,730.5699999999999,702.0,749.3,0,146.0,2.4104543607126643,13087532.221129084
2016-12-03,764.2,770.9,772.3,755.8,38450.0,1237.6,0.1,762.5666666666667,65.23715035830297,0.7552222935040191,768.5797300932265,709.3002699067736,737.6527588774496,77.64350453172214,18.089405869395073,15790010.0,2.179435753442983,-0.008691140225710159,2.367103620700742,2.367103620700742,742.15,701.55,736.3815999999999,702.0,749.3,0,147.0,2.4106193860748877,13117850.829181546
2016-12-04,766.4,764.2,769.2,758.8,19160.0,1237.6,0.1,767.1666666666666,65.91267740599037,1.067167055988067,769.5124380286629,714.547561971337,740.3905913653116,76.40449438202242,17.54016259300972,15809170.0,5.2024708304735725,0.0028788275320594803,2.2886433445993895,2.2886433445993895,742.15,701.55,741.4958079999999,702.0,749.3,0,148.0,2.4107849978988107,13148295.496264445
2016-12-05,754.3,766.4,769.2,746.0,51170.0,1237.6,0.1,761.6333333333333,59.1092157324501,0.30794240428330255,768.177488405402,720.2025115945979,741.7152969495676,53.74531835205982,17.944436693509026,15758000.0,2.4585710404781183,-0.015788100208768308,2.3789522329986776,2.3789522329986776,742.525,701.55,745.9963110399999,754.3,749.3,0,149.0,2.4109430298079357,13178032.20267096
2016-12-06,758.2,754.3,762.5,750.9,33430.0,1237.6,0.1,759.6333333333333,60.523584384387284,-0.0624899153803824,769.7512745464185,720.4187254535816,743.2852686686564,61.04868913857685,17.491262643972668,15791430.0,1.1877752569064581,0.0051703566220338,2.306945745709927,2.306945745709927,742.675,701.55,746.0,754.3,749.3,0,150.0,2.411102648519782,13207994.64080641
2016-12-07,765.6,758.2,769.0,754.3,34870.0,1237.6,0.1,759.3666666666668,63.12954291035509,0.053688191346758174,772.4360131812055,720.5439868187946,745.4104811764034,74.90636704119854,17.291886740831767,15826300.0,3.3058966401295375,0.009759957794777119,2.2586058961379005,2.2586058961379005,742.7,701.55,746.0,754.3,749.3,0,151.0,2.4112658295902665,13238386.910989655
2016-12-08,768.5,765.6,773.4,761.2,28780.0,1237.6,0.1,764.1,64.12891062366155,0.18147218436753754,775.2310279042599,719.8989720957402,747.6094829691269,80.33707865168539,16.928180545058066,15855080.0,4.515163878688977,0.0037878787878786735,2.2027560891422335,2.2027560891422335,743.4,701.55,749.96,754.3,749.3,0,152.0,2.4114299923874234,13268946.13725175
2016-12-09,770.5,768.5,773.5,765.0,24180.0,1237.6,0.1,768.2000000000002,64.83677838218796,0.2519823647546353,778.1140737447541,719.275926255246,749.7895322101625,84.08239700374531,16.326167648982487,15879260.0,4.06537007023231,0.002602472348731233,2.118905600127513,2.118905600127513,748.8,701.55,753.4448,754.3,749.3,0,153.0,2.41159462273347,13299620.130250918
2016-12-10,774.0,770.5,777.0,769.2,18020.0,1237.6,0.1,771.0,66.09761985921685,0.3780503457389113,780.8243196204381,721.1156803795619,752.0952910472898,90.3660886319846,15.717155674055164,15897280.0,5.435226808336735,0.00454250486696961,2.0306402679657833,2.0306402679657833,750.475,702.25,756.511424,754.3,749.3,0,154.0,2.4117605582971664,13330495.99050581
2016-12-11,767.9,774.0,774.2,763.0,17140.0,1237.6,0.1,770.8000000000001,61.9297187055569,-0.08117903793578485,782.4703121327402,722.6396878672599,753.6005014237384,78.36257309941514,15.39450169733694,15880140.0,5.278310940499041,-0.007881136950904422,2.0047534441121164,2.0047534441121164,752.525,703.3,759.21005312,754.3,749.3,0,155.0,2.4119224026377966,13361015.479346437
2016-12-12,778.5,767.9,781.3,767.9,28760.0,1237.6,0.1,773.4666666666667,65.94795524654546,0.18275210165170108,785.9353555744492,722.094644425551,755.9718822405251,94.766355140187,15.2520372903843,15908900.0,6.163916541660991,0.013803880713634697,1.959157005829711,1.959157005829711,755.3499999999999,705.5,761.5848467456,754.3,749.3,0,156.0,2.412089531335199,13392149.797591547
2016-12-13,778.7,778.5,790.3,767.8,33110.0,1237.6,0.1,775.0333333333334,66.0208289776979,0.2219903080992811,788.959813624142,722.8301863758579,758.1364648842847,80.56951423785607,15.769748912499706,15942010.0,6.292656292656296,0.00025690430314706525,2.025137910941275,2.025137910941275,759.8499999999999,718.0,763.0,754.3,778.7,0,157.0,2.412256109179508,13423295.303113446
2016-12-14,776.5,778.7,780.8,771.0,24780.0,1237.6,0.1,777.9000000000001,64.38847875191524,-0.03532994851831184,790.7633815510494,725.1466184489504,759.8853729905433,71.95121951219518,15.343338275892581,15917230.0,4.57912457912458,-0.0028252215230513134,1.97596114306408,1.97596114306408,761.0749999999999,718.0,767.3679999999999,754.3,778.7,0,158.0,2.412420801281835,13454312.383024618
2016-12-15,775.2,776.5,780.3,773.1,26220.0,1237.6,0.1,776.8000000000001,63.39108665676018,-0.4075217299044098,792.2852117206875,727.1047882793124,761.3439088962058,65.9142212189618,14.761671256185963,15891010.0,3.00292319957481,-0.0016741790083708574,1.9042403581251242,1.9042403581251242,761.925,719.0,767.8,754.3,778.7,0,159.0,2.4125841102520527,13485252.374962147
2016-12-16,782.0,775.2,783.9,773.3,27610.0,1237.6,0.1,777.9000000000001,66.32915576435302,-0.3143499480075036,793.8336544839945,730.3463455160054,763.3111556679958,81.26410835214455,14.464409023601252,15918620.0,1.4398754702296048,0.00877192982456143,1.8496686730947893,1.8496686730947893,766.85,720.8499999999999,771.0,754.3,778.7,0,160.0,2.412750541007274,13516586.881398242
2016-12-17,787.2,782.0,791.6,779.4,23580.0,1237.6,0.1,781.4666666666667,68.41659225106308,-0.0357733139915819,794.7562724329157,735.2037275670843,765.5862836996151,90.35087719298251,14.302665521915452,15942200.0,3.009683328971473,0.006649616368286537,1.8169036486173085,1.8169036486173085,767.95,731.0,773.1,754.3,778.7,0,161.0,2.412919177777701,13548222.098486623
2016-12-18,789.0,787.2,791.3,783.8,14530.0,1237.6,0.1,786.0666666666667,69.1300191334112,0.12750951960118861,795.518722272863,740.0112777271372,767.8161614425089,94.29824561403504,13.816760841778635,15956730.0,2.9488517745302745,0.0022865853658535773,1.7511737442051503,1.7511737442051503,767.95,731.0,773.3,754.3,778.7,0,162.0,2.4130881397724337,13579961.625704428
2016-12-19,789.8,789.0,793.7,786.3,25460.0,1237.6,0.1,788.6666666666666,69.46020521493016,0.1458605929464376,794.8601707235414,746.3898292764586,769.9098603527461,90.88785046728952,13.358420781651597,15982190.0,4.706350258517832,0.0010139416983523386,1.691367533761914,1.691367533761914,769.0,732.05,776.5939999999999,754.3,778.7,0,163.0,2.4132568777431724,13611747.836233752
2016-12-20,799.1,789.8,800.0,787.1,34480.0,1237.6,0.1,792.6333333333333,73.06673154249262,0.614526949829111,797.1038879230966,749.8061120769034,772.6898736524846,98.03063457330421,13.325676440105054,16016670.0,5.3943550514376115,0.011775132945049505,1.6675855888005322,1.6675855888005322,773.3499999999999,735.2,780.0151999999999,754.3,778.7,0,164.0,2.4134300093407615,13644069.691781744
2016-12-21,829.2,799.1,833.1,796.0,65290.00000000001,1237.6,0.1,806.0333333333334,80.92024531095832,2.666880713696864,809.458111444173,745.1118885558271,778.071790447486,94.5757997218359,15.023842408668981,16081960.0,8.307210031347966,0.03766737579777257,1.8118478543980923,1.8118478543980923,789.9000000000001,751.75,784.01216,754.3,778.7,1,165.0,2.413618433394329,13678087.767145174
2016-12-22,860.2,829.2,874.7,828.9,70560.0,1237.6,0.1,829.5,85.58289585182429,5.6556288243183275,829.9391066528439,733.5608933471561,785.8935246905826,87.01880035810206,17.222139379478346,16152520.0,11.932335718932991,0.03738543174143749,2.0021087397673036,2.0021087397673036,811.875,772.55,787.1,754.3,778.7,1,166.0,2.413822006579538,13713799.37270419
2016-12-23,917.2,860.2,920.3,858.0,102220.0,1237.6,0.1,868.8666666666668,90.28433235865361,10.720984593033688,864.8707890511232,713.9292109488767,798.3989032914794,98.02924348378899,20.44198656665846,16254740.0,19.03958468526931,0.06626365961404335,2.2287381777865742,2.2287381777865742,835.35,795.3499999999999,796.0,754.3,778.7,1,167.0,2.414052543509866,13752478.800427461
2016-12-24,891.1,917.2,920.5,880.8,46030.0,1237.6,0.1,889.5,77.77726368305191,11.494700335999283,882.2555350941631,709.0144649058369,807.2275791684814,81.33333333333334,21.817558954754286,16208710.0,15.129198966408271,-0.028456170955080684,2.448385024661013,2.448385024661013,835.525,795.45,820.86,754.3,778.7,0,168.0,2.414269897786631,13789852.716361146
2016-12-25,891.1,891.1,895.2,851.4,42480.0,1237.6,0.1,899.8000000000002,77.77726368305191,11.177382074394266,896.2671718481831,708.6828281518169,815.2154287714832,80.7465618860511,23.387733315128987,16251190.0,16.04375569735643,0.0,2.624591327026034,2.624591327026034,837.75,800.9,840.788,754.3,778.7,0,169.0,2.414486530724315,13827247.28728991
2016-12-26,898.4,891.1,909.3,885.9,38790.0,1237.6,0.1,893.5333333333333,78.73292209135815,10.633252614351768,909.728090036167,709.241909963833,823.1377688884847,85.52717747216764,23.388609506905485,16289980.0,15.401412973667306,0.008192122096285503,2.6033625898158377,2.6033625898158377,841.4749999999999,802.75,851.4,754.3,778.7,0,170.0,2.4147059575104706,13865040.51383759
2016-12-27,925.8,898.4,937.9,893.4,49690.0,1237.6,0.1,905.1,81.88227421084568,11.233986163759667,927.552684420485,707.437315579515,832.9151242324386,92.75014979029358,24.896565970697953,16339670.0,18.89045845640168,0.030498664292074817,2.6891948553357046,2.6891948553357046,852.025,811.45,851.4,754.3,778.7,0,171.0,2.4149375944834786,13904251.681278357
2016-12-28,972.2,925.8,974.5,925.5,77290.0,1237.6,0.1,932.1333333333333,85.73478470294086,13.707737308150406,954.1884281777267,701.1715718222732,846.180350496016,98.85799404170807,26.618239829933817,16416960.0,25.20283322601417,0.050118816158997825,2.737938678248695,2.737938678248695,870.525,829.75,868.6999999999999,754.3,778.7,0,172.0,2.4151895367457947,13945768.996604318
2016-12-29,971.1,972.2,982.6,949.2,61130.0,1237.6,0.1,956.3666666666668,85.27186539048297,14.163199734572217,975.7749397928345,699.6450602071656,858.0774599725859,94.50549450549451,27.10265127065283,16355830.0,25.270897832817337,-0.00113145443324425,2.7909227958658045,2.7909227958658045,876.8,833.8,889.8599999999999,754.3,778.7,0,173.0,2.4154402281942846,13987271.330209978
2016-12-30,959.0,971.1,971.6,927.4,70840.0,1237.6,0.1,967.4333333333334,80.14555335221581,12.595486701202013,991.3557672509793,702.5642327490208,867.6891304513873,88.38582677165354,28.323890465606205,16284990.0,22.634271099744247,-0.012460096797446196,2.9534818003760384,2.9534818003760384,885.025,833.8,908.4079999999999,754.3,778.7,0,174.0,2.4156847670791564,14028223.79988783
2016-12-31,963.4,959.0,965.5,942.4,27560.0,1237.6,0.1,964.5,80.60222410833796,10.866152383782875,1004.8211002930354,708.6488997069646,876.804451360779,90.34205231388329,27.95075543234862,16312550.0,22.383130081300802,0.004588112617309736,2.901261722269942,2.901261722269942,891.875,833.8,923.2463999999999,754.3,778.7,0,175.0,2.4159305197777265,14069425.601709684
2017-01-01,995.4,963.4,1001.6,956.1,41150.0,1237.6,0.1,972.6,83.56325660843146,10.862772901243297,1022.7588980499568,712.4011019500431,888.0992655168952,97.1202972596377,29.204272901466574,16353700.0,26.15969581749049,0.03321569441561145,2.9339233374991536,2.9339233374991536,902.225,843.3,927.4,754.3,778.7,0,176.0,2.4161895546523806,14112200.897718053
2017-01-02,1017.0,995.4,1031.7,990.2,64950.0,1237.6,0.1,991.9333333333334,85.20496388300455,11.2529034695049,1041.969483842845,717.0205161571549,900.3755259438576,93.99018806214225,30.08253912279039,16418650.0,28.766776399088386,0.02169981916817365,2.9579684486519557,2.9579684486519557,919.0,858.35,942.24,754.3,778.7,0,177.0,2.416457036458151,14156031.899833895
2017-01-03,1033.3,1017.0,1035.5,1006.5,54790.0,1237.6,0.1,1015.2333333333332,86.31572407463122,11.505345963534744,1060.7039315164734,723.9660684835268,913.0349996634902,99.0814196242171,30.005214899733936,16473440.0,29.30797146790138,0.01602753195673534,2.9038241459144425,2.9038241459144425,929.975,860.25,956.1,754.3,778.7,0,178.0,2.4167305614026957,14200662.642566536
2017-01-04,1135.4,1033.3,1148.5,1022.3,156270.0,1237.6,0.1,1061.8999999999999,90.91614303912823,17.10758733223137,1100.4046061765857,720.2853938234142,934.2126187431578,95.90112640801004,36.87627097832438,16629710.0,36.92715870718765,0.09880963902061368,3.2478660364914895,3.2478660364914895,988.35,922.3,971.98,754.3,1135.4,1,179.0,2.417043723319469,14249817.891295517
2017-01-05,989.3,1135.4,1150.6,874.5,240010.0,1237.6,0.1,1052.6666666666667,59.88947092271298,9.890764431346383,1104.1363110897637,737.2836889102359,939.4590360057142,46.08957219251337,53.96368019415835,16389700.0,15.00813764240873,-0.1286771181962305,5.454733669681427,5.454733669681427,984.675,924.25,1148.5,754.3,1135.4,1,180.0,2.4172969769641224,14292487.988876553
2017-01-06,886.2,989.3,1027.4,852.5,194290.0,1237.6,0.1,1003.6333333333336,47.55583470937316,-2.2608653341444622,1099.5001725723914,751.8198274276086,934.3867468623129,11.631016042780773,62.60198875171847,16195410.0,-3.3798517226341036,-0.10421510158698055,7.06409261472788,7.06409261472788,980.375,929.3499999999999,1148.5,754.3,1135.4,1,181.0,2.4175022931061902,14329945.205940431
2017-01-07,888.9,886.2,900.9,806.7,130660.0,1237.6,0.1,921.4666666666667,47.85867420216192,-10.111466126019891,1093.9206543795997,767.3893456204006,930.0546757325687,23.90229717941261,64.85898955516714,16326070.0,-0.24688587139491025,0.0030467163168583777,7.296545118142326,7.296545118142326,968.925,931.6999999999999,1150.6,754.3,1135.4,0,182.0,2.4177082125621423,14367564.216497129
2017-01-08,900.9,888.9,936.1,875.8,76910.0,1237.6,0.1,892.0,49.26103292327544,-14.238173465853485,1087.0121471995633,785.4078528004363,927.2780399485146,27.391683628961896,64.53334744408377,16402980.0,1.0997643362136633,0.013499831252109296,7.163208729502029,7.163208729502029,969.7249999999999,931.6999999999999,1129.966,754.3,1135.4,0,183.0,2.4179191747160407,14405842.660645198
2017-01-09,899.8,900.9,910.5,870.9,62580.0,1237.6,0.1,896.5333333333334,49.13058861334038,-16.618047434533672,1079.6111443417387,802.8788556582615,924.6610837629418,27.071823204419875,62.75239405522065,16340400.0,0.15583259127337237,-0.0012210012210012167,6.9740380145833125,6.9740380145833125,970.25,931.6999999999999,1110.5700399999998,754.3,1135.4,0,184.0,2.4181289073812318,14444081.445077647
2017-01-10,904.4,899.8,911.3,890.1,53710.0,1237.6,0.1,901.6999999999999,49.73007550108879,-17.376646586618172,1074.809984110776,815.2000158892238,922.7314567378996,28.409421343413772,59.78436590841917,16394110.0,-2.311514365953767,0.005112247166036976,6.610389861612028,6.610389861612028,970.3,931.6999999999999,1092.3378375999998,754.3,1135.4,0,185.0,2.4183401176935018,14482584.333337234
2017-01-11,785.4,904.4,917.7,751.6,194440.0,1237.6,0.1,863.2000000000002,37.438336445166506,-24.92755342725355,1084.267647178291,798.2623528217089,909.6522703819091,8.471177944862147,67.37833977210352,16199670.0,-19.21415346636495,-0.13157894736842102,8.578856604545901,8.578856604545901,951.0999999999999,938.0999999999999,1075.199567344,785.4,1135.4,1,186.0,2.418490276912211,14514298.879158678
2017-01-12,810.1,785.4,828.2,739.5,120240.0,1237.6,0.1,833.3000000000001,40.71386955573586,-27.112502897152726,1089.7283331075944,782.0916668924058,900.1711017741084,17.17343711992217,68.90131550266756,16319910.0,-16.57913706106477,0.031448943213649105,8.505285212031547,8.505285212031547,945.05,938.0999999999999,1049.31160195648,785.4,1135.4,0,187.0,2.418653047720762,14547504.120544843
2017-01-13,824.8,810.1,835.0,771.0,89860.0,1237.6,0.1,806.7666666666668,42.63872262700134,-26.396017341052474,1092.8561053874234,772.3338946125765,892.9929016051457,20.74920943809292,68.5512215381913,16409770.0,-13.993743482794581,0.0181459079126034,8.311253823738033,8.311253823738033,945.05,938.0999999999999,1018.330441760832,785.4,1135.4,0,188.0,2.4188228609109546,14581579.08122407
2017-01-14,819.6,824.8,838.9,808.3,44210.0,1237.6,0.1,818.1666666666666,42.117790962964115,-25.108337524666062,1095.8783423146679,762.1616576853323,886.0031014522747,19.48431038676722,65.84041999974906,16365560.0,-14.926302678015357,-0.006304558680892303,8.033238164927898,8.033238164927898,914.25,938.0999999999999,990.4473975847487,785.4,1135.4,0,189.0,2.4189893205058604,14615348.728678886
2017-01-15,821.2,819.6,826.4,808.6,24400.0,1237.6,0.1,821.8666666666668,42.351173504041846,-23.038959421495512,1098.1328926739645,752.1871073260356,879.831377504439,19.873510094867445,62.40896142833841,16389960.0,-17.50050231062889,0.0019521717911177294,7.59972740237925,7.59972740237925,891.425,938.0999999999999,965.3526578262738,785.4,1135.4,0,190.0,2.419155965801428,14649213.489525178
2017-01-16,827.3,821.2,836.7,817.7,33220.0,1237.6,0.1,822.7000000000002,43.28998322588614,-20.24841825983121,1098.3861523959326,742.0838476040673,874.828389170683,21.35733398199951,59.308321326314235,16423180.0,-18.652900688298924,0.007428153921090974,7.168901405332314,7.168901405332314,891.425,938.0999999999999,942.7673920436464,785.4,1135.4,0,191.0,2.419325123054516,14683439.164877284
2017-01-17,899.7,827.3,906.4,825.0,82210.0,1237.6,0.1,849.4000000000001,53.06052692957616,-12.874889491039026,1093.3288037533043,739.8911962466958,877.1971140115703,38.96862077353444,60.886298374434645,16505390.0,-12.92944933707538,0.08751359845279838,6.7674000638473535,6.7674000638473535,886.825,938.8499999999999,922.4406528392817,785.4,1135.4,0,192.0,2.4195294240605802,14721761.706718482
2017-01-18,872.0,899.7,913.7,845.9,69260.0,1237.6,0.1,866.3333333333334,49.54353151196254,-9.374169110237789,1087.5399223213828,735.7700776786173,876.7021507723731,32.230600827049386,61.380134204832174,16436130.0,-23.19887264400212,-0.030788040457930488,7.0390062161504785,7.0390062161504785,886.825,939.15,739.5,785.4,1135.4,0,193.0,2.419719694617036,14758570.718287593
2017-01-19,895.2,872.0,905.3,870.7,58440.0,1237.6,0.1,888.9666666666668,52.38990688978346,-5.214678829369621,1083.109338871888,733.8206611281119,878.4638506988138,54.08127822160472,59.467267475915584,16494570.0,-9.511776003234601,0.026605504587156048,6.64290297988333,6.64290297988333,886.825,939.1999999999999,742.984,785.4,1135.4,0,194.0,2.419920482880222,14796677.594342692
2017-01-20,892.9,895.2,901.5,878.9,38870.0,1237.6,0.1,886.7000000000002,52.07626096241828,-2.475796810865623,1077.8440936473132,732.0359063526867,879.8387220608315,78.02644964394709,56.8338912276359,16455700.0,0.7560370119611749,-0.002569258266309271,6.365090293161149,6.365090293161149,885.825,940.5999999999999,746.39832,785.4,1135.4,0,195.0,2.420119486376478,14834673.17906065
2017-01-21,919.8,892.9,928.9,889.5,40380.0,1237.6,0.1,902.6333333333333,55.43657391459525,1.0982173745561408,1069.2261584019784,733.0938415980218,883.644558055038,91.70905391658187,55.588613282804765,16496080.0,3.476206547418155,0.030126553925411637,6.043554390389733,6.043554390389733,897.5,945.05,749.7443536000001,785.4,1135.4,0,196.0,2.420330446194906,14874145.075681983
2017-01-22,918.8,919.8,938.4,888.6,47930.0,1237.6,0.1,910.5,55.28139224975902,3.2253046135691745,1056.0256364406002,736.4743635593998,886.9926953831296,90.14580191050779,55.17514090546156,16448150.0,1.9869019869019844,-0.0010871928680148413,6.005130703685412,6.005130703685412,909.1999999999999,945.05,756.910579456,785.4,1135.4,0,197.0,2.4205402422793934,14913583.326028084
2017-01-23,921.5,918.8,928.0,910.8,32740.000000000004,1237.6,0.1,920.0333333333333,55.64243627072458,4.562754880791188,1038.2209487635494,743.0990512364504,890.279105346641,91.50326797385623,52.462630840785735,16480890.0,2.4116470326739328,0.0029386155855464224,5.69317751934734,5.69317751934734,909.275,945.05,767.79994468864,785.4,1135.4,0,198.0,2.4207505884039886,14953186.3498986
2017-01-24,893.8,921.5,925.6,889.2,58870.0,1237.6,0.1,911.3666666666668,51.08552634676646,3.3847082174845005,974.564198699572,782.5958013004283,890.614428646961,77.57667169431875,51.315300066443896,16422020.0,-1.1720477664750137,-0.030059685295713567,5.7412508465477625,5.7412508465477625,911.55,945.05,778.0359480073216,785.4,1135.4,0,199.0,2.420947252524192,14991295.739436874
2017-01-25,894.4,893.8,905.7,883.6,37900.0,1237.6,0.1,903.2333333333332,51.1787935553626,2.490077415472887,955.8177853881465,791.8522146118536,890.9749592520122,77.87833081950728,49.22849291884076,16459920.0,13.878278584160938,0.0006712911165809299,5.5040801563999056,5.5040801563999056,913.375,945.05,787.6577911268823,785.4,1135.4,0,200.0,2.4211435208136582,15029452.063501768
2017-01-26,915.6,894.4,919.3,893.5,33800.0,1237.6,0.1,901.2666666666668,54.481350088106375,3.128952694115359,959.1549725700545,791.4550274299456,893.3202012280111,86.37992831541222,47.55502913892356,16493720.0,13.02308356992964,0.023703041144901738,5.193865130944032,5.193865130944032,918.5999999999999,945.05,796.7023236592694,785.4,1135.4,0,201.0,2.421349065688684,15068788.643597143
2017-01-27,918.0,915.6,922.6,907.9,30970.0,1237.6,0.1,909.3333333333335,54.8536768074632,3.488605381480104,962.4918937152264,791.0281062847736,895.6706582539149,84.31975403535743,45.20824134328616,16524690.0,11.29970902036858,0.002621231979030192,4.92464502650176,4.92464502650176,924.8,945.05,805.2041842397132,785.4,1135.4,0,202.0,2.421555031169456,15108273.774429642
2017-01-28,918.5,918.0,921.9,912.8,14310.0,1237.6,0.1,917.3666666666668,54.93637659355266,3.5251883713127805,964.6960600992194,790.5839399007808,897.8448812773515,84.66872110939909,42.62908124733715,16539000.0,12.066861883845775,0.0005446623093681158,4.641162901179874,4.641162901179874,926.8499999999999,945.05,813.1959331853304,785.4,1135.4,0,203.0,2.4217605362372487,15147804.296777826
2017-01-29,914.5,918.5,922.4,912.7,11050.0,1237.6,0.1,917.0000000000001,54.08285158123,3.0621456883049296,966.4097403017631,790.3402596982369,899.4310830604609,80.19884009942007,40.277004015384485,16527950.0,11.36142230881636,-0.004354926510615087,4.404265064558173,4.404265064558173,928.025,945.05,820.7081771942106,785.4,1135.4,0,204.0,2.421963498038409,15187133.974022292
2017-01-30,920.7,914.5,922.3,911.5,19060.0,1237.6,0.1,917.9000000000001,55.24357308490916,2.954181697011454,968.4664224193536,789.9135775806462,901.4566941975598,84.39153439153444,38.1715037285713,16547010.0,11.289737700954925,0.006779661016949268,4.145921986376811,4.145921986376811,928.025,945.05,827.769686562558,785.4,1135.4,0,205.0,2.4221686397998106,15226820.088531101
2017-01-31,965.5,920.7,967.5,917.4,54670.0,1237.6,0.1,933.5666666666667,62.60040775264286,5.531062447197749,974.0814942816905,802.3085057183093,907.5560566549351,98.35526315789474,39.0235391765305,16601680.0,7.313548960764694,0.0486586293037905,4.041795875352719,4.041795875352719,904.5,945.05,834.4075053688046,785.4,1135.4,0,206.0,2.422393243263678,15268917.491546627
2017-02-01,982.4,965.5,986.6,959.8,45220.0,1237.6,0.1,956.2000000000002,64.94151903095045,7.862548289590251,984.1871571979706,809.4328428020295,914.684051259227,96.37618636755819,38.15042923534975,16646900.0,12.660550458715594,0.01750388399792846,3.8833905980608456,3.8833905980608456,899.075,945.05,845.0549049393002,785.4,1135.4,0,207.0,2.4226244897761067,15311918.955327848
2017-02-02,1004.0,982.4,1009.1,973.5,50860.0,1237.6,0.1,983.9666666666667,67.72255183786592,10.200027699372026,998.3685550643144,813.1714449356858,923.1903320916815,96.08294930875574,37.968255718539055,16697760.0,12.153708668453971,0.02198697068403921,3.7816987767469175,3.7816987767469175,910.325,945.05,859.2094144453702,785.4,1135.4,0,208.0,2.422864231281228,15356052.83524573
2017-02-03,1013.0,1004.0,1023.7,989.2,61670.0,1237.6,0.1,999.8000000000001,68.83197133395659,11.591378737433441,1010.3876571590833,820.4923428409165,931.7436337972357,92.3625981441827,37.720523167214836,16759430.0,13.45055437339008,0.008964143426294813,3.723644932597713,3.723644932597713,920.1,945.05,877.1962847119257,785.4,1135.4,0,209.0,2.4231070212724277,15400675.760056434
2017-02-04,1031.8,1013.0,1041.0,1000.4,39460.0,1237.6,0.1,1016.2666666666668,71.06894511387037,12.915771929714943,1023.4545033838651,828.4854966161347,941.2728115308323,94.15501905972043,37.926200083842346,16798890.0,12.176560121765602,0.018558736426456113,3.675731739081445,3.675731739081445,932.35,945.05,897.7068048522561,785.4,1135.4,0,210.0,2.4233568620804875,15446272.318491865
2017-02-05,1016.1,1031.8,1033.7,1004.0,31060.0,1237.6,0.1,1020.3000000000001,66.75978179742123,11.897623303326103,1029.347764503946,841.472235496054,948.3992104326578,84.18043202033039,37.3386143635679,16767830.0,10.589899869394872,-0.015216127156425618,3.6746987859037397,3.6746987859037397,933.25,945.05,920.6337160758951,785.4,1135.4,0,211.0,2.4235994698874443,15491128.67650439
2017-02-06,1024.7,1016.1,1030.6,1010.8,32020.000000000004,1237.6,0.1,1024.2,67.90766546786986,10.98824002159645,1041.6977608705772,841.6222391294224,955.6659522962143,89.64421855146126,36.085856194741616,16799850.0,11.199131850244171,0.0084637338844602,3.521602048867143,3.521602048867143,933.25,945.05,939.8923215037519,785.4,1135.4,0,212.0,2.4238449092434515,15536454.205923552
2017-02-07,1049.6,1024.7,1054.1,1019.9,39550.0,1237.6,0.1,1030.1333333333334,71.02733139664818,11.209883623603421,1055.6677394411142,845.4122605588856,964.6120520775272,97.36070381231671,35.9511521808315,16839400.0,17.431192660550455,0.02429979506196922,3.4252241025944645,3.4252241025944645,947.675,945.05,956.0695500631516,785.4,1135.4,0,213.0,2.4240997643861184,15583050.748142846
2017-02-08,1055.5,1049.6,1069.2,1020.3,65150.00000000001,1237.6,0.1,1043.2666666666667,71.72861110356982,10.89072883599863,1069.8460504038794,847.2639495961206,973.2680471177628,92.20261809903242,36.87606988220068,16904550.0,18.01207513416816,0.0056211890243902385,3.4937062891710737,3.4937062891710737,966.025,945.05,973.7150310517843,785.4,1055.5,0,214.0,2.424356240394311,15629980.92944424
2017-02-09,979.0,1055.5,1073.0,924.7,146750.0,1237.6,0.1,1028.0333333333335,53.609445478508846,4.9659450435749015,1070.2520369487368,855.4679630512633,973.8139473922615,43.0648092065415,44.83492203347206,16757800.0,6.924421144604628,-0.07247749881572718,4.5796651719583314,4.5796651719583314,969.825,945.05,1069.2,979.0,1055.5,1,215.0,2.424580176732979,15673079.480873493
2017-02-10,997.6,979.0,1005.6,947.0,62130.0,1237.6,0.1,1010.7000000000002,56.487481259915214,1.8959899824490627,1073.25381213834,860.24618786166,976.0792857358556,53.31269349845202,45.818141888224055,16819930.0,8.671023965141615,0.018998978549540357,4.592836997616685,4.592836997616685,972.1,945.05,1069.2,979.0,1055.5,0,216.0,2.424811353130738,15717178.840342905
2017-02-11,1008.3,997.6,1014.3,983.9,28320.0,1237.6,0.1,994.9666666666667,58.097968260071966,0.2678374911929886,1076.8109815505773,865.6390184494229,979.1479251895837,59.93808049535601,44.716846039065196,16848250.0,9.77681001633097,0.010725741780272635,4.434875140242507,4.434875140242507,973.925,945.05,1073.0,979.0,1055.5,0,217.0,2.425046316042076,15761863.223822821
2017-02-12,996.5,1008.3,1007.8,992.5,14750.0,1237.6,0.1,1000.8000000000001,55.651698553569815,-1.8077785293579538,1078.5385046722483,871.4114953277516,980.8005037429567,52.63157894736842,42.651357036274824,16833500.0,8.96664844177146,-0.011702866210453244,4.280116110012526,4.280116110012526,979.1500000000001,945.05,1070.034,979.0,1055.5,0,218.0,2.425275589678921,15805971.097661378
2017-02-13,995.4,996.5,1007.6,975.1,32910.0,1237.6,0.1,1000.0666666666667,55.417445502384304,-3.368079503878196,1076.94531891783,883.16468108217,982.1909319579132,50.128534704370175,41.92626010511234,16800590.0,8.113391984359719,-0.0011038635223281634,4.212001216105319,4.212001216105319,985.35,945.05,1067.12732,979.0,1055.5,0,219.0,2.425503683322261,15850053.172413131
2017-02-14,1008.3,995.4,1013.8,986.5,39540.0,1237.6,0.1,1000.0666666666666,57.66784153748098,-3.622473607569354,1074.913905253184,896.5860947468159,984.6775098666834,56.372218476061995,40.88152724046146,16840130.0,4.432936302433967,0.0129596142254369,4.054500370967119,4.054500370967119,987.4000000000001,945.05,1064.2787736,979.0,1055.5,0,220.0,2.4257364938349064,15894838.183591487
2017-02-15,1008.2,1008.3,1010.9,999.7,23360.0,1237.6,0.1,1003.9666666666667,57.64355085575807,-3.866388104490163,1073.9326803878773,906.8273196121224,986.9177470222373,56.30478759271748,38.761418151857065,16816770.0,2.6262214983713426,-9.917683229188068e-05,3.8446159642786215,3.8446159642786215,988.575,945.05,1061.487198128,979.0,1055.5,0,221.0,2.4259685448570525,15939651.884305816
2017-02-16,1031.9,1008.2,1040.3,1007.4,38080.0,1237.6,0.1,1016.1333333333336,61.75516052665699,-2.563275106492526,1074.4862715111724,917.6637284888277,991.2017711153576,72.28590694538103,38.34274542672441,16854850.0,2.7788844621514035,0.023507240626859716,3.715742361345519,3.715742361345519,988.575,945.05,1058.75145416544,979.0,1055.5,0,222.0,2.426209668027223,15985717.395143777
2017-02-17,1049.4,1031.9,1057.4,1025.9,45710.0,1237.6,0.1,1029.8333333333335,64.49576803020913,-0.7486538754348118,1075.7097694619347,929.5302305380651,996.7444595805616,84.0863115306811,37.853977896244096,16900560.0,3.5932872655478865,0.016959007655780622,3.6072020103148557,3.6072020103148557,988.575,945.05,924.7,979.0,1055.5,0,223.0,2.4264571454988824,16032705.734989343
2017-02-18,1052.3,1049.4,1063.2,1044.7,25360.0,1237.6,0.1,1044.5333333333335,64.94407966083475,0.3614138049737292,1073.4851482999356,945.5348517000642,1002.035463430032,86.0418071476736,36.471550903655235,16925920.0,1.9868191509982556,0.002763483895559249,3.465889090910884,3.465889090910884,991.7,945.05,927.354,979.0,1055.5,0,224.0,2.4267050497900895,16079882.204840656
2017-02-19,1048.9,1052.3,1056.5,1037.7,17950.0,1237.6,0.1,1050.2,63.92493512103465,0.5688143699796484,1067.5081614326268,964.3318385673734,1006.4987526271718,83.74915711395825,35.20929726767986,16907970.0,3.22802873732901,-0.003231017770597644,3.3567830362932454,3.3567830362932454,998.725,945.05,932.7878400000001,979.0,1055.5,0,225.0,2.426950857554643,16126930.77966453
2017-02-20,1077.6,1048.9,1081.8,1041.0,31010.0,1237.6,0.1,1059.6000000000001,68.4287057499451,2.246818959826907,1074.3276845908306,968.7223154091694,1013.2702999960126,97.32654360280073,35.608633177131296,16938980.0,5.162486581438457,0.02736199828391639,3.304438862020351,3.304438862020351,1008.05,945.05,938.0043264000001,979.0,1055.5,0,226.0,2.427207286524966,16175451.39057036
2017-02-21,1119.0,1077.6,1123.0,1073.5,57050.0,1237.6,0.1,1081.8333333333333,73.55709949889933,5.563969264329632,1093.128836539136,963.581163460864,1023.3397952344875,97.98285426122038,36.60087366447907,16996030.0,6.612042682926838,0.038418708240534505,3.27085555536006,3.27085555536006,1032.25,945.05,946.632066816,979.0,1055.5,0,227.0,2.427478819276344,16226023.133100657
2017-02-22,1120.5,1119.0,1132.3,1094.8,47910.0,1237.6,0.1,1105.7,73.72364377775736,7.1756076492025045,1109.2761676785085,959.0838323214911,1032.5931480692982,94.31599229287093,36.66509697415914,17043940.0,6.158218853623875,0.0013404825737264314,3.272208565297558,3.272208565297558,1040.65,945.05,960.74150147072,979.0,1055.5,0,228.0,2.427750151771743,16276724.468954628
2017-02-23,1171.9,1120.5,1181.6,1113.5,65740.0,1237.6,0.1,1137.1333333333334,78.67909129915893,10.801926220059293,1137.4695514961327,946.7804485038673,1045.8604673007935,95.86530264279632,38.91044719029063,17109680.0,19.703779366700726,0.045872378402499026,3.320287327441815,3.320287327441815,1068.6,960.55,977.897351323648,979.0,1055.5,0,229.0,2.4280395612468655,16329880.09178802
2017-02-24,1176.5,1171.9,1211.7,1092.4,108170.0,1237.6,0.1,1156.3000000000002,79.05970113926006,12.489623247430899,1161.0345700685643,937.6854299314358,1058.3023275578607,85.12256973795434,44.65255810526987,17217850.0,17.933039294306333,0.0039252495946753285,3.795372554634073,3.795372554634073,1085.5749999999998,975.6,1002.3416691648102,979.0,1055.5,1,230.0,2.4283298309153873,16383316.17453067
2017-02-25,1149.1,1176.5,1180.0,1116.2,45860.0,1237.6,0.1,1165.8333333333333,70.93659623327939,10.803126361787122,1174.5962032447223,937.4237967552772,1066.9497249333026,73.54184277261194,46.02023252632201,17171990.0,13.9640979867103,-0.023289417764555953,4.004893614682971,4.004893614682971,1091.6750000000002,975.6,1031.6518354817367,979.0,1055.5,0,231.0,2.4286094253279864,16435557.47294802
2017-02-26,1171.6,1149.1,1177.5,1130.6,30770.0,1237.6,0.1,1165.7333333333333,73.35740281263787,10.250037968288687,1191.116644870433,935.593355129567,1076.9164177967975,83.05156382079454,46.08307306015616,17202760.0,17.571500250878064,0.019580541293185982,3.933345259487552,3.933345259487552,1096.45,975.6,1056.8585785142936,979.0,1055.5,0,232.0,2.428896383210399,16488908.088842494
2017-02-27,1188.8,1171.6,1195.8,1164.3,35470.0,1237.6,0.1,1169.8333333333333,75.06709198970908,10.07474633928534,1209.018716965331,931.6112830346692,1087.5719970542455,89.8312611012433,45.04142498443072,17238230.0,19.429375125577657,0.014680778422669905,3.7888143492959894,3.7888143492959894,1096.45,975.6,1078.5363775222925,979.0,1055.5,0,233.0,2.429188672338385,16543115.982370572
2017-02-28,1189.3,1188.8,1208.2,1175.8,50580.0,1237.6,0.1,1183.2333333333333,75.1170802684895,9.056722109402045,1224.8132741256338,929.1967258743659,1097.2603782871745,89.4339622641509,44.13846605697139,17288810.0,17.951006644847762,0.0004205921938089663,3.711297911121785,3.711297911121785,1097.275,975.6,1097.1792846691715,979.0,1055.5,0,234.0,2.4294803512741754,16597420.297655772
2017-03-01,1222.7,1189.3,1225.0,1154.6,51150.0,1237.6,0.1,1200.2666666666667,78.25357312753832,9.64281496199385,1242.740641809139,935.639358190861,1109.2070089264912,98.94301470588238,46.014289910044866,17339960.0,21.275540567347747,0.028083746741780935,3.7633344164590548,3.7633344164590548,1112.05,982.25,1113.2121848154875,979.0,1055.5,0,235.0,2.4297828495731375,16653303.698400294
2017-03-02,1255.5,1222.7,1287.0,1212.0,78490.0,1255.5,0.1,1222.5,80.8115411962699,11.143344845033695,1265.69041892003,938.4795810799701,1123.1396747430158,87.93565683646113,48.08469777361309,17418450.0,21.6687663533288,0.026825877157111266,3.8299241556043877,3.8299241556043877,1147.775,1013.25,1131.0982352450094,979.0,1055.5,0,236.0,2.4300956365932573,16710712.056165934
2017-03-03,1283.3,1255.5,1291.3,1250.8,67280.0,1283.3,0.1,1253.8333333333333,82.67196606211184,12.793879631134978,1291.3887897625639,940.2812102374362,1138.3930390532048,96.8454258675079,47.542933646926436,17485730.0,22.288927005908125,0.02214257268020714,3.704740407303549,3.704740407303549,1149.925,1015.4,1154.6,979.0,1283.3,0,237.0,2.4304167815539235,16769407.756815441
2017-03-04,1264.3,1283.3,1285.8,1228.7,38420.0,1283.3,0.1,1267.7,77.16531374959354,11.43608431724855,1307.1636621844684,951.2863378155313,1150.3841781909948,89.35331230283911,48.22558124357454,17447310.0,20.14634609902119,-0.014805579365697819,3.814409653055014,3.814409653055014,1149.925,1015.4,1181.9399999999998,1264.3,1283.3,0,238.0,2.430730863907271,16827381.001643516
2017-03-05,1271.2,1264.3,1273.3,1242.1,25430.0,1283.3,0.1,1272.9333333333334,77.74505745354467,9.89071619516983,1320.0773198198824,965.9526801801172,1161.8904469347096,91.9696364362765,47.00946829760493,17472740.0,21.19363142339593,0.005457565451237878,3.6980387269984996,3.6980387269984996,1155.875,1031.15,1203.812,1264.3,1283.3,0,239.0,2.4310464115110166,16885744.85355245
2017-03-06,1277.0,1271.2,1280.6,1261.0,31030.0,1283.3,0.1,1270.8333333333333,78.24504902941295,8.216049448269857,1331.349508289756,981.5504917102443,1172.8532615123565,93.43434343434346,45.05164913349029,17503770.0,18.50408314773572,0.004562617998741247,3.52792867137747,3.52792867137747,1159.475,1049.8,1221.3095999999998,1264.3,1283.3,0,240.0,2.4313630497188403,16944452.54563625
2017-03-07,1232.7,1277.0,1280.9,1148.7,87720.0,1283.3,0.1,1260.3,66.04085003584653,3.3321386304971696,1331.543958317304,1003.8060416826959,1178.5529508921322,70.53795877325292,51.276531338240986,17416050.0,10.16085790884719,-0.034690681284259894,4.159692653382087,4.159692653382087,1169.575,1049.95,1291.3,1264.3,1283.3,0,241.0,2.4316641180925376,17001298.611319497
2017-03-08,1147.0,1232.7,1242.0,1136.9,97880.0,1283.3,0.1,1218.9,49.844097993996456,-5.956887422173914,1325.4795853332007,1021.380414666799,1175.5479079500244,27.450980392156836,55.12106481408091,17318170.0,2.3650156180276665,-0.06952218706903546,4.805672608027979,4.805672608027979,1173.65,1054.5,1288.4479999999999,1264.3,1283.3,0,242.0,2.4319342894865863,17054225.2287848
2017-03-09,1191.3,1147.0,1207.0,1129.3,59860.0,1283.3,0.1,1190.3333333333333,55.86920321090266,-9.21013502006086,1321.609724545212,1039.4402754547882,1177.0481071928791,49.7234791352438,56.73384589878942,17378030.0,1.655431350797838,0.03862249346120317,4.7623475110206845,4.7623475110206845,1171.75,1058.15,1282.3860799999998,1264.3,1283.3,0,243.0,2.4322195308651717,17109322.924502805
2017-03-10,1112.4,1191.3,1330.4,988.7,190470.0,1283.3,0.1,1150.2333333333336,45.406995912314706,-16.351077421738125,1315.8502645100077,1051.2097354899927,1170.891144603081,36.20134621012585,77.08857119173304,17187560.0,-5.448363790905219,-0.06623016872324339,6.929932685340977,6.929932685340977,1156.15,1088.15,1129.3,1264.3,1283.3,1,244.0,2.4324753951397695,17160665.514153596
2017-03-11,1179.2,1112.4,1202.7,1104.8,70750.0,1283.3,0.1,1160.966666666667,53.36880141984112,-16.218910577562163,1307.1670470278689,1072.9229529721313,1171.6824641646926,55.750658472344156,78.57510182089497,17258310.0,2.619441301888447,0.060050341603739676,6.6634245099130744,6.6634245099130744,1159.0,1100.5500000000002,1330.4,1264.3,1283.3,0,245.0,2.4327548555570306,17215324.953217424
2017-03-12,1225.1,1179.2,1235.5,1160.9,44410.0,1283.3,0.1,1172.2333333333333,57.910980818850724,-12.83185116182814,1303.3303696528264,1091.5096303471737,1176.76984852996,69.18349429323963,78.29116597654533,17302720.0,4.566404916353705,0.03892469470827664,6.3905939087866575,6.3905939087866575,1159.5500000000002,1104.65,1330.4,1264.3,1283.3,0,246.0,2.433049477324111,17272196.668083943
2017-03-13,1238.2,1225.1,1245.6,1205.6,60460.0,1283.3,0.1,1214.1666666666667,59.134437178755405,-9.646216380217467,1304.2640046786325,1102.4959953213677,1182.6203391461543,73.01726660813578,75.55608269250638,17363180.0,4.155450874831771,0.010693004652681637,6.1020903482883515,6.1020903482883515,1159.5500000000002,1107.0,1325.8880000000001,1264.3,1283.3,0,247.0,2.433347749810129,17329746.542035762
2017-03-14,1243.1,1238.2,1255.5,1218.4,45140.0,1283.3,0.1,1235.466666666667,59.607404253205544,-7.255146061240829,1304.2147601760244,1114.8052398239756,1188.3803068465206,74.451273046532,72.80921964304163,17408320.0,4.523669385352725,0.003957357454369204,5.857068590060464,5.857068590060464,1159.5500000000002,1107.0,1321.4662400000002,1264.3,1283.3,0,248.0,2.433646880555362,17387601.622833107
2017-03-15,1253.4,1243.1,1256.9,1236.4,43590.0,1283.3,0.1,1244.8999999999999,60.638666351928634,-5.126285881294677,1308.479325963138,1118.690674036862,1194.5726585754235,77.46561311091601,69.0728468113958,17451910.0,2.5108366729369465,0.008285737269729143,5.510838264831323,5.510838264831323,1159.5500000000002,1107.0,1317.1329152000003,1264.3,1283.3,0,249.0,2.433948660295341,17446007.28949309
2017-03-16,1172.9,1253.4,1260.2,1119.0,132770.0,1283.3,0.1,1223.1333333333334,49.912999525649575,-9.056332337224873,1308.5932235363089,1118.216776463691,1192.5085958539546,53.906935908691835,74.22478632486754,17319140.0,-6.579052170450013,-0.06422530716451247,6.328313268383283,6.328313268383283,1159.5500000000002,1107.0,1312.8862568960003,1264.3,1283.3,1,250.0,2.4342220093159845,17500726.251575615
2017-03-17,1071.7,1172.9,1174.9,1063.5,163740.0,1283.3,0.1,1166.0000000000002,40.26975885850705,-17.878348990403026,1319.9429938229036,1099.1270061770965,1181.003015296435,24.290313140181443,76.88015873023414,17155400.0,-16.48873996727187,-0.08628186546167627,7.173664153236367,7.173664153236367,1159.5500000000002,1107.0,1308.7245317580803,1264.3,1283.3,1,251.0,2.434457047153111,17550369.80158814
2017-03-18,971.4,1071.7,1103.6,940.2,210420.0,1283.3,0.1,1072.0000000000002,33.38530112872046,-29.205908828150086,1350.6639013457434,1048.3860986542568,1161.0408233634412,7.995899538698085,83.06014739236026,16944980.0,-23.166969864747287,-0.09358962396192971,8.550560777471718,8.550560777471718,1135.3000000000002,1111.95,1298.9155504877572,1264.3,1283.3,1,252.0,2.4346504965804194,17594443.345913015
2017-03-19,1022.6,971.4,1063.7,967.3,106450.0,1283.3,0.1,1021.9000000000001,39.108045347922115,-31.77514294660414,1360.9330871327459,1021.4969128672541,1147.8559830431134,21.11737570476678,84.01299400719168,17051430.0,-19.556324732536186,0.0527074325715462,8.2156262475251,8.2156262475251,1117.75,1119.15,1277.3926174584917,1264.3,1283.3,0,253.0,2.434864651597906,17641471.526782926
2017-03-20,1047.5,1022.6,1057.5,1005.0,61430.0,1283.3,0.1,1013.8333333333334,41.729816159336664,-30.32612726340198,1365.04825306604,1003.2017469339601,1138.2982703723408,27.498718605843145,81.76206586382084,17112860.0,-17.97180892717306,0.024349696851163616,7.805447815161894,7.805447815161894,1117.75,1120.95,1257.1610604109821,1264.3,1283.3,0,254.0,2.435088126652417,17689907.034082513
2017-03-21,1121.3,1047.5,1125.5,1043.9,92590.0,1283.3,0.1,1063.8,48.770240332355776,-23.244707108392863,1361.0500381191705,997.0599618808293,1136.679387479737,46.41209636084057,81.75048973069077,17205450.0,-9.03707309158758,0.07045346062052493,7.290688462560491,7.290688462560491,1117.75,1120.95,1238.1433967863231,1264.3,1283.3,0,255.0,2.4353391994518625,17742290.023829497
2017-03-22,1044.7,1121.3,1121.9,997.8,115290.0,1283.3,0.1,1071.1666666666667,42.967306034271665,-22.549421943036137,1355.9164757145693,981.1135242854305,1127.9194458150002,26.781137878011272,84.77545474992715,17090160.0,-8.918918918918916,-0.06831356461250326,8.114813319606313,8.114813319606313,1117.75,1120.95,1220.2667929791437,1264.3,1283.3,0,256.0,2.435560157156358,17790645.16662567
2017-03-23,1035.0,1044.7,1062.8,1022.0,56520.0,1283.3,0.1,1067.0,42.2812365763018,-21.572494063182614,1344.336330180968,967.8636698190319,1119.0699747850003,24.295233213736534,81.63435083921807,17033640.0,-13.12012087635356,-0.009284962190102442,7.887376892678074,7.887376892678074,1117.75,1123.9,1203.462785400395,1264.3,1283.3,0,257.0,2.435776554123621,17838493.423773505
2017-03-24,939.7,1035.0,1038.4,927.3,132600.0,1283.3,0.1,1006.4666666666667,36.17053899308292,-25.883874105122423,1343.3487664597917,936.3912335402084,1101.9871200435718,3.724842294983505,83.73904006498822,16901040.0,-15.524991010427907,-0.09207729468599024,8.911252534318209,8.911252534318209,1111.3,1127.5500000000002,1187.6670182763712,939.7,1283.3,0,258.0,2.435952181599057,17880778.78327842
2017-03-25,966.3,939.7,996.0,890.4,127050.0,1283.3,0.1,980.3333333333334,38.828013541494215,-25.445485630648697,1332.109369290794,917.1406307092062,1089.0645371822793,20.524607896160077,85.30053720320335,17028090.0,-18.054613297150617,0.028306906459508285,8.827541881734797,8.827541881734797,1071.525,1110.4,1166.8376568142614,939.7,1283.3,0,259.0,2.436138757624608,17924690.507500764
2017-03-26,969.4,966.3,1004.3,946.7,85330.0,1283.3,0.1,958.4666666666667,39.145995033556595,-23.494735007498903,1314.8633792855069,903.6266207144932,1077.6679145934909,21.362898864250944,83.32192740297454,17113420.0,-20.87176557015753,0.0032081134223327368,8.595206045283117,8.595206045283117,1059.1750000000002,1110.4,1139.1938911328352,939.7,1283.3,0,260.0,2.4363260177250408,17968801.37496698
2017-03-27,1045.1,969.4,1048.8,961.8,91260.0,1283.3,0.1,993.6,46.464316461964756,-16.011615013269974,1299.1177768940713,900.6122231059286,1074.56620844173,41.83342347214708,83.58464687419064,17204680.0,-15.595218866095955,0.07808953992160084,7.997765464949827,7.997765464949827,1059.1750000000002,1110.4,1114.3145020195518,939.7,1045.1,0,261.0,2.436543798984179,18017305.977952782
2017-03-28,1044.4,1045.1,1068.4,1015.5,80000.0,1283.3,0.1,1019.6333333333333,46.408737694124476,-10.292366398658746,1294.1524844390497,895.3175155609505,1071.6932362091843,41.64413196322339,81.39288638317703,17124680.0,-15.984232965972152,-0.0006697923643668169,7.793267558710937,7.793267558710937,1059.1750000000002,1110.4,1091.9230518175966,939.7,1045.1,0,262.0,2.436760620821943,18065802.13421396
2017-03-29,1041.9,1044.4,1058.7,1008.3,68850.0,1283.3,0.1,1043.8,46.196206672697805,-6.069904065830475,1282.8090541156866,891.7209458843131,1068.855785141643,40.9680908599243,79.17910878437867,17055830.0,-16.8741024413595,-0.0023937188816545163,7.5994921570571705,7.5994921570571705,1059.1750000000002,1110.4,1071.770746635837,939.7,1045.1,0,263.0,2.4369757698956596,18114188.231683485
2017-03-30,1037.9,1041.9,1052.7,1020.9,74990.0,1283.3,0.1,1041.4,45.83453039392695,-3.0888387861750175,1279.8637163462392,887.2162836537606,1065.9076151281533,51.845342706502656,75.79488672835161,16980840.0,-11.509932645579331,-0.0038391400326326375,7.302715746059506,7.302715746059506,1058.275,1110.4,1068.4,939.7,1045.1,0,264.0,2.4371886488508796,18162377.997206878
2017-03-31,1079.1,1037.9,1088.2,1035.2,90990.0,1283.3,0.1,1052.9666666666667,50.162570278974925,1.8494689954327015,1269.889584737337,887.1804152626629,1067.1640327349958,80.26371756699272,74.16668053346936,17071830.0,0.6904917420919906,0.039695539069274366,6.873012745201498,6.873012745201498,1049.85,1110.4,890.4,939.7,1045.1,0,265.0,2.4374169618610475,18212885.127722315
2017-04-01,1086.1,1079.1,1103.7,1067.5,50660.0,1283.3,0.1,1067.7,50.880705731559786,5.568884788583603,1250.8572875962673,892.3127124037329,1068.9674581888057,83.241173968524,71.4547747810787,17122490.0,11.807700226477243,0.006486887220832127,6.579023550416969,6.579023550416969,1053.725,1110.4,894.356,939.7,1045.1,0,266.0,2.4376472562474816,18263811.094064396
2017-04-02,1097.4,1086.1,1109.5,1074.2,70980.0,1283.3,0.1,1087.5333333333333,52.081096615558316,8.59106811482475,1227.3991614451368,901.6908385548629,1071.6753193136813,88.04763930242454,68.8722908681445,17193470.0,7.314688050068459,0.010404198508424889,6.27595141863901,6.27595141863901,1055.1750000000002,1110.4,902.7297599999999,939.7,1045.1,0,267.0,2.4378811349863834,18315387.795026623
2017-04-03,1147.6,1097.4,1157.9,1095.6,98500.0,1283.3,0.1,1110.3666666666666,57.097196744607395,13.480738135040305,1206.1719275829344,913.3680724170656,1078.9062412838068,96.14953271028031,68.40284152041991,17291970.0,9.556085918854407,0.04574448696919986,5.960512506136277,5.960512506136277,1081.3500000000001,1110.4,915.1359743999999,939.7,1045.1,0,268.0,2.438132800792867,18369656.13482341
2017-04-04,1141.8,1147.6,1161.2,1122.2,71000.0,1283.3,0.1,1128.9333333333334,56.3630835484027,15.680073550681602,1177.3007127751227,931.0792872248774,1084.8961230663012,92.83604135893644,66.30263855467562,17220970.0,1.8282350842771782,-0.005054025792959216,5.80685221183006,5.80685221183006,1085.95,1110.4,934.5570964479999,939.7,1045.1,0,269.0,2.4383816526764757,18423676.940811392
2017-04-05,1129.9,1141.8,1143.8,1110.1,69470.0,1283.3,0.1,1139.7666666666667,54.8061112577087,15.652840751238424,1168.081999293354,935.9980007066463,1089.1822065837964,88.4416543574594,63.97387865791308,17151500.0,8.15545132573945,-0.010422140479943831,5.661906244615725,5.661906244615725,1080.025,1110.4,957.2213868032,939.7,1045.1,0,270.0,2.43862546130764,18477125.504430406
2017-04-06,1188.7,1129.9,1201.6,1130.5,92360.0,1283.3,0.1,1153.4666666666667,60.59799119473203,18.707698560314324,1188.2232022164678,927.5567977835319,1098.6600916710538,95.85475578406174,64.52574446806213,17243860.0,14.850241545893725,0.05204000354013627,5.428261501477423,5.428261501477423,1090.125,1110.4,977.61924812288,939.7,1045.1,0,271.0,2.4388895007694105,18533651.89833468
2017-04-07,1190.5,1188.7,1201.2,1173.2,59750.0,1283.3,0.1,1169.7,60.763761625183214,19.853964891723216,1204.9613983508182,932.7286016491813,1107.4067496071439,96.43316195372753,61.91676272034341,17303610.0,26.68936894753644,0.001514259274838059,5.200904050427837,5.200904050427837,1093.275,1110.4,1004.4969383481343,939.7,1045.1,0,272.0,2.4391534299132576,18590331.687953755
2017-04-08,1180.8,1190.5,1198.2,1166.7,33180.0,1283.3,0.1,1186.6666666666667,59.31552022683863,18.964719549348516,1219.4310873447218,934.0789126552784,1114.396582977892,91.83993723028641,59.74413681174745,17270430.0,22.198075131946602,-0.008147837043259165,5.059632182566689,5.059632182566689,1096.85,1110.4,1028.149305746358,939.7,1045.1,0,273.0,2.4394132506686472,18646583.223225143
2017-04-09,1204.3,1180.8,1215.1,1174.0,45350.0,1283.3,0.1,1191.8666666666666,61.69732532015663,18.92179264124135,1236.8874092001918,932.3025907998083,1122.9588131704736,95.73628108961707,58.41241275376548,17315780.0,24.231483391788732,0.019901761517615135,4.850320746804408,4.850320746804408,1108.3,1110.4,1048.9633890567952,939.7,1045.1,0,274.0,2.439680467230592,18704081.304295197
2017-04-10,1206.7,1204.3,1214.9,1194.8,40010.0,1283.3,0.1,1197.2666666666667,61.94237110829927,18.021892731809174,1249.589985923156,928.1400140768445,1130.934164297095,95.9381044487428,55.675811842782245,17355790.0,15.462635154530682,0.001992858922195584,4.613890100504039,4.613890100504039,1109.975,1110.4,1072.222514588844,939.7,1045.1,0,275.0,2.439947766960239,18761765.370704945
2017-04-11,1220.7,1206.7,1229.6,1195.8,37400.0,1283.3,0.1,1210.5666666666666,63.4128155093237,17.33124234903441,1266.806198706875,928.523801293125,1139.4832915068955,95.97830998644379,54.113253854012086,17393190.0,16.8805055534278,0.011601889450567615,4.432969104121576,4.432969104121576,1111.3,1110.4,1092.225362546406,939.7,1045.1,0,276.0,2.440219081459506,18820213.78202914
2017-04-12,1212.5,1220.7,1225.5,1207.4,44780.0,1283.3,0.1,1213.3,61.904135810544524,15.351697006226402,1280.1652216701207,932.9147783298793,1146.437263744334,91.8064206995688,51.5408785787255,17348410.0,16.373932239178412,-0.0067174571966904795,4.250794109585608,4.250794109585608,1114.925,1110.4,1114.205304538981,939.7,1045.1,0,277.0,2.4404868791262175,18878322.412509263
2017-04-13,1176.2,1212.5,1218.7,1150.3,66050.0,1283.3,0.1,1203.1333333333332,55.598087168767094,10.839802334345539,1276.4465647063203,960.2834352936798,1149.2718100543973,72.53086419753092,52.745101537387974,17282360.0,13.32498313903073,-0.029938144329896832,4.484365034635944,4.484365034635944,1114.925,1110.4,1132.668455812744,1176.2,1045.1,0,278.0,2.4407414293409064,18934648.137335356
2017-04-14,1177.3,1176.2,1195.4,1162.2,47220.0,1283.3,0.1,1188.6666666666667,55.74520615265852,7.339275661607349,1272.4924533135286,985.3375466864713,1151.941161477788,67.73596545342383,51.349022856145986,17329580.0,9.100176072653142,0.0009352150994728081,4.361592020398029,4.361592020398029,1120.025,1110.4,1148.1775028827049,1176.2,1045.1,0,279.0,2.440995644097932,18991088.446853
2017-04-15,1177.0,1177.3,1194.8,841.5,28390.0,1283.3,0.1,1176.8333333333333,55.69101038316556,4.550085826648264,1264.0224384407793,1014.5675615592203,1154.3277175275225,86.44679206390107,72.9169497949927,17301190.0,8.36939508332567,-0.00025482035165202976,6.195152913763186,6.195152913763186,1035.55,1085.95,1229.6,1176.2,1045.1,0,280.0,2.4412490348194793,19047570.68292036
2017-04-16,1176.8,1177.0,1188.0,1166.7,18930.0,1283.3,0.1,1177.0333333333335,55.65216554166766,2.3489732811860726,1263.7369913072553,1028.023008692745,1156.4679349058538,86.39525895387787,69.23002480963608,17282260.0,7.235283397120454,-0.0001699235344095884,5.882904895448341,5.882904895448341,1035.55,1085.95,1221.838,1176.2,1045.1,0,281.0,2.4415016378834857,19104099.632356238
2017-04-17,1194.0,1176.8,1203.0,1172.8,46480.0,1283.3,0.1,1182.6000000000001,58.34318857695197,1.736915709800435,1263.2232677467698,1043.4967322532304,1160.0424172957726,90.82710641587222,66.44216589466207,17328740.0,4.043220634367383,0.014615907545887152,5.564670510440709,5.564670510440709,1035.55,1085.95,1214.23124,1176.2,1045.1,0,282.0,2.4417594870953714,19161577.69060656
2017-04-18,1206.1,1194.0,1213.9,1191.1,52750.0,1283.3,0.1,1192.3,60.174039015351156,1.8235032126097437,1260.927719378005,1062.2122806219954,1164.4288537437942,93.94485957227519,63.324868330757646,17381490.0,5.631459099667188,0.010134003350083631,5.250382914414862,5.250382914414862,1035.55,1085.95,841.5,1176.2,1045.1,0,283.0,2.4420207555345415,19219738.273895305
2017-04-19,1215.2,1206.1,1218.2,1194.1,43350.0,1283.3,0.1,1205.1,61.542975287021875,2.147839728812542,1254.541986035634,1086.328013964366,1169.26420100629,96.28961607833037,60.523092021417824,17424840.0,7.549340649615005,0.007544979686593178,4.980504610057424,4.980504610057424,1035.55,1085.95,848.948,1176.2,1045.1,0,284.0,2.442284384028027,19278427.128459156
2017-04-20,1238.1,1215.2,1246.6,1210.7,55200.0,1283.3,0.1,1219.8,64.82008185831296,3.479978864005272,1256.285379331543,1100.484620668457,1175.8199913866433,97.90175265366577,58.76429973417368,17480040.0,4.155800454277771,0.018844634628044643,4.746329031110063,4.746329031110063,1044.05,1085.95,863.71808,1176.2,1045.1,0,285.0,2.442554946099658,19338338.948346518
2017-04-21,1249.6,1238.1,1257.0,1235.6,41340.0,1283.3,0.1,1234.3,66.36993187378688,4.638503278397192,1258.0593538432217,1115.0606461567781,1182.8466588736298,98.21901323706376,56.09542118173271,17521380.0,4.964300713985713,0.009288425813746892,4.4890701970016575,4.4890701970016575,1049.25,1085.95,886.6909952,1176.2,1249.6,0,286.0,2.4428285644492895,19398896.58987637
2017-04-22,1240.9,1249.6,1257.0,1215.8,43820.0,1283.3,0.1,1242.8666666666666,64.07030316390009,4.327788688733243,1256.240208582951,1131.2297914170492,1188.375548504713,96.12515042117931,55.03146252589466,17477560.0,5.089769647696489,-0.006962227912931995,4.434802363276223,4.434802363276223,1049.25,1085.95,916.315715584,1176.2,1249.6,0,287.0,2.4430985776625906,19459092.319137376
2017-04-23,1249.1,1240.9,1256.2,1223.1,42610.0,1283.3,0.1,1246.5333333333333,65.290999771216,4.18112634011333,1261.9863215136666,1135.6336784863333,1194.158829599502,98.09867629362212,53.46492948833077,17520170.0,3.7200033214315336,0.006608107019098863,4.2802761579001505,4.2802761579001505,1049.25,1085.95,943.57045833728,1176.2,1249.6,0,288.0,2.4433705555189786,19519770.907475542
2017-04-24,1248.2,1249.1,1256.4,1234.9,38540.0,1283.3,0.1,1246.0666666666666,65.0298556131221,3.554706667198019,1265.08805443088,1143.1719455691198,1199.305607732883,97.88206979542721,51.181720239164285,17481630.0,3.439131515703986,-0.000720518773516865,4.100442255981757,4.100442255981757,1130.55,1085.95,968.6448216702976,1176.2,1249.6,0,289.0,2.4436415008331225,19580477.222020384
2017-04-25,1264.3,1248.2,1272.6,1244.2,43890.0,1283.3,0.1,1253.8666666666666,67.53166952841009,3.737220741583833,1267.0400169069037,1154.6599830930961,1205.4955498535608,98.07469264671771,49.5544545077954,17525520.0,3.57172114360612,0.01289857394648286,3.9195170851692955,3.9195170851692955,1139.875,1085.95,991.7132359366738,1176.2,1249.6,0,290.0,2.4439169598700197,19642061.520090964
2017-04-26,1286.6,1264.3,1309.2,1263.0,58910.0,1286.6,0.1,1266.3666666666666,70.66240098593235,4.8043427613957235,1279.8617832942211,1151.628216705779,1213.2197832008408,95.16784263416717,49.31485061438144,17584430.0,6.1113402061855595,0.017638218777188852,3.8329590093565553,3.8329590093565553,1162.75,1085.95,1019.8019123430064,1176.2,1249.6,0,291.0,2.444198836698448,19704824.177074194
2017-04-27,1332.9,1286.6,1346.8,1285.3,61770.0,1332.9,0.1,1294.6,75.86572556400972,7.890653466734371,1303.6473068499415,1142.082693150059,1224.6178990864748,97.24915891549577,50.1852184276399,17646200.0,13.32256418976365,0.03598632053474282,3.765115044462443,3.765115044462443,1182.3,1094.15,1054.5296828618457,1176.2,1249.6,0,292.0,2.444494434032933,19769903.562238704
2017-04-28,1329.6,1332.9,1356.2,1287.6,77570.0,1332.9,0.1,1316.3666666666666,74.84678898161728,8.897422494193556,1321.0185375784563,1139.5914624215434,1234.6161944115725,94.83194093646782,51.50055996852278,17568630.0,12.936379852204194,-0.002475804636506984,3.8733874825904615,3.8733874825904615,1191.15,1098.85,1095.4475272611874,1176.2,1249.6,0,293.0,2.4447882529601,19834919.047247954
2017-04-29,1336.3,1329.6,1343.7,1314.2,40970.0,1336.3,0.1,1332.9333333333334,75.56436949224114,9.165896201897375,1337.733775158672,1136.076224841328,1244.300366372375,89.49868073878623,49.929091399342575,17609600.0,13.534409515717924,0.0050391095066184555,3.7363684351824125,3.7363684351824125,1192.425,1098.85,1137.1679228993974,1176.2,1249.6,0,294.0,2.4450833655257314,19900346.326872483
2017-04-30,1351.9,1336.3,1358.9,1309.7,40640.0,1351.9,0.1,1339.2666666666667,77.19565256134686,9.504633147409393,1355.6006904227634,1132.7293095772366,1254.547950527387,96.23858140784525,49.87701344224668,17650240.0,14.87933378653978,0.011674025293721524,3.6894010978805145,3.6894010978805145,1193.775,1100.2,1172.2130552354938,1176.2,1249.6,0,295.0,2.4453824592823903,19966607.489746343
2017-05-01,1415.8,1351.9,1448.7,1342.8,100440.0,1415.8,0.1,1368.0,82.38349219704594,12.930382759594664,1387.4073267392748,1120.4326732607253,1269.905288572398,87.22826086956519,53.87865533922906,17750680.0,18.57621440536013,0.04726680967527175,3.8055272876980553,3.8055272876980553,1240.5,1145.1,1205.8167052931049,1176.2,1249.6,1,296.0,2.4456996555261115,20035920.809166107
2017-05-02,1445.9,1415.8,1471.1,1394.8,70010.0,1445.9,0.1,1404.5333333333335,84.20615784291358,15.924920655530265,1421.4817945242721,1109.6982054757282,1286.666689660741,90.90252707581234,55.480179957855555,17820690.0,19.88226515214329,0.021260064980929583,3.8370689506781623,3.8370689506781623,1254.65,1156.3,1254.393364234484,1176.2,1249.6,0,297.0,2.4460246547361986,20106698.190305084
2017-05-03,1485.6,1445.9,1496.4,1424.1,81720.0,1485.6,0.1,1449.1000000000001,86.22980979829131,19.068558234130776,1458.338689074569,1103.781310925431,1305.6127192168608,96.21981099054946,56.6815956751516,17902410.0,22.25148123765634,0.027456947230098727,3.815400893588557,3.815400893588557,1269.625,1168.95,1297.7346913875872,1176.2,1249.6,0,298.0,2.4463599140672008,20179341.211300556
2017-05-04,1516.8,1485.6,1609.8,1437.1,136710.0,1516.8,0.1,1482.7666666666667,87.57698423862888,21.55494268496119,1496.1172382244245,1099.9527617755757,1325.7257935771597,76.39593908629442,64.96862455549793,18039120.0,22.510298037315245,0.02100161550888524,4.28326902396479,4.28326902396479,1331.025,1225.65,1337.4677531100697,1176.2,1249.6,1,299.0,2.446702844965939,20253458.681957897
2017-05-05,1507.8,1516.8,1588.1,1485.0,120380.0,1516.8,0.1,1503.3999999999999,84.99386719937041,20.88443506698063,1524.366952896191,1104.7830471038092,1343.0661941888586,74.11167512690355,67.6922942301052,17918740.0,20.662612035851478,-0.0059335443037974445,4.489474348726967,4.489474348726967,1336.6,1225.65,1391.9342024880557,1507.8,1249.6,0,300.0,2.447042529287113,20327330.004479583
2017-05-06,1545.3,1507.8,1560.4,1503.9,59600.0,1545.3,0.1,1523.3,86.74780917134686,21.190319292244595,1555.4975415594458,1110.5024584405537,1362.3265566470625,83.32040341349884,66.89284464224055,17978340.0,24.53058264163106,0.02487067250298458,4.32879341501589,4.32879341501589,1337.175,1225.65,1435.5073619904445,1507.8,1249.6,0,301.0,2.447391416011822,20402936.079149183
2017-05-07,1554.4,1545.3,1572.9,1495.2,71360.0,1554.4,0.1,1535.8333333333333,87.14060053542688,20.231433376013428,1583.712213879187,1118.327786120813,1380.6192655378186,85.22272606028277,67.66478431065194,18049700.0,24.441597950524393,0.005888824176535357,4.353112732285894,4.353112732285894,1342.7,1225.65,1470.3658895923556,1507.8,1249.6,0,302.0,2.4477418705582115,20479072.02834689
2017-05-08,1664.5,1554.4,1667.7,1552.9,107230.0,1664.5,0.1,1588.0666666666666,90.72322854621399,24.92955293849697,1633.7436597124783,1114.1363402875218,1407.655525962788,99.24439197166468,71.03158543131966,18156930.0,33.35202691876301,0.0708311888831703,4.267442801521157,4.267442801521157,1371.65,1254.6,1495.2,1507.8,1249.6,0,303.0,2.448119380157018,20559838.488065105
2017-05-09,1697.5,1664.5,1757.4,1620.0,127230.0,1697.5,0.1,1638.8,91.48863407710078,27.949929375672227,1682.7835477432795,1113.3264522567201,1435.2597615853797,87.88430420711973,75.77218647193968,18284160.0,34.26401961559757,0.019825773505557143,4.463751780379362,4.463751780379362,1424.775,1299.45,1495.2,1507.8,1249.6,0,304.0,2.4485040256751343,20642073.317822095
2017-05-10,1752.3,1697.5,1766.2,1665.0,89680.0,1752.3,0.1,1704.7666666666667,92.58302582071445,31.08791732990602,1737.464080489562,1110.0659195104377,1465.4540700058199,97.10958619255561,77.58845886680113,18373840.0,36.196175967666726,0.03228276877761416,4.427806817713926,4.427806817713926,1442.175,1303.85,1547.64,1507.8,1249.6,0,305.0,2.4489007380552974,20726590.916458964
2017-05-11,1819.3,1752.3,1864.8,1741.5,109010.0,1819.3,0.1,1756.3666666666668,93.65690133513102,34.842843237219626,1799.2145947355386,1105.285405264461,1499.153682386218,92.11711711711712,80.85356894774391,18482850.0,36.491859854452684,0.03823546196427552,4.444213101068758,4.444213101068758,1580.1,1353.15,1591.352,1507.8,1819.3,0,306.0,2.449311837660042,20813794.574297003
2017-05-12,1686.4,1819.3,1822.5,1641.2,109340.0,1819.3,0.1,1752.6666666666667,71.5327369482446,25.951049595796277,1821.5569978042322,1127.493002195768,1516.986665016102,67.86164655017116,88.02831402290506,18373510.0,26.835138387484974,-0.07305007420436427,5.21989528124437,5.21989528124437,1584.875,1353.15,1864.8,1507.8,1819.3,0,307.0,2.4496911836028126,20896174.030646715
2017-05-13,1763.7,1686.4,1770.5,1594.6,75470.0,1819.3,0.1,1756.4666666666665,75.20203014633668,22.95398490765905,1852.8797664302615,1147.6302335697387,1540.4831731098066,81.78706539362278,94.30486302126899,18448980.0,31.98383596497793,0.04583728652751429,5.3469900221845545,5.3469900221845545,1601.425,1353.15,1864.8,1507.8,1819.3,0,308.0,2.4500878925393312,20981726.628772
2017-05-14,1772.6,1763.7,1802.8,1736.1,40640.0,1819.3,0.1,1740.8999999999999,75.5921176152364,19.39128823108416,1878.2167909489804,1174.7332090510195,1562.5895375755392,82.33716475095784,92.33308709117834,18489620.0,31.11916561875877,0.0050462096728467465,5.208907090780681,5.208907090780681,1604.725,1353.15,1853.992,1507.8,1819.3,0,309.0,2.4504857669743365,21067819.9358542
2017-05-15,1708.9,1772.6,1776.7,1656.8,80240.0,1819.3,0.1,1748.4000000000003,67.4177488215519,10.983467767637507,1887.3112992621313,1210.0987007378685,1576.5238673302497,66.82978723404258,94.30215229895133,18409380.0,20.702076564486518,-0.035935913347624804,5.51829552922648,5.51829552922648,1608.875,1353.15,1843.6163199999999,1507.8,1819.3,0,310.0,2.4508678918808986,21151659.14302367
2017-05-16,1729.3,1708.9,1752.6,1653.7,75540.0,1819.3,0.1,1736.9333333333334,68.58922064231237,5.321601404479651,1895.6129939511534,1246.0670060488465,1591.073975203559,69.25346040390288,94.63056999188336,18484920.0,19.600248979874117,0.011937503657323267,5.472189324691111,5.472189324691111,1624.5749999999998,1353.15,1833.6556672,1507.8,1819.3,0,311.0,2.45125397419896,21236487.493783817
2017-05-17,1801.3,1729.3,1842.8,1704.0,94620.0,1819.3,0.1,1746.5,72.36569329959227,4.958512710900479,1914.5454751623865,1273.9745248376134,1611.0955013746486,85.15314472761283,97.7855292781774,18579540.0,21.250673128702214,0.041635343780720424,5.428608742473625,5.428608742473625,1635.0,1353.15,1594.6,1507.8,1819.3,0,312.0,2.4516557493896123,21324271.78498538
2017-05-18,1881.0,1801.3,1980.5,1791.1,73100.0,1881.0,0.1,1803.8666666666668,75.82984970314074,8.41572347344821,1941.1689240289938,1302.491075971006,1636.8006917199202,79.91927346115035,104.32942004402187,18652640.0,24.011075949367093,0.04424582246155562,5.546486977353634,5.546486977353634,1694.675,1411.0,1599.5639999999999,1507.8,1819.3,0,313.0,2.452074207860012,21415212.14550492
2017-05-19,1962.0,1881.0,1969.7,1875.3,98760.0,1962.0,0.1,1881.4333333333332,78.74594728482056,14.149973049494832,1976.997684162021,1329.2323158379795,1667.7720544132612,96.18792499484854,103.62017575516317,18751400.0,30.12335853561481,0.04306220095693769,5.281354523708623,5.281354523708623,1697.625,1411.0,1614.80144,1507.8,1819.3,0,314.0,2.452508862772995,21509264.323666096
2017-05-20,2040.2,1962.0,2048.4,1944.4,89860.0,2040.2,0.1,1961.0666666666666,81.11486130363659,20.799887492581263,2022.1690419541555,1352.8909580458444,1703.2413825643794,98.5177151120752,103.6473060583658,18841260.0,32.02614379084968,0.03985728848114167,5.080252233034301,5.080252233034301,1733.9,1444.95,1629.4293824,1507.8,1819.3,0,315.0,2.4529584404045583,21606250.97513881
2017-05-21,2044.2,2040.2,2094.9,1980.1,78780.0,2044.2,0.1,2015.4666666666665,81.230102396895,22.8924456251319,2063.4927143330633,1374.4072856669366,1735.7136318439623,90.64575645756456,104.44392705419682,18920040.0,31.510550694801847,0.0019605920988139403,5.109281237364095,5.109281237364095,1761.85,1468.2,1654.5676194559999,1507.8,1819.3,0,316.0,2.4534078708171534,21703649.23050066
2017-05-22,2124.4,2044.2,2264.8,1998.6,174380.0,2124.4,0.1,2069.6,83.41531403003987,26.829575226466176,2116.293133146923,1389.456866853077,1772.7313811921565,79.05102954341986,115.99793226461135,19094420.0,27.629918894562937,0.03923295176597197,5.460267946931433,5.460267946931433,1867.15,1553.15,1689.79420989952,1507.8,1819.3,0,317.0,2.4538719509109486,21803984.977911305
2017-05-23,2272.6,2124.4,2286.3,2110.8,114180.0,2272.6,0.1,2147.066666666667,86.53491600184292,35.994906760241236,2199.182835039448,1385.267164960552,1820.337916316713,98.0193725603585,120.24807995999626,19208600.0,33.879234167893955,0.06976087365844474,5.2912118261020975,5.2912118261020975,1878.475,1563.9,1747.294788909568,1507.8,1819.3,0,318.0,2.4543623814745543,21909301.089462966
2017-05-24,2445.3,2272.6,2497.0,2263.3,149260.0,2445.3,0.1,2280.7666666666664,89.10643999530596,49.43820524417947,2315.224403425105,1362.0755965748954,1879.8581147627406,94.27083333333336,128.35178853428224,19357860.0,39.54802259887007,0.07599225556631173,5.248917864240879,5.248917864240879,1989.35,1669.25,1811.97541424042,1507.8,1819.3,0,319.0,2.4548814712191906,22020063.669341575
2017-05-25,2307.2,2445.3,2781.8,2210.5,248440.0,2445.3,0.1,2341.7000000000003,76.52150339236523,44.91092102936017,2371.3148694679035,1385.925130532097,1920.5573419281939,60.02358490566035,159.99094649611925,19109420.0,26.81800692574066,-0.05647568805463554,6.934420357841507,6.934420357841507,2144.325,1811.65,1907.8788562467612,1507.8,1819.3,1,320.0,2.4553760156806868,22127136.070045453
2017-05-26,2244.9,2307.0,2616.5,2051.4,191490.0,2445.3,0.1,2332.4666666666667,71.6080923787077,34.09236929033136,2406.0079568812776,1421.1920431187225,1951.4471188874134,54.77594339622642,188.92730746068216,18917930.0,33.11788425047438,-0.027002427184465883,8.415845136116626,8.415845136116626,2174.375,1811.65,2047.7062392472794,1507.8,1819.3,0,321.0,2.4558584955129588,22232629.91841454
2017-05-27,2052.4,2244.9,2322.4,1868.6,222950.0,2445.3,0.1,2201.5,59.001683829074224,11.51093607335352,2405.4408056702623,1471.5591943297375,1961.061678993374,35.34261147061431,207.84678549920486,18694980.0,16.36899699495379,-0.08574992204552545,10.127011571779617,10.127011571779617,2206.75,1811.65,2781.8,2052.4,1819.3,0,322.0,2.456303751395718,22332119.5948673
2017-05-28,2189.0,2052.4,2300.5,2051.1,125000.0,2445.3,0.1,2162.1,63.863317213272815,3.7166700848226526,2426.0465402514756,1503.4034597485243,1982.7700905178144,47.451467068522284,210.81487224926167,18819980.0,23.49091729662643,0.06655622685636331,9.630647430299756,9.630647430299756,2214.075,1811.65,2763.536,2052.4,1819.3,0,323.0,2.456774115273834,22436462.376765896
2017-05-29,2278.2,2189.0,2337.4,2117.3,92240.0,2445.3,0.1,2173.2000000000003,66.64481298252436,2.565874034694531,2457.2434555839004,1530.2765444160991,2010.9062723732607,55.35856750288092,211.47809566002869,18912220.0,33.313827608403045,0.04074920054819553,9.282683507156031,9.282683507156031,2217.325,1811.65,2745.63728,2052.4,1819.3,0,324.0,2.4572596518543923,22543969.500399265
2017-05-30,2192.6,2278.2,2329.3,2147.1,120960.0,2445.3,0.1,2219.9333333333334,61.73405513412737,-5.521772914170725,2473.077039684926,1558.472960315074,2028.2104369091405,45.3330859157543,209.3868031128838,18791260.0,26.79118718556641,-0.03757352295672023,9.549703690271084,9.549703690271084,2229.3,1811.65,2728.0965344,2052.4,1819.3,0,325.0,2.457728743189299,22649075.933791067
2017-05-31,2303.3,2192.6,2330.6,2168.4,117750.0,2445.3,0.1,2258.0333333333333,65.29550202034591,-4.993343155149205,2504.2984169197084,1575.6515830802914,2054.409442917794,51.70081760371456,206.01631717624923,18909010.0,27.868761450063857,0.05048800510809093,8.944397915002353,8.944397915002353,2231.85,1811.65,2710.906603712,2052.4,1819.3,0,326.0,2.4582167562971002,22758042.707920346
2017-06-01,2412.6,2303.3,2460.8,2303.3,122700.0,2445.3,0.1,2302.8333333333335,68.42067524213175,0.8298115118303144,2537.9010667697703,1614.6689332302292,2088.5228293065757,59.57074025405167,202.5508659493743,19031710.0,28.261562998405097,0.0474536534537402,8.395542814779668,8.395542814779668,2231.85,1811.65,2694.06047163776,2052.4,1819.3,0,327.0,2.458722493713318,22870706.873932254
2017-06-02,2492.6,2412.6,2494.0,2385.6,83030.0,2492.6,0.1,2402.8333333333335,70.51364937896047,7.794588927154308,2584.8509595008395,1640.6090404991608,2127.006369372616,68.33114323258867,195.8258040958476,19114740.0,27.043832823649332,0.03315924728508657,7.85628677268104,7.85628677268104,2246.275,1811.65,2677.551262205005,2052.4,1819.3,0,328.0,2.459240385062798,22986116.13277778
2017-06-03,2545.4,2492.6,2582.8,2449.9,70960.0,2545.4,0.1,2483.5333333333333,71.84018652273436,13.356202322683544,2632.232750064915,1670.5072499350847,2166.853381813319,74.11300919842311,191.33110380328705,19185700.0,24.762278208018824,0.02118270079435125,7.516740150989512,7.516740150989512,2215.375,1811.65,2661.372236960905,2052.4,1819.3,0,329.0,2.459765710091011,23103452.86932941
2017-06-04,2524.1,2545.4,2559.8,2478.2,59480.0,2545.4,0.1,2520.7,70.46300895953009,12.987460354421529,2653.8800020573826,1730.3799979426174,2200.8768692596695,71.78055190538763,183.493167817338,19126220.0,23.476176499364048,-0.008368036457924166,7.269647312600055,7.269647312600055,2206.95,1811.65,2645.516792221687,2052.4,1819.3,0,330.0,2.4602866229333897,23220587.048747938
2017-06-05,2705.0,2524.1,2705.4,2523.9,86690.0,2705.0,0.1,2591.5,74.86927876915504,21.79534717219485,2702.9301134973753,1778.8998865026247,2248.888595996844,91.59001314060446,183.35079868752814,19212910.0,27.330069666729422,0.07166910978170438,6.778218066082371,6.778218066082371,2283.225,1811.65,1868.6,2052.4,1819.3,0,331.0,2.460834399373744,23343225.244707957
2017-06-06,2870.5,2705.0,2931.2,2699.7,192230.0,2870.5,0.1,2699.866666666667,78.08960039523028,34.86077512313895,2786.969420898159,1801.780579101841,2308.0896820923826,94.28759646150952,186.79002735270473,19405140.0,26.30907330810526,0.061182994454713535,6.507229658690289,6.507229658690289,2393.575,2048.95,1885.336,2052.4,1819.3,0,332.0,2.461405036898259,23470713.40352753
2017-06-07,2691.5,2870.5,2880.9,2626.6,122680.0,2870.5,0.1,2755.6666666666665,67.94791474070391,27.845196107991484,2818.062535799282,1851.7374642007183,2344.604950464537,77.44212309429703,191.61216825608295,19282460.0,10.068294278820586,-0.06235847413342621,7.1191591401108285,7.1191591401108285,2401.0249999999996,2052.0,1927.17056,2052.4,1819.3,0,333.0,2.4619486787645806,23593911.12474789
2017-06-08,2798.8,2691.5,2808.4,2623.6,95420.0,2870.5,0.1,2786.933333333333,70.42727514841361,26.818531521482612,2868.342943034307,1885.137056965693,2387.861621848867,87.53999623564845,191.1255848092199,19377880.0,21.307212205270474,0.039866245587962146,6.828840389067453,6.828840389067453,2421.125,2061.1499999999996,1967.3317376,2052.4,1819.3,0,334.0,2.4625070037970316,23720483.932124697
2017-06-09,2811.4,2798.8,2852.1,2786.1,67050.0,2870.5,0.1,2767.2333333333336,70.71376054436546,23.494764306696936,2916.1592496899625,1914.4407503100379,2428.198610244213,88.72576698663657,182.18804303713276,19444930.0,25.234977059111763,0.004501929398313509,6.4803316154632125,6.4803316154632125,2454.85,2062.6499999999996,2005.886468096,2052.4,1819.3,0,335.0,2.463066072562279,23847875.975045435
2017-06-10,2900.3,2811.4,2914.2,2807.4,86520.0,2900.3,0.1,2836.8333333333335,72.72167300900904,23.721193465375308,2970.972306327857,1945.237693672143,2473.1606473638117,96.48903533689358,176.80318282019468,19531450.0,41.31260962775288,0.03162125631358048,6.096030852677126,6.096030852677126,2475.4249999999997,2070.95,2042.89900937216,2052.4,1819.3,0,336.0,2.4636365939864846,23978104.19591951
2017-06-11,2973.4,2900.3,2977.9,2867.3,83030.0,2973.4,0.1,2895.0333333333333,74.28302678741673,25.098562655022903,3035.9603099288347,1965.149690071165,2520.80249047202,99.4771089937253,172.0743840473236,19614480.0,35.8337140246688,0.025204289211460784,5.787125312683244,5.787125312683244,2527.425,2096.85,2078.4310489972736,2052.4,2973.4,0,337.0,2.464216042264882,24110730.86319316
2017-06-12,2656.8,2973.4,2985.1,2483.6,217960.0,2973.4,0.1,2843.5,58.63047307197439,2.1981664988009584,3048.605763462871,1990.9242365371297,2533.7546342365895,60.82338902147975,195.60478518680048,19396520.0,16.618382933895198,-0.10647743324140713,7.362420399984962,7.362420399984962,2559.875,2100.45,2132.399186057437,2052.4,2973.4,0,338.0,2.464749177823652,24235299.69549641
2017-06-13,2713.0,2656.8,2784.8,2647.4,116740.0,2973.4,0.1,2781.066666666667,60.23237298080627,-10.932371024988385,3067.2987302240754,1999.001269775925,2550.8256214521525,66.6829925309171,191.44730053060044,19513260.0,23.734379275745695,0.021153267088226402,7.056664228920032,7.056664228920032,2580.6,2104.1,2200.615251172842,2052.4,2973.4,0,339.0,2.4652896881495936,24361920.276006535
2017-06-14,2467.3,2713.0,2803.7,2349.0,174190.0,2973.4,0.1,2612.366666666667,50.94469204197385,-36.49266157899632,3066.240811939336,2016.0691880606637,2542.870800361471,24.053974772660613,210.2510647784147,19339070.0,7.120218816480701,-0.0905639513453741,8.52150386164693,8.52150386164693,2546.95,2110.0,2263.3740310790145,2052.4,2973.4,0,340.0,2.4657910553124145,24481695.391593162
2017-06-15,2442.5,2467.3,2521.6,2125.6,262790.0,2973.4,0.1,2540.9333333333334,50.10486773183628,-54.323271766028455,3060.6601652930726,2041.409834706927,2533.3116765175214,36.870273414776044,223.51884586567078,19076280.0,1.2393268672801165,-0.010051473270376587,9.151232174643635,9.151232174643635,2491.1,2114.65,2985.1,2052.4,2973.4,1,341.0,2.4662873773827316,24601087.297876053
2017-06-16,2508.6,2442.5,2536.4,2335.3,117210.0,2973.4,0.1,2472.7999999999997,52.35912605761887,-60.44951863229397,3030.21042145521,2117.4795785447895,2530.9581835158524,44.560791157649795,221.91749973240857,19193490.0,0.6419000240712509,0.027062436028659098,8.846268824539925,8.846268824539925,2491.1,2124.05,2967.91,2052.4,2973.4,0,342.0,2.466793423815259,24722945.04084867
2017-06-17,2655.1,2508.6,2690.7,2454.8,95950.0,2973.4,0.1,2535.4,56.996481098929515,-53.64983248484546,3018.8089214044826,2175.4910785955176,2542.7812136571997,61.60558464223386,222.9162497515222,19289440.0,4.309735208611606,0.058399107071673395,8.395776044274122,8.395776044274122,2491.1,2135.2,2951.0638,2052.4,2973.4,0,343.0,2.467321228359851,24849642.49951854
2017-06-18,2539.6,2655.1,2676.0,2488.6,92000.0,2973.4,0.1,2567.7666666666664,52.64555803440398,-55.70282182488384,3006.993898335049,2213.4461016649516,2542.478240927943,48.167539267015705,220.37937476927064,19197440.0,0.614080266233509,-0.04350118639599265,8.677719907437023,8.677719907437023,2491.1,2136.35,2934.554524,2052.4,2973.4,0,344.0,2.4678301874271837,24973302.2520481
2017-06-19,2616.8,2539.6,2617.8,2518.8,81830.0,2973.4,0.1,2603.8333333333335,55.11206844711359,-50.77225374592129,2978.9317070461543,2283.9282929538454,2549.55650369671,57.149505526468914,211.70941942860847,19279270.0,-3.26062846580406,0.030398487950858533,8.090393588681156,8.090393588681156,2491.1,2147.4,2918.37543352,2052.4,2973.4,0,345.0,2.468350143388416,25099740.46616321
2017-06-20,2754.4,2616.8,2800.5,2614.0,111300.0,2973.4,0.1,2636.9333333333334,59.192004102319174,-37.75268856575025,2970.5493522255642,2337.420647774435,2569.0654081065472,73.15881326352532,209.90874661227932,19390570.0,-4.044591534575854,0.052583307856924444,7.620851968206481,7.620851968206481,2491.1,2147.4,2902.5199248496,2052.4,2973.4,0,346.0,2.468889608634945,25230676.292367663
2017-06-21,2677.6,2754.4,2804.4,2624.4,116030.0,2973.4,0.1,2682.933333333334,56.12571515375885,-33.94206494169552,2963.8305648690507,2370.6394351309486,2579.4020359059236,64.22338568935427,207.77240756854508,19274540.0,-0.5164406464796616,-0.027882660470520015,7.759650715885311,7.759650715885311,2445.925,2163.95,2886.981526352608,2052.4,2973.4,0,347.0,2.4694167203811586,25359841.07577068
2017-06-22,2722.8,2677.6,2757.3,2623.2,78300.0,2973.4,0.1,2718.2666666666664,57.52045058282128,-28.240070847768123,2965.0263753983854,2392.4636246016144,2593.0589848672644,69.48225712623622,202.51009274222045,19352840.0,-2.715449478347863,0.016880788766059363,7.437567678207009,7.437567678207009,2491.55,2189.95,2871.753895825556,2052.4,2973.4,0,348.0,2.4699495106977665,25490802.247419693
2017-06-23,2710.4,2722.8,2759.7,2699.5,56940.0,2973.4,0.1,2703.6,56.98525537620955,-25.263042939818547,2966.8681961085076,2407.121803891492,2604.2343196418105,68.03955788248983,192.34508611777613,19295900.0,-3.5925161841075623,-0.004554135448802787,7.096557191476392,7.096557191476392,2508.1,2204.6,2856.830817909045,2052.4,2973.4,0,349.0,2.470479449937563,25621868.119202204
2017-06-24,2590.1,2710.4,2741.6,2540.4,86960.0,2973.4,0.1,2674.433333333334,51.93642676773704,-30.978378108989915,2963.8936438197225,2416.6963561802777,2602.888193961638,54.04304828388598,192.9775799665064,19208940.0,-10.695445298762206,-0.04438459268004724,7.45058414603708,7.45058414603708,2562.6000000000004,2211.1,2842.206201550864,2052.4,2973.4,0,350.0,2.470990217224779,25749739.27320978
2017-06-25,2541.6,2590.1,2660.7,2472.4,86970.0,2973.4,0.1,2614.0333333333333,50.012589790365546,-37.189596490031846,2963.137482818809,2401.112517181191,2597.051223108149,48.40023269342641,192.6434671117559,19121970.0,-14.522095917131908,-0.018725145747268468,7.579613909024076,7.579613909024076,2592.4750000000004,2235.05,2827.8740775198467,2052.4,2973.4,0,351.0,2.4714924321383593,25876514.42784641
2017-06-26,2446.1,2541.6,2584.8,2327.3,165830.0,2973.4,0.1,2525.933333333333,46.37023836297767,-46.30069011668205,2945.881128649386,2375.9288713506135,2582.674916145468,47.21567472009427,197.27607660377336,18956140.0,-7.930593194820847,-0.037574756059175374,8.064922799712742,8.064922799712742,2560.6000000000004,2240.15,2813.82859596945,2446.1,2973.4,0,352.0,2.4719783601244676,26000594.530692503
2017-06-27,2583.8,2446.1,2585.1,2309.6,159260.0,2973.4,0.1,2523.8333333333335,51.818952138444565,-41.763942943360775,2942.0461356316237,2368.9938643683763,2582.782066988757,67.50147318797882,202.86349970350383,19115400.0,-4.76225580538149,0.05629369199950962,7.851362323070819,7.851362323070819,2556.175,2240.15,2800.064024050061,2446.1,2973.4,0,353.0,2.4724851891637787,26129550.237592924
2017-06-28,2577.7,2583.8,2616.9,2490.1,110420.0,2973.4,0.1,2535.866666666667,51.56899967962868,-37.99260892571118,2925.024678321728,2363.9053216782713,2582.2980606088754,66.60282852091925,197.43039258182498,19004980.0,4.474526810683728,-0.0023608638439509555,7.659168738868953,7.659168738868953,2556.175,2269.0,2786.57474356906,2446.1,2973.4,0,354.0,2.472990082550344,26258747.484487616
2017-06-29,2558.4,2577.7,2605.9,2526.5,75320.0,2973.4,0.1,2573.2999999999997,50.735145982996606,-35.65452092809515,2903.81062698689,2359.8193730131093,2580.0220548366015,50.282942603071966,188.99965025455177,18929660.0,4.745138178096217,-0.007487294875276329,7.387415973051585,7.387415973051585,2556.175,2289.85,2773.3552486976787,2446.1,2973.4,0,355.0,2.473490987886528,26387758.902745005
2017-06-30,2480.6,2558.4,2576.3,2469.5,73000.0,2973.4,0.1,2538.9,47.407370699252866,-37.98939967355972,2860.582870654156,2361.077129345844,2570.553287709306,34.5594179466451,183.12824666494095,18856660.0,-1.1161604081958063,-0.030409631019387207,7.382417425822017,7.382417425822017,2545.0,2289.85,2760.4001437237253,2446.1,2973.4,0,356.0,2.4739785923261333,26514639.416665368
2017-07-01,2424.6,2480.6,2529.6,2387.5,66320.0,2973.4,0.1,2487.8666666666663,45.11362173925024,-41.65299464358919,2783.4140075590726,2383.365992440928,2556.652974594134,23.24171382376717,180.19765761744517,18790340.0,-8.681405596776017,-0.022575183423365286,7.432057148290242,7.432057148290242,2545.0,2289.85,2747.704140849251,2446.1,2973.4,0,357.0,2.474456125474924,26640026.38924139
2017-07-02,2536.5,2424.6,2555.3,2375.9,67760.0,2973.4,0.1,2480.5666666666666,50.289401093175876,-35.14743014421893,2775.4325964208183,2379.3174035791817,2554.7336436804067,45.856911883589326,180.14068207334194,18858100.0,-0.12206646716017913,0.04615194258846822,7.101938973914525,7.101938973914525,2540.475,2289.85,2735.262058032266,2446.1,2973.4,0,358.0,2.4749506837396367,26769579.31993983
2017-07-03,2572.5,2536.5,2617.5,2506.3,83420.0,2973.4,0.1,2511.2000000000003,51.86213448055865,-27.372718520647254,2758.3801412007974,2382.3198587992024,2556.425677615606,53.13257881972514,175.21634763953176,18941520.0,-1.692907367777445,0.014192785334121716,6.811131103577522,6.811131103577522,2520.25,2289.85,2723.0688168716206,2446.1,2973.4,0,359.0,2.4754498808303,26900740.898787625
2017-07-04,2617.3,2572.5,2658.7,2570.0,80680.0,2973.4,0.1,2575.4333333333334,53.82016165949438,-18.58610989346535,2760.7361230383312,2394.9638769616686,2562.223232128406,62.186742118027524,169.03660852242234,19022200.0,-4.97749056055765,0.017414965986394693,6.458434589937047,6.458434589937047,2519.75,2319.4,2711.119440534188,2446.1,2973.4,0,360.0,2.475954972589641,27033794.94311072
2017-07-05,2627.9,2617.3,2642.7,2562.0,89720.0,2973.4,0.1,2605.9,54.29387846426097,-11.7660749700755,2760.1537493091787,2414.086250690821,2568.478162401891,70.71761830704294,162.72685077082073,19111920.0,-1.8561398267104803,0.004049975165246522,6.192277132722734,6.192277132722734,2519.75,2319.4,2699.409051723504,2446.1,2627.9,0,361.0,2.4764606863053333,27167639.986560848
2017-07-06,2614.2,2627.9,2634.8,2581.8,60160.0,2973.4,0.1,2619.7999999999997,53.529585869419364,-8.06011981149689,2761.936875044905,2422.8631249550954,2572.8326231255205,67.67385025549878,154.88921857290498,19051760.0,-3.988541207580445,-0.005213288176871389,5.924918467328628,5.924918467328628,2536.325,2319.4,2687.9328706890337,2446.1,2627.9,0,362.0,2.476963333164612,27301491.4719373
2017-07-07,2513.9,2614.2,2617.5,2484.7,90450.0,2973.4,0.1,2585.3333333333335,48.181990126849655,-12.008520856129351,2755.6032361961666,2415.076763803833,2567.2199923516614,47.29166666666671,153.31141724626892,18961310.0,-7.249852420306965,-0.03836737816540425,6.098548758752095,6.098548758752095,2536.325,2344.55,2676.686213275253,2446.1,2627.9,0,363.0,2.4774494367281714,27432443.359923717
2017-07-08,2564.9,2513.9,2568.7,2480.6,54510.0,2973.4,0.1,2564.3333333333335,50.86961574826947,-10.86455998851185,2755.863080752417,2417.346919247583,2566.9990406991224,72.71432640273433,148.6534588715354,19015820.0,-0.972935407899302,0.02028720315048327,5.795682438751429,5.795682438751429,2491.15,2388.1,2665.664489009748,2446.1,2627.9,0,364.0,2.477942562222221,27565541.442418374
2017-07-09,2511.4,2564.9,2576.7,2509.6,39160.0,2973.4,0.1,2530.0666666666666,48.053923500316,-13.232956987783957,2753.0499297527494,2409.6200702472506,2561.703893965873,57.805786307648305,142.82821180928286,18976660.0,-1.1882278879445949,-0.020858513002456225,5.6871948637924215,5.6871948637924215,2491.15,2426.85,2654.863199229553,2446.1,2627.9,0,365.0,2.4784263397612865,27697254.601350807
2017-07-10,2344.0,2511.4,2530.3,2271.8,123800.0,2973.4,0.1,2473.4333333333334,40.500065616469506,-24.917347891155536,2742.685880296962,2378.9441197030383,2540.970189778647,18.661152752649233,151.0904823943341,18852860.0,-4.173991251379744,-0.06665604841920847,6.445839692591044,6.445839692591044,2465.125,2426.85,2644.277935244962,2446.1,2627.9,0,366.0,2.478881754673548,27823406.436017476
2017-07-11,2324.3,2344.0,2412.8,2265.5,146630.0,2973.4,0.1,2393.233333333333,39.70897882773165,-32.34564759215377,2743.8710253062495,2342.4289746937507,2520.3349336092524,14.95422177009161,150.81973365188168,18706230.0,-10.043347008282375,-0.008404436860068198,6.488823888993747,6.488823888993747,2498.5249999999996,2426.85,2633.904376540063,2446.1,2627.9,0,367.0,2.47933289284598,27949194.529817168
2017-07-12,2403.1,2324.3,2424.8,2262.1,109520.0,2973.4,0.1,2357.133333333333,44.38826418502679,-30.357145876929167,2718.8283118256913,2335.5016881743086,2509.1697018369427,35.55219364599093,151.66832410531873,18815750.0,-6.773480234317411,0.033902680376887595,6.3113613293378865,6.3113613293378865,2496.825,2426.85,2623.7382890092617,2446.1,2627.9,0,368.0,2.47979634559116,28078262.86018162
2017-07-13,2362.4,2403.1,2436.7,2335.0,88170.0,2973.4,0.1,2363.266666666667,42.55133280293472,-30.12763676366985,2694.800869765817,2324.7291302341837,2495.1916349953294,25.28996469994962,148.09915809779594,18727580.0,-7.661038148843026,-0.016936457076276445,6.269012787749574,6.269012787749574,2492.825,2426.85,2613.7755232290765,2446.1,2627.9,0,369.0,2.48025208678295,28206220.27556113
2017-07-14,2234.2,2362.4,2370.5,2165.4,114410.0,2973.4,0.1,2333.233333333333,37.31331568568512,-36.52803998860159,2708.4604071777608,2275.4795928222397,2470.335288805298,13.946888303263686,152.17064680509625,18613170.0,-9.933080706280743,-0.05426684727395881,6.810967988769863,6.810967988769863,2442.5,2426.85,2604.012012764495,2446.1,2627.9,0,370.0,2.480684773881922,28329635.733595293
2017-07-15,1975.1,2234.2,2237.1,1974.0,155320.0,2973.4,0.1,2190.566666666667,29.428580225327693,-55.018901512885094,2774.445846041308,2152.844153958692,2423.1700232047933,0.16065430115377674,160.09417203330366,18457850.0,-18.539140476779675,-0.11596992211977442,8.105623615680404,8.105623615680404,2342.475,2426.85,2594.4437725092052,2446.1,2627.9,0,371.0,2.481067693666562,28442482.056523565
2017-07-16,1914.1,1975.1,2044.4,1809.0,189640.0,2973.4,0.1,2041.1333333333332,27.932090202362232,-67.35082814429204,2829.6074815236334,2044.4825184763667,2374.6871638519556,12.369071436977748,165.47315974521055,18268210.0,-24.537748866548398,-0.0308845121765986,8.644958975247404,8.644958975247404,2249.7749999999996,2397.05,2569.626021608837,1914.1,2627.9,0,372.0,2.4814373431398113,28552802.47461578
2017-07-17,2233.4,1914.1,2233.8,1913.8,176890.0,2973.4,0.1,2040.8666666666668,43.988127664143015,-50.75263002080949,2815.586045168536,2023.463954831464,2361.231243485103,49.94704013181125,176.51079119198124,18445100.0,-13.181729834791057,0.16681469097748303,7.903232344944086,7.903232344944086,2238.6,2397.05,2523.988460312307,1914.1,2627.9,0,373.0,2.481867289714028,28677112.89483619
2017-07-18,2320.2,2233.4,2400.7,2164.6,202620.0,2973.4,0.1,2155.8999999999996,47.41771147426596,-31.613626471058765,2798.020047397592,2015.2799526024082,2357.323506010331,61.31702051097517,180.76716324969684,18647720.0,-11.351392656554477,0.038864511507119115,7.791016431760058,7.791016431760058,2227.0,2397.05,2481.0891526935684,1914.1,2627.9,0,374.0,2.4823114431425752,28805174.326734394
2017-07-19,2282.6,2320.2,2412.4,2243.1,154320.0,2973.4,0.1,2278.733333333333,46.100900191760026,-19.752257024896437,2781.2952270327623,2004.4247729672381,2350.2069816283947,57.35044805037537,179.94808016043277,18493400.0,-13.139769397617876,-0.01620549952590289,7.883469734532234,7.883469734532234,2199.075,2397.05,2440.763803531954,1914.1,2627.9,0,375.0,2.482748220785563,28932132.049510814
2017-07-20,2866.0,2282.6,2932.8,2282.1,310340.0,2973.4,0.1,2489.6,63.18443353312985,26.601628389987454,2851.0254595344923,1973.2345404655077,2399.3301262352143,94.05588182950702,213.57321729183045,18803740.0,9.632009792670805,0.2555857355647069,7.451961524488153,7.451961524488153,2370.9,2397.05,1809.0,1914.1,2627.9,1,376.0,2.4832741590024785,29079988.707432427
2017-07-21,2675.1,2866.0,2874.0,2622.5,193760.0,2973.4,0.1,2607.9,56.83629843485055,42.67015972730105,2878.3082441193305,1971.001755880669,2425.5939237366224,77.06887346502934,216.28227319955684,18609980.0,6.412347348740993,-0.06660851360781583,8.085016380679482,8.085016380679482,2370.9,2397.05,1831.476,1914.1,2627.9,0,377.0,2.4837718289070487,29222118.151917364
2017-07-22,2836.5,2675.1,2876.7,2658.6,121920.0,2973.4,0.1,2792.5333333333333,60.453909746238494,61.29978792656926,2925.7852972454943,1953.5247027545051,2464.727835761706,91.43085958355577,216.4121108281599,18731900.0,10.589106787788992,0.060334193114276236,7.629547358651855,7.629547358651855,2370.9,2397.05,1853.50248,1914.1,2627.9,0,378.0,2.4842916914984947,29370057.79031744
2017-07-23,2756.6,2836.5,2856.7,2675.6,108230.0,2973.4,0.1,2756.066666666667,57.86824926627389,65.01914923245369,2951.3985613064856,1946.3214386935138,2492.5251847367817,84.32105356825055,213.88981719757706,18623670.0,9.763478537867318,-0.028168517539220894,7.759189479706054,7.759189479706054,2370.9,2397.05,1875.0884304,1914.1,2627.9,0,379.0,2.484799265597868,29515900.20188962
2017-07-24,2763.4,2756.6,2798.9,2715.7,83010.0,2973.4,0.1,2785.5,58.032763807296035,64.58286870369797,2972.34736031464,1939.98263968536,2518.3227861904215,84.92614344189357,204.554830254893,18706680.0,17.892491467576797,0.002466806936080701,7.402288132550227,7.402288132550227,2370.9,2397.05,1896.242661792,1914.1,2627.9,0,380.0,2.48530683211561,29662465.583920095
2017-07-25,2582.6,2763.4,2779.1,2472.6,205880.0,2973.4,0.1,2700.8666666666663,52.19679673930822,49.44539177364614,2967.4389839145542,1940.361016085446,2524.444425600858,68.83787150738563,211.8366280938292,18500800.0,11.113023275824967,-0.06542664833176526,8.20245597823237,8.20245597823237,2397.1000000000004,2397.05,1916.97380855616,1914.1,2627.9,0,381.0,2.4857866964705706,29803277.74178669
2017-07-26,2559.2,2582.6,2631.7,2441.5,135500.0,2973.4,0.1,2635.0666666666666,51.47528983148445,35.819225538207476,2961.806869140123,1940.493130859877,2527.754480305538,66.75565047161415,210.29115465855566,18365300.0,6.49577628896009,-0.009060636567799873,8.217066061994203,8.217066061994203,2459.8,2397.05,1937.290332385037,1914.1,2627.9,0,382.0,2.4862620203923247,29943690.948275592
2017-07-27,2691.9,2559.2,2712.9,2547.7,103830.0,2973.4,0.1,2611.233333333333,55.252772838353096,33.734923778883,2980.874536672374,1939.2254633276266,2543.387386943106,78.56380138814735,207.07035789723025,18469130.0,13.947680325093126,0.05185214129415461,7.692349563402439,7.692349563402439,2479.425,2397.05,1957.2005257373362,1914.1,2627.9,0,383.0,2.486756350745189,30089254.752531193
2017-07-28,2806.8,2691.9,2843.8,2683.6,138910.0,2973.4,0.1,2685.9666666666667,58.28112220438785,37.78125848136437,3012.9975213956136,1931.2924786043864,2568.474302472334,88.78804057661506,203.72247519028525,18608040.0,25.62886044221647,0.042683606374679606,7.2581756872696745,7.2581756872696745,2489.175,2397.05,1976.7125152225894,1914.1,2627.9,0,384.0,2.487266204495136,30239211.513426468
2017-07-29,2733.5,2806.8,2812.1,2699.4,84490.0,2973.4,0.1,2744.066666666667,55.691722310836155,33.36144633565945,3035.8631214511583,1930.6368785488417,2584.191035570207,82.26552767396332,197.2208698195506,18523550.0,38.39805579464331,-0.026115148924041653,7.214957739877467,7.214957739877467,2515.0,2397.05,1995.8342649181377,1914.1,2627.9,0,385.0,2.487764643140857,30387192.70769584
2017-07-30,2766.5,2733.5,2773.1,2621.7,82720.0,2973.4,0.1,2768.933333333334,56.62604078387666,30.574691397393757,3066.3039986288236,1942.4460013711764,2601.55379408733,83.6800785083415,193.94795054672554,18606270.0,44.53267854344079,0.012072434607645954,7.010589211882362,7.010589211882362,2515.0,2397.05,2014.573579619775,1914.1,2627.9,0,386.0,2.488266844009107,30536800.44864663
2017-07-31,2883.3,2766.5,2916.3,2723.1,91120.0,2973.4,0.1,2794.433333333333,59.852884971299815,34.23582569953597,3111.0052394241507,1953.644760575849,2628.386766079013,93.55636552980995,193.89452550767373,18697390.0,29.09913136921286,0.042219410807880164,6.7247433672414845,6.7247433672414845,2524.9,2397.05,2032.9381080273795,1914.1,2627.9,0,387.0,2.4887843655119672,30690837.034158956
2017-08-01,2747.0,2883.3,2946.0,2659.6,123170.0,2973.4,0.1,2798.933333333333,54.73541783044458,25.51616826712103,3132.242402521125,1966.7975974788742,2639.6832645476784,71.6887181675914,200.50205939998276,18574220.0,18.394965951211113,-0.047272222800263664,7.298946465234174,7.298946465234174,2535.625,2397.05,2050.935345866832,1914.1,2627.9,0,388.0,2.4892818266316974,30840792.914593708
2017-08-02,2720.5,2747.0,2773.8,2668.9,81820.0,2973.4,0.1,2783.6,53.77277076642335,16.442592260745784,3148.05146813592,1986.7985318640804,2647.3800964955185,66.0340412712758,193.67334087141256,18492400.0,19.184263559099275,-0.009646887513651281,7.119034768293055,7.119034768293055,2535.625,2397.05,2086.737932032159,1914.1,2627.9,0,389.0,2.4897745066587187,30990318.251631368
2017-08-03,2810.0,2720.5,2822.9,2717.6,68100.0,2973.4,0.1,2759.1666666666665,56.552035596079904,14.988211805475402,3164.873408097508,2027.5565919024914,2662.867706353088,73.0426164519326,187.3609593805974,18560500.0,-1.9539427773900906,0.03289836427127368,6.66764980002126,6.66764980002126,2535.625,2377.5,2121.1084147508723,1914.1,2627.9,0,390.0,2.4902789654436486,31143449.417438794
2017-08-04,2878.5,2810.0,2892.7,2779.5,68760.0,2973.4,0.1,2803.0,58.60342765745964,17.011304433326387,3145.3604608113296,2137.40953918867,2683.404115271842,86.62041625371656,182.063747996269,18629260.0,7.603454076483125,0.02437722419928834,6.324952162455063,6.324952162455063,2562.175,2377.5,2154.104078160837,1914.1,2627.9,0,391.0,2.4907919260257403,31299427.533135403
2017-08-05,3262.8,2878.5,3344.0,2875.9,159400.0,3262.8,0.1,2983.766666666667,67.79133253801689,41.22280199105646,3164.060567612325,2253.5794323876753,2738.584675722143,91.0027700831025,202.49490885367837,18788660.0,15.0290851401375,0.13350703491401772,6.206169818979967,6.206169818979967,2779.675,2576.5,2185.7799150344035,1914.1,2627.9,0,392.0,2.4913531802262923,31468121.086142674
2017-08-06,3232.0,3262.8,3295.1,3166.5,60660.0,3262.8,0.1,3124.433333333334,66.51709499377472,51.48768783345419,3213.5143147829344,2303.9856852170656,2785.576611367653,87.59002770083103,197.2167010784156,18728000.0,17.245882609011105,-0.0094397450042909,6.102001889802463,6.102001889802463,2779.675,2576.5,2255.2731201323395,3232.0,2627.9,0,393.0,2.491909668523645,31636541.469946038
2017-08-07,3401.9,3232.0,3425.1,3198.5,88110.0,3401.9,0.1,3298.9,69.88030608242782,65.16385963841549,3302.0925978970504,2323.5774021029497,2844.2740769516863,97.64131760878408,199.31550814424307,18816110.0,23.105594557429253,0.05256806930693081,5.858946710492462,5.858946710492462,2820.225,2617.05,2320.596732924399,3232.0,2627.9,0,394.0,2.4924852543496607,31810636.50768317
2017-08-08,3429.4,3401.9,3494.9,3357.1,106940.0,3429.4,0.1,3354.433333333333,70.39858960036251,71.02507492725744,3366.1811930056842,2374.168806994316,2900.00035533724,93.78203911144865,194.92154327679714,18923050.0,32.78866258808953,0.008083717922337419,5.68383808470278,5.68383808470278,2864.6,2651.95,2408.9569942904473,3232.0,3429.4,0,395.0,2.49306294845636,31986221.588362187
2017-08-09,3348.8,3429.4,3437.1,3251.0,97060.0,3429.4,0.1,3393.366666666667,66.77200120378598,64.62020231067851,3432.3708308391347,2356.2591691608645,2942.743178638455,84.57559121621622,194.29143304274018,18825990.0,30.85339168490155,-0.023502653525398043,5.801822534721099,5.801822534721099,2864.6,2651.95,2517.5512948614023,3232.0,3429.4,0,396.0,2.4936302496375493,32160152.46965659
2017-08-10,3425.7,3348.8,3453.8,3322.9,71000.0,3429.4,0.1,3401.2999999999997,68.44237840947973,60.76693697359809,3506.938934848901,2356.7510651510993,2988.7390663871734,92.07512597343103,189.7634735396873,18896990.0,27.259556447119127,0.02296344959388419,5.539407231797511,5.539407231797511,2866.925,2651.95,2615.286165375262,3232.0,3429.4,0,397.0,2.494205417488564,32337029.60567208
2017-08-11,3654.4,3425.7,3706.5,3409.8,97560.0,3654.4,0.1,3476.3000000000006,72.81866417684867,68.26398540891927,3625.9187210251052,2319.5612789748952,3052.135345778871,95.19727138643069,197.40179685828107,18994550.0,30.19809035200228,0.06676007823218622,5.4017567003688995,5.4017567003688995,3011.1000000000004,2757.75,2703.247548837736,3232.0,3429.4,0,398.0,2.494804885307358,32521089.8168921
2017-08-12,3871.6,3654.4,3967.3,3611.4,123590.0,3871.6,0.1,3650.566666666666,76.19501564539213,81.5926923923634,3781.123211863516,2275.8567881364843,3130.1795985618355,92.88793103448275,208.72309708268958,19118140.0,41.63526614230839,0.05943520140105063,5.3911327896138435,5.3911327896138435,3219.675,2888.15,2823.6378429772076,3232.0,3429.4,0,399.0,2.4954259133823844,32711741.292221036
2017-08-13,4062.6,3871.6,4189.4,3847.3,158590.0,4062.6,0.1,3862.866666666667,78.70056605242826,96.01986808856554,3959.128752193902,2227.7712478060976,3218.9815415559465,91.71133481500851,218.25001871964028,19276730.0,46.8498102295319,0.04933360884388893,5.372175914922471,5.372175914922471,3374.45,2999.2,2983.7505449603987,3232.0,3429.4,0,400.0,2.4960647127313815,32908108.614228938
2017-08-14,4327.9,4062.6,4336.7,3978.9,128460.00000000001,4327.9,0.1,4087.3666666666663,81.59785758685148,114.90205002273285,4166.371530998497,2195.0584690015025,3324.5928233125233,99.47528471766739,228.21787452538024,19405190.0,50.10231332154127,0.06530300792595867,5.273178089266856,5.273178089266856,3530.5,3072.85,3176.6544577667346,3232.0,3429.4,0,401.0,2.496727173818708,33111814.345280312
2017-08-15,4161.7,4327.9,4436.5,3837.1,211580.0,4327.9,0.1,4184.066666666667,74.73902769148978,107.78750142910894,4290.912264261102,2230.767735738899,3404.317316330378,84.45349626612355,254.7308834878531,19193610.0,51.499817983254445,-0.03840199634926866,6.120837241700581,6.120837241700581,3628.25,3122.75,3385.462655368722,3232.0,3429.4,0,402.0,2.49737314544724,33312469.02844733
2017-08-16,4387.4,4161.7,4398.1,3938.6,112900.0,4387.4,0.1,4292.333333333333,77.5044026674339,109.51613510575697,4450.7804215998585,2240.449578400142,3497.944238584628,97.14352201989642,269.3572489530065,19306510.0,61.27182503216319,0.05423264531321337,6.139336485230581,6.139336485230581,3641.375,3122.75,3595.6701242949775,3232.0,3429.4,0,403.0,2.498038662197345,33519491.77034397
2017-08-17,4278.9,4387.4,4487.5,4194.1,127480.0,4387.4,0.1,4275.999999999999,73.3474792718116,95.11941360213359,4566.329272214287,2272.1107277857122,3572.320977767044,87.78688524590162,271.074588313506,19179030.0,52.27402135231315,-0.024729908373980036,6.335146610425718,6.335146610425718,3666.875,3148.25,3763.836099435982,3232.0,3429.4,0,404.0,2.498693224185706,33724902.34798212
2017-08-18,4105.4,4278.9,4362.7,3978.3,144400.0,4387.4,0.1,4257.233333333333,67.14567421052521,67.00538726980778,4626.746429498718,2348.8835705012825,3623.090408455897,76.29064283941422,279.169260576827,19034630.0,42.62289386833419,-0.04054780434223748,6.800050191865033,6.800050191865033,3684.85,3148.25,3908.5688795487854,3232.0,3429.4,0,405.0,2.4993304513880163,33926953.868043765
2017-08-19,4150.5,4105.4,4189.7,3957.5,113720.0,4387.4,0.1,4178.266666666666,67.90534832930543,45.565226214930306,4680.305459809926,2433.724540190075,3673.319893364859,74.4890234670704,275.81431339276793,19148350.0,27.206693637366676,0.010985531251522573,6.6453273917062505,6.6453273917062505,3706.575,3148.25,4487.5,3232.0,3429.4,0,406.0,2.4999708305713257,34131065.49603581
2017-08-20,4066.6,4150.5,4182.3,4034.4,70160.0,4387.4,0.1,4107.5,64.89897631378733,21.095712292464782,4715.6964675437985,2516.6635324562003,3710.775141615825,67.3467804499612,266.6775767218559,19078190.0,25.823019801980195,-0.020214431996145032,6.557752833370775,6.557752833370775,3756.975,3148.25,4476.9,3232.0,3429.4,0,407.0,2.500602102971075,34333951.65902843
2017-08-21,4005.1,4066.6,4097.3,3966.9,90650.0,4387.4,0.1,4074.066666666667,62.70740598057723,-2.6083746913405434,4714.587431238089,2643.582568761911,3738.8060805095556,60.98665588354225,256.94346409886623,18987540.0,17.731267820923595,-0.015123198740963018,6.4154069585994415,6.4154069585994415,3839.95,3148.25,4466.512,3232.0,3429.4,0,408.0,2.5012263080207897,34536129.24948763
2017-08-22,4089.7,4005.1,4142.7,3612.2,169140.0,4387.4,0.1,4053.7999999999997,64.48412992623486,-15.26039379263716,4698.051230332024,2797.0387696679754,3772.2245490324553,67.82854832187626,276.4832166632329,19156680.0,19.254096926576068,0.021123068088187535,6.760476726000267,6.760476726000267,3802.225,3148.25,4456.33176,3232.0,3429.4,0,409.0,2.5018575739256343,34741429.351370186
2017-08-23,4141.1,4089.7,4255.6,4070.5,96650.0,4387.4,0.1,4078.633333333333,65.55778762330485,-22.40591602598562,4674.868728521195,2953.3312714788044,3807.3555443626974,70.25588184784479,269.9558440444306,19253330.0,23.659221213569044,0.012568159033670145,6.5189404758260014,6.5189404758260014,3802.225,3148.25,4422.5664896,3232.0,3429.4,0,410.0,2.502492604790647,34948988.21378805
2017-08-24,4318.4,4141.1,4364.1,4111.7,72360.0,4387.4,0.1,4183.066666666667,69.03509754403494,-17.639781128670336,4658.094941645073,3114.0950583549266,3856.0264448995836,84.30917695091394,268.70185518411415,19325690.0,26.058907668505704,0.04281471106710755,6.222254890332396,6.222254890332396,3802.225,3148.25,4390.151830016,3232.0,3429.4,0,411.0,2.5031428828167273,35162005.62827152
2017-08-25,4364.4,4318.4,4461.7,4292.6,82900.0,4387.4,0.1,4274.633333333333,69.88461928256497,-13.99655360588963,4684.077744307757,3198.2722556922417,3904.4429739567663,85.94909256934136,261.5874369566774,19408590.0,19.4286339754816,0.01065209336791395,5.993663205862831,5.993663205862831,3811.7,3148.25,3612.2,3232.0,3429.4,0,412.0,2.503796161874381,35377160.63789514
2017-08-26,4352.3,4364.4,4379.3,4263.3,46160.0,4387.4,0.1,4345.033333333333,69.34568421918647,-14.924031968955205,4684.629221749819,3309.75077825018,3947.0960240561217,84.55386724551583,251.1883343169147,19362430.0,12.416055377621662,-0.0027724314911555803,5.771392925968217,5.771392925968217,3805.25,3148.25,3629.1899999999996,3232.0,3429.4,0,413.0,2.504447222285534,35593016.000024505
2017-08-27,4345.8,4352.3,4408.2,4321.1,42520.0,4387.4,0.1,4354.166666666667,69.03768209774907,-18.276326478546594,4690.213894599799,3398.556105400201,3985.0678312888717,83.81126470924256,239.4677390085636,19319910.0,6.9709053315610765,-0.0014934632263401415,5.510325809023968,5.510325809023968,3807.575,3148.25,3645.8401999999996,3232.0,3429.4,0,414.0,2.505096567204297,35809710.0643263
2017-08-28,4390.3,4345.8,4403.1,4195.2,75490.0,4390.3,0.1,4362.8,70.0194420640616,-19.676359655022964,4689.2145510735,3495.6454489265006,4023.661371166122,88.89523591911346,237.21290050795193,19395400.0,1.4418078051711118,0.010239771733627778,5.403113694006148,5.403113694006148,3819.75,3148.25,3662.1573959999996,3232.0,3429.4,0,415.0,2.505748751859993,36028532.477795914
2017-08-29,4597.3,4390.3,4647.8,4350.2,100800.0,4597.3,0.1,4444.466666666667,74.12887735253933,-9.364144422790446,4684.898305683602,3624.811694316399,4078.2936215312534,95.1235998455002,241.52626475738398,19496200.0,10.466876516808044,0.04714939753547598,5.253654639840428,5.253654639840428,3921.825,3228.4,3678.1482480799996,3232.0,3429.4,0,416.0,2.5064177502385614,36253489.580582224
2017-08-30,4583.0,4597.3,4644.1,4491.8,68470.0,4597.3,0.1,4523.533333333334,73.38058044009173,-6.353008378076936,4657.5578338226205,3767.8821661773804,4126.360895671134,93.7427578215527,235.1529601318566,19427730.0,4.458221270000465,-0.0031105213929916165,5.130983201655173,5.130983201655173,3945.925,3228.4,3716.9343181567997,3232.0,3429.4,0,417.0,2.507084383302174,36479178.011850156
2017-08-31,4735.1,4583.0,4765.1,4580.1,72290.0,4735.1,0.1,4638.466666666666,76.13952785734259,2.5578430006135022,4689.168898800692,3844.341101199306,4184.336048464359,97.39786625032527,231.57060583672396,19500020.0,10.66161864030477,0.03318786820859709,4.890511411305441,4.890511411305441,4191.8,3287.05,3754.168945430528,3232.0,3429.4,0,418.0,2.5077625757365967,36709613.504944466
2017-09-01,4921.9,4735.1,4925.2,4690.2,102010.0,4921.9,0.1,4746.666666666667,79.01603080379876,16.90804319328197,4790.45542040263,3848.084579597371,4254.580234324896,99.74866717440973,231.81556256267226,19602030.0,19.88843961611536,0.039450064412578145,4.709879570139017,4.709879570139017,4290.15,3367.1,3814.8248087046964,3232.0,4921.9,0,419.0,2.5084546608601035,36945546.58483807
2017-09-02,4573.8,4921.9,4976.5,4448.6,160770.0,4921.9,0.1,4743.599999999999,63.62335302821918,-0.2593445884781431,4813.000537731715,3876.6594622682846,4284.982116770144,70.48303159129225,252.96445095105278,19441260.0,10.198771232381645,-0.07072472012840558,5.530728299249043,5.530728299249043,4349.8,3392.75,3903.6548240083207,3232.0,4921.9,0,420.0,2.509117039652486,37174315.799454264
2017-09-03,4612.9,4573.8,4719.8,4397.7,102820.0,4921.9,0.1,4702.866666666666,64.46081265330028,-11.570612551204647,4841.455768877338,3876.7042311226614,4316.212391363463,73.34897016785162,257.90270445454905,19544080.0,13.433826784045632,0.008548690366872114,5.590901698596308,5.590901698596308,4349.8,3392.75,4010.9393416074886,3232.0,4921.9,0,421.0,2.509781585366226,37405144.25570076
2017-09-04,4267.5,4612.9,4621.0,4098.6,170400.0,4921.9,0.1,4484.733333333334,52.87947755271373,-43.12994267705835,4840.248190716914,3888.491809283086,4311.573115995514,48.031957780546804,276.79536842208125,19373680.0,6.551646650520588,-0.0748769754384443,6.486124626176479,6.486124626176479,4343.625,3392.75,4976.5,3232.0,4921.9,0,422.0,2.5104147393416234,37628119.234782025
2017-09-05,4409.1,4267.5,4496.7,4004.6,158410.0,4921.9,0.1,4429.833333333333,56.34244097936734,-54.54846951923827,4841.637131017118,3889.2728689828823,4320.861390662608,41.61950817985394,292.17427067764686,19532090.0,7.80986380419103,0.033181019332161776,6.626619280071824,6.626619280071824,4341.85,3392.75,4958.942,3232.0,4921.9,0,423.0,2.5110594667338844,37855873.875756286
2017-09-06,4618.7,4409.1,4660.0,4401.5,110930.0,4921.9,0.1,4431.766666666666,60.920671052140705,-48.28062487446675,4869.192402561128,3895.697597438874,4349.226972504264,63.1855129128511,289.7689656292435,19643020.0,11.53316751587741,0.04753804631330638,6.273820893958117,6.273820893958117,4392.25,3445.15,4920.76832,3232.0,4921.9,0,424.0,2.5117211088652707,38090079.64839374
2017-09-07,4635.6,4618.7,4690.5,4493.2,70530.0,4921.9,0.1,4554.466666666666,61.27330869297437,-43.44349850443933,4890.181160864104,3927.728839135896,4376.500594170525,64.92437493569301,283.16403951286895,19713550.0,7.345313078918135,0.0036590382575185654,6.108465776013222,6.108465776013222,4392.450000000001,3570.55,4884.1215872,3232.0,4921.9,0,425.0,2.512383029010716,38325823.51351835
2017-09-08,4326.5,4635.6,4699.6,4130.9,180360.0,4921.9,0.1,4526.933333333333,52.026295867302714,-60.46223067244233,4886.01649307839,3949.493506921608,4371.738632820951,33.120691429159386,303.5594652619498,19533190.0,-0.8683896984694262,-0.06667960997497635,7.016282567016059,7.016282567016059,4392.450000000001,3609.8,4848.940723712,3232.0,4921.9,0,426.0,2.513017032394762,38554563.31694705
2017-09-09,4335.1,4326.5,4402.1,4185.3,77090.0,4921.9,0.1,4432.400000000001,52.242248314686854,-69.87496404254568,4873.053631709344,3989.306368290657,4368.249239218956,34.00555612717362,297.362360600382,19610280.0,-0.39519334604691353,0.0019877499133249543,6.859411792124333,6.859411792124333,4392.450000000001,3629.3,4815.16709476352,3232.0,4921.9,0,427.0,2.5136506991968957,38784570.13787118
2017-09-10,4245.9,4335.1,4338.1,4032.1,108080.0,4921.9,0.1,4302.5,49.7411992251178,-80.10908202580677,4849.704147784393,4036.735852215606,4356.596930721912,24.827657166375108,297.97933484321186,19502200.0,-2.298771227391977,-0.020576226615303117,7.018048819878279,7.018048819878279,4392.450000000001,3709.0,4782.7444109729795,3232.0,4921.9,0,428.0,2.514275198645133,39013139.64933165
2017-09-11,4217.9,4245.9,4364.4,4134.6,88760.0,4921.9,0.1,4266.3,48.94902220852075,-86.23331276799064,4837.216832077671,4062.0431679223293,4343.387699224587,21.946702335631205,293.10938235441097,19413440.0,-3.9268387126164623,-0.006594597140771152,6.949178082799758,6.949178082799758,4328.275,3709.0,4751.61863453406,3232.0,4921.9,0,429.0,2.5148960387490464,39241930.59947961
2017-09-12,4158.9,4217.9,4387.8,4075.0,107040.0,4921.9,0.1,4207.566666666667,47.24172019244421,-91.2423079292416,4835.340761394191,4065.6992386058087,4325.817442155579,15.876118942277982,294.51585504338163,19306400.0,-9.536032018793652,-0.013988003508855096,7.081580587255805,7.081580587255805,4323.225,3709.0,4721.737889152698,3232.0,4921.9,0,430.0,2.5155103309204456,39470033.82379017
2017-09-13,3870.3,4158.9,4174.6,3752.0,186540.0,4921.9,0.1,4082.3666666666663,39.908984832184956,-109.7342911670861,4886.284175196241,3969.9458248037577,4282.4348286169525,9.661086157615369,303.664722540283,19119860.0,-15.5509491599389,-0.06939334920291407,7.846025438345425,7.846025438345425,4260.075000000001,3709.0,4693.05237358659,3232.0,4921.9,0,431.0,2.51609568775213,39690428.745358594
2017-09-14,3243.1,3870.3,3930.7,3219.0,317590.0,4921.9,0.1,3757.433333333333,29.274360888204612,-157.06632412669887,5062.981288913741,3681.118711086259,4183.4505592248615,1.371266002844945,332.8100995016913,18802270.0,-31.509366222466266,-0.16205462108880453,10.262097977296145,10.262097977296145,4028.525,3709.0,4636.589231171394,3243.1,4921.9,1,432.0,2.516611549375551,39890236.136399396
2017-09-15,3713.8,3243.1,3824.4,2979.9,448550.0,4921.9,0.1,3609.066666666667,41.80705939042894,-149.5701191177377,5088.382858963074,3591.867141036926,4138.721934536779,36.75748772913955,369.3593781087134,19250820.0,-24.54539913448058,0.14513891030187165,9.945591526434201,9.945591526434201,3908.975,3709.0,4523.182092677683,3243.1,4921.9,1,433.0,2.517178890405889,40107295.90562621
2017-09-16,3698.9,3713.8,3893.7,3551.8,169360.0,4921.9,0.1,3551.933333333333,41.55602773370774,-138.7505571964819,5106.486758704347,3509.073241295654,4096.834131247562,41.32421403528938,367.3979939580909,19081460.0,-19.12851458306004,-0.00401206311594593,9.932628455975856,9.932628455975856,3908.975,3762.1,4368.8538834099145,3243.1,4921.9,0,434.0,2.517743649721517,40324720.10552505
2017-09-17,3689.6,3698.9,3796.6,3485.8,96070.0,4921.9,0.1,3700.7666666666664,41.38897832584927,-125.74153935753114,5114.225881482166,3431.2641185178336,4058.0499282716037,41.26882595801592,363.3552801039415,18985390.0,-20.015608402523355,-0.0025142609965125295,9.848094105158864,9.848094105158864,3834.6,3799.1,4229.958495068923,3243.1,4921.9,0,435.0,2.518306412434459,40542688.46736842
2017-09-18,4100.3,3689.6,4122.8,3689.0,147930.0,4921.9,0.1,3829.6000000000004,50.795738443335054,-84.95215797116656,5078.858446789329,3416.93155321067,4062.073744626689,65.15089841251381,368.3870458108028,19133320.0,-3.917984768599878,0.1113128794449263,8.98439250325105,8.98439250325105,3831.025,3799.1,2979.9,3243.1,4921.9,0,436.0,2.5189089511456677,40774601.044611245
2017-09-19,3908.0,4100.3,4120.7,3852.2,123220.0,4921.9,0.1,3899.3000000000006,46.99270222755986,-67.17725781187053,5042.752657398845,3385.537342601154,4047.4000546622424,53.9687154736291,361.25225682431693,19010100.0,-11.365131205915047,-0.04689900738970321,9.243916500110464,9.243916500110464,3831.025,3799.1,3002.7580000000003,3243.1,4921.9,0,437.0,2.519491863946731,41001509.553630285
2017-09-20,3882.2,3908.0,4053.0,3846.8,86650.0,4921.9,0.1,3963.5,46.48979724310344,-53.980426674331305,4975.909684178406,3367.0903158215947,4031.666716122981,52.468453800081384,350.17709562258,18923450.0,-15.946045424037067,-0.006601842374616251,9.020068405094534,9.020068405094534,3831.025,3818.05,3025.15884,3243.1,4921.9,0,438.0,2.520071175669444,41228515.31025095
2017-09-21,3617.3,3882.2,3912.8,3576.5,145130.0,4921.9,0.1,3802.5,41.57065557446049,-59.4806113099483,4867.100220482862,3345.439779517137,3992.2032193493637,37.06460429144618,349.18587450668144,18778320.0,-21.96695141944948,-0.06823450620782023,9.653218547167263,9.653218547167263,3777.725,3818.05,3047.1116632,3243.1,4921.9,0,439.0,2.5206221623682574,41447538.146851264
2017-09-22,3600.8,3617.3,3753.5,3505.8,114720.0,4921.9,0.1,3700.1000000000004,41.277678517752896,-60.423518406394805,4817.079319779539,3298.160680220461,3954.926722268472,43.6577134017719,341.93688347048993,18663600.0,-16.77337339650988,-0.004561413208746812,9.496136510511272,9.496136510511272,3764.775,3822.7,3068.625429936,3243.1,4921.9,0,440.0,2.521170379540036,41666818.29220095
2017-09-23,3788.0,3600.8,3813.4,3563.2,67820.0,4921.9,0.1,3668.7000000000007,45.93335449549172,-45.32320794182323,4739.455681182951,3293.2943188170493,3939.0289391952842,57.39754243909367,335.3842489368835,18731420.0,-12.620239440843356,0.051988447011775074,8.853860848386578,8.853860848386578,3764.775,3847.05,3089.7089213372797,3243.1,4921.9,0,441.0,2.5217371483735094,41893378.97126841
2017-09-24,3667.5,3788.0,3790.9,3633.9,49660.0,4921.9,0.1,3685.433333333334,43.54038228916677,-40.49229714326479,4715.055774756683,3257.694225243317,3913.169040224305,48.838695930108656,322.6425168699633,18681760.0,-13.62255352222143,-0.031810982048574465,8.797341973277799,8.797341973277799,3891.25,3878.0,3110.370742910534,3243.1,4921.9,0,442.0,2.5222904276425235,42116701.038418345
2017-09-25,3932.8,3667.5,3971.5,3665.7,100200.0,4921.9,0.1,3796.1000000000004,49.74765353074407,-17.638146593999807,4665.0853202554335,3260.034679744567,3915.038655441038,67.68236380424747,321.4394799506802,18781960.0,-6.759287797245062,0.07233810497614179,8.17329841209012,8.17329841209012,3891.25,3926.2,3130.619328052323,3243.1,4921.9,0,443.0,2.522869624539786,42349857.16998992
2017-09-26,3892.7,3932.8,3982.3,3858.8,63250.0,4921.9,0.1,3831.0,48.87302465061631,-4.135144499651091,4561.195594844075,3291.324405155925,3912.911164446653,76.40411818866657,307.30094566848874,18718710.0,-6.400730962514123,-0.010196297803092058,7.8942879150329786,7.8942879150329786,3896.25,3978.2,3150.4629414912765,3243.1,4921.9,0,444.0,2.523443836403291,42582635.76492949
2017-09-27,4212.2,3892.7,4232.4,3882.1,117600.0,4921.9,0.1,4012.566666666667,55.574825634023824,25.757145962167613,4468.179889449277,3342.000110550723,3941.4148630707814,98.38722554890221,310.3723066921681,18836310.0,8.8339405214066,0.08207670768361286,7.368413339636487,7.368413339636487,3923.6499999999996,3978.2,3169.909682661451,3243.1,4921.9,0,445.0,2.524047404563692,42826595.64615061
2017-09-28,4195.6,4212.2,4274.6,4112.9,92230.0,4921.9,0.1,4100.166666666667,55.1701865883212,42.847099043862514,4444.677593698636,3352.412406301365,3965.6229713497546,93.89820035529466,299.7528562141561,18744080.0,29.37004717708367,-0.003940933478941977,7.144457436699306,7.144457436699306,3870.0250000000005,3978.2,3212.409295354993,3243.1,4921.9,0,446.0,2.524648389465689,43071081.06208753
2017-09-29,4172.8,4195.6,4237.5,4030.4,97800.0,4921.9,0.1,4193.533333333334,54.58235436929083,50.52358477636682,4414.762436913832,3366.0975630861662,3985.354116935492,87.09432048681539,293.1347950560021,18646280.0,12.359308524960957,-0.005434264467537475,7.024894436733178,7.024894436733178,3864.9750000000004,3978.2,3276.1407376336933,3243.1,4921.9,0,447.0,2.525246217612408,43315889.32642258
2017-09-30,4360.6,4172.8,4383.3,4164.3,67490.0,4921.9,0.1,4243.000000000001,58.50426603935751,65.22232400710186,4438.136516871504,3354.193483128496,4021.0918200844926,97.47075208913651,287.83945255200194,18713770.0,17.88910216550867,0.04500575153374231,6.600913923588542,6.600913923588542,3892.15,3978.2,3336.0482933756716,3243.1,4921.9,0,448.0,2.525859928640935,43567542.274280526
2017-10-01,4403.1,4360.6,4412.6,4258.3,60580.0,4921.9,0.1,4312.166666666667,59.359548836394964,74.13058206564185,4474.708823325413,3336.1411766745878,4057.473551505017,98.9523599470666,278.300920226859,18774350.0,19.338139635732883,0.009746365179103877,6.320567786942358,6.320567786942358,3913.825,3978.2,3419.828429905618,3243.1,4921.9,0,449.0,2.5264762970801793,43821578.86346162
2017-10-02,4401.3,4403.1,4477.4,4364.7,71200.0,4921.9,0.1,4388.333333333333,59.30379727342749,75.94641199935992,4517.399133852555,3317.6908661474445,4090.2189275521587,92.1675586661178,266.4722830677976,18703150.0,7.340926273687291,-0.0004088028888737938,6.054399451702851,6.054399451702851,3947.7,3978.2,3519.1055869150564,3243.1,4921.9,0,450.0,2.5270914326944607,44076673.29109
2017-10-03,4314.2,4401.3,4436.0,4230.7,81870.0,4921.9,0.1,4372.866666666668,56.53668288263604,67.60491262299072,4563.338532390832,3316.141467609168,4111.550458261477,83.20296418279129,262.1028342772407,18621280.0,10.394063459570107,-0.019789607615931737,6.075351960438568,6.075351960438568,3955.6499999999996,3978.2,3634.1009164852494,3243.1,4921.9,0,451.0,2.5276978127573737,44330199.92755397
2017-10-04,4218.7,4314.2,4355.3,4183.6,64080.0,4921.9,0.1,4311.400000000001,53.58443276790869,52.64411754920713,4534.285017567085,3442.7549824329158,4121.755176522288,73.37381638534377,255.6454889717235,18557200.0,8.667765699860903,-0.02213620138148442,6.059816743824483,6.059816743824483,3948.375,3978.2,3735.2968065070195,4218.7,4921.9,0,452.0,2.528294529904045,44581795.65358027
2017-10-05,4321.4,4218.7,4365.8,4143.4,63610.0,4921.9,0.1,4284.766666666666,56.23133488298995,46.84742014461722,4567.749050286143,3470.0509497138573,4140.768969234451,83.94400988060929,253.270811188029,18620810.0,19.46479418350702,0.02434399222509298,5.860850909150484,5.860850909150484,3954.2,3978.2,3824.349189726177,4218.7,4921.9,0,453.0,2.5288994320625804,44837714.184024245
2017-10-06,4371.9,4321.4,4422.1,4296.9,61690.0,4921.9,0.1,4304.0,57.514322270816564,43.66041727948995,4601.319341344796,3503.780658655204,4162.781448354979,88.45985561146358,244.12289610316984,18682500.0,21.414685625416556,0.01168602767621607,5.583908508958802,5.583908508958802,3991.2749999999996,3978.2,3902.715286959036,4218.7,4921.9,0,454.0,2.529507733583064,45096313.721555844
2017-10-07,4435.8,4371.9,4472.9,4319.5,40200.0,4921.9,0.1,4376.366666666667,59.14619310636684,43.03183412255776,4636.31147780933,3543.408522190669,4188.783215178314,95.06816834617672,237.64268923865765,18722700.0,17.10137275607181,0.014616070815892446,5.357380613162397,5.357380613162397,3991.2749999999996,3978.2,3971.6774525239516,4218.7,4921.9,0,455.0,2.5301205390815267,45358018.56352754
2017-10-08,4611.7,4435.8,4622.9,4419.4,71370.0,4921.9,0.1,4473.133333333334,63.322501862728664,51.08927033483509,4707.4059424165835,3523.454057583417,4229.061004208951,98.82992060175513,235.20392572161066,18794070.0,25.745057941376952,0.039654628251949875,5.100156682386336,5.100156682386336,4092.2749999999996,3978.2,4032.3641582210776,4218.7,4921.9,0,456.0,2.5307471928791783,45626224.50127007
2017-10-09,4777.5,4611.7,4875.4,4556.1,110190.0,4921.9,0.1,4608.333333333333,66.77064545245014,63.4075499050964,4808.471863302003,3509.3381366979984,4281.293289522384,90.36986031870946,241.210788170067,18904260.0,21.478336045565495,0.03595203504130806,5.048891432131177,5.048891432131177,4218.525,3978.2,4115.039176070127,4218.7,4777.5,0,457.0,2.5313863058889168,45900527.09363419
2017-10-10,4763.4,4777.5,4930.0,4722.8,98490.0,4921.9,0.1,4717.533333333334,66.20065550216285,66.1253826227632,4889.945119872477,3515.984880127523,4327.208214329776,84.10153640614558,238.78144615791933,18805770.0,22.36750841318365,-0.002951334379905912,5.012836338705952,5.012836338705952,4245.825,3978.2,4236.696907898907,4218.7,4777.5,0,458.0,2.5320231880596085,46175672.71302117
2017-10-11,4824.2,4763.4,4874.9,4718.6,70480.0,4921.9,0.1,4788.366666666667,67.48942550237123,67.312597859878,4945.923723565534,3580.6962764344653,4374.540765345988,88.23921742996885,232.8899142894965,18876250.0,14.529224633208301,0.012763992106478605,4.827534395122434,4.827534395122434,4372.299999999999,3978.2,4361.491464477103,4218.7,4777.5,0,459.0,2.5326638348200534,46453851.18141894
2017-10-12,5432.6,4824.2,5432.6,4815.0,163920.0,5432.6,0.1,5006.733333333334,76.95758312562789,102.27134960875244,5141.07460147222,3568.7253985277794,4475.308311503513,100.0,260.36920612596106,19040170.0,29.48326818571837,0.12611417437088024,4.792718148326051,4.792718148326051,4623.6,4206.25,4463.823000871224,4218.7,4777.5,1,460.0,2.5333488727590923,46750061.73461449
2017-10-13,5637.3,5432.6,5852.8,5392.0,215020.0,5637.3,0.1,5298.033333333334,79.15703129614161,130.56856267022215,5368.508978485452,3526.2210215145483,4585.974186598417,87.3932373932374,274.6856914026781,19255190.0,35.09633819018404,0.03767993226079591,4.872646327189933,4.872646327189933,4838.700000000001,4416.35,4657.57840069698,4218.7,4777.5,1,461.0,2.534046922434998,47052992.86288252
2017-10-14,5824.7,5637.3,5839.6,5568.9,76220.0,5824.7,0.1,5631.533333333333,80.94979021883411,151.80542792059103,5584.663471935068,3525.786528064933,4703.948073589044,98.35614835614834,274.40099915962975,19331410.0,33.57565472641378,0.03324286449186653,4.71098939275207,4.71098939275207,4877.075000000001,4416.35,4815.0,4218.7,4777.5,0,462.0,2.5347563241224202,47362131.735881284
2017-10-15,5688.1,5824.7,5862.7,5448.2,101640.0,5824.7,0.1,5716.700000000001,75.8298122398865,146.4808140217139,5742.14029163441,3543.83970836559,4797.676828485326,89.84470424009774,284.40807064822764,19229770.0,29.18398401126479,-0.023451851597507067,5.000053983724401,5.000053983724401,4887.675,4421.3,5022.56,4218.7,4777.5,0,463.0,2.5354554713155166,47669457.27518769
2017-10-16,5759.3,5677.4,5795.3,5576.1,61360.0,5824.7,0.1,5757.366666666668,76.65850770367092,137.71455576867027,5880.842605456095,3591.7973945439044,4889.2599876772,93.98592450415869,279.7503513162114,19291130.0,30.854520255379093,0.012517360805893052,4.857367237619353,4.857367237619353,4912.65,4421.3,5190.588000000001,4218.7,4777.5,0,464.0,2.5361582119552333,47980143.858227044
2017-10-17,5598.6,5759.3,5773.3,5521.1,65640.0,5824.7,0.1,5682.0,70.76148948044198,112.1374876846424,5982.277560848714,3629.002439151287,4956.81617932699,84.63909730704358,277.78246907933914,19225490.0,29.771452412961864,-0.027902696508256164,4.96164164397062,4.96164164397062,4946.825,4421.3,5325.0104,4218.7,4777.5,0,465.0,2.536848967317776,48288301.635766104
2017-10-18,5575.8,5598.6,5601.3,5114.9,122020.0,5824.7,0.1,5644.566666666668,69.93944008564084,85.9093936740685,6061.926696478125,3687.3733035218743,5015.767019391087,83.3129762112488,292.6837212879578,19103470.0,32.168677554696956,-0.004072446683099362,5.249178974998346,5.249178974998346,5001.799999999999,4421.3,5862.7,4218.7,4777.5,0,466.0,2.537537010175827,48597407.30332416
2017-10-19,5698.6,5576.7,5737.4,5517.6,83060.0,5824.7,0.1,5624.333333333333,71.83713332495051,69.74421621909221,6144.089334157302,3757.790665842699,5080.798731830032,89.51973432111383,287.47774119596073,19186530.0,31.86930161521731,0.022023745471501988,5.04470819492438,5.04470819492438,5019.475,4421.3,5847.744,4218.7,4777.5,0,467.0,2.5382322247469955,48911264.352324195
2017-10-20,5993.1,5698.6,6075.3,5611.4,123860.0,5993.1,0.1,5755.833333333333,75.78517630426876,71.53221692487807,6275.333683665634,3789.7963163343666,5167.684566893839,95.31837339104682,300.07933111053495,19310390.0,37.08227544088384,0.0516793598427685,5.007080327552267,5.007080327552267,5157.825,4527.6,5114.9,4218.7,4777.5,0,468.0,2.5389455219490484,49234174.09243363
2017-10-21,6006.6,5993.1,6187.2,5874.5,112940.0,6006.6,0.1,5899.433333333334,75.95160349760644,66.38339201482859,6389.166839893307,3836.313160106693,5247.581274808711,89.78391220726328,300.9808074597825,19423330.0,35.41187609901259,0.002252590479050909,5.010834872636475,5.010834872636475,5337.025,4583.55,5134.107999999999,4218.7,4777.5,0,469.0,2.53965850058385,49559099.971979074
2017-10-22,5982.9,6006.6,6070.6,5723.0,105030.0,6006.6,0.1,5994.2,74.97734922096966,54.631290834832555,6478.077051448121,3905.5629485518784,5317.611629588834,87.47471031819018,304.3107497840838,19318300.0,29.733070234403797,-0.003945659774248433,5.086341904161591,5.086341904161591,5342.849999999999,4583.55,5176.231679999999,4218.7,4777.5,0,470.0,2.5403687942616564,49885123.07960858
2017-10-23,5903.6,5982.9,6049.0,5644.2,137140.0,6006.6,0.1,5964.366666666668,71.66488419315225,35.68367070798831,6526.868774748926,4015.7112252510738,5373.420045818469,80.68909165191342,311.48855337093494,19181160.0,23.570905285191007,-0.013254441825870322,5.276247600971186,5.276247600971186,5379.924999999999,4583.55,5216.670412799999,4218.7,4777.5,0,471.0,2.5410728259218653,50210820.66878264
2017-10-24,5513.1,5903.6,5904.6,5463.4,143740.0,6006.6,0.1,5799.866666666666,58.06162582900358,-6.722083021531603,6497.831251139785,4174.188748860215,5386.722898597663,54.09914204003815,320.75365670158254,19037420.0,15.738758029978603,-0.06614608035774783,5.818027184371452,5.818027184371452,5379.924999999999,4583.55,5255.4915962879995,5513.1,4777.5,0,472.0,2.541749601066849,50527793.409504324
2017-10-25,5734.0,5513.1,5748.0,5375.6,105840.0,6006.6,0.1,5716.9000000000015,62.40857617806596,-22.5745201058902,6481.659418243232,4331.620581756769,5419.796908255028,66.97274449788661,324.44268122289805,19143260.0,18.859085444218735,0.040068201193520725,5.658226041557343,5.658226041557343,5408.174999999999,4583.55,5292.759932436479,5513.1,4777.5,0,473.0,2.542440214575058,50852323.18001144
2017-10-26,5887.6,5734.0,5970.4,5689.9,93680.0,6006.6,0.1,5711.566666666667,65.11613482298301,-25.19631867066886,6464.677724862607,4500.172275137394,5464.349583659311,72.06005781964008,321.3039182784053,19236940.0,8.375363546000072,0.026787582839204793,5.45729870029223,5.45729870029223,5408.174999999999,4583.55,5328.53753513902,5513.1,4777.5,0,474.0,2.5431397496686596,51182546.06003625
2017-10-27,5764.6,5887.6,5997.8,5692.3,83930.0,6006.6,0.1,5795.4000000000015,61.308061845467165,-36.982508623378806,6411.4211367818425,4686.308863218157,5492.944861406043,60.58938729833075,320.1750669728049,19153010.0,2.2581732389619176,-0.02089136490250698,5.554159299392931,5.554159299392931,5473.349999999999,4583.55,5362.88403373346,5513.1,4777.5,0,475.0,2.5438300858102956,51511185.1322572
2017-10-28,5726.6,5764.6,5871.0,5654.8,53230.0,6006.6,0.1,5792.933333333334,60.13794719544357,-48.386117958757154,6354.433557645408,4854.786442354592,5515.197731748324,57.04560290963356,312.7482764747474,19099780.0,-1.6842069119439536,-0.0065919578114700395,5.4613256814645235,5.4613256814645235,5473.349999999999,4583.55,5395.856672384121,5513.1,4777.5,0,476.0,2.544516756321306,51840444.03896945
2017-10-29,6147.5,5726.6,6295.4,5679.4,163060.0,6147.5,0.1,5879.566666666667,67.53011189447261,-29.555929453819147,6355.451620890897,4990.768379109102,5575.4169953913415,87.47141041931387,334.4091138694083,19262840.0,8.07651060986972,0.07349910941920146,5.43975785066138,5.43975785066138,5527.45,4637.65,5427.510405488756,5513.1,6147.5,0,477.0,2.545229272001232,52182450.83800919
2017-10-30,6124.3,6147.7,6226.2,6019.0,78620.0,6147.5,0.1,5999.466666666667,66.79483888597156,-21.036952345058182,6308.842965259101,5173.4670347409,5627.691567258833,85.50614146548078,325.32274859302197,19184220.0,6.337575747052593,-0.0037738918259454524,5.311998899352121,5.311998899352121,5527.45,4637.65,5479.583781159431,5513.1,6147.5,0,478.0,2.545939177272888,52525641.804738194
2017-10-31,6451.2,6124.3,6467.2,6090.8,101250.0,6451.2,0.1,6241.0,71.5030986175421,2.963089937252448,6300.490169121405,5344.519830878595,5706.1209418056105,98.81683058492939,328.9711236935204,19285470.0,15.22880720180044,0.053377528860441226,5.099378777491326,5.099378777491326,5651.724999999999,4723.55,5528.532754289865,5513.1,6147.5,0,479.0,2.5466676869895615,52878857.77986474
2017-11-01,6737.8,6449.1,6738.7,6355.0,133190.0,6737.8,0.1,6437.766666666666,74.86769580417713,32.82963674445284,6478.1734663180405,5297.35653368196,5804.376090205076,99.93397402978506,332.8803291439832,19418660.0,20.840058825639368,0.04442584325396837,4.940489909821948,4.940489909821948,5793.125,4859.3,5603.6261339466755,5513.1,6147.5,0,480.0,2.5474115291454753,53240897.36083672
2017-11-02,7024.8,6737.8,7339.9,6737.8,238800.0,7024.8,0.1,6737.933333333334,77.70631823043529,64.75824288164739,6715.660777302785,5198.619222697215,5920.606938756973,83.95866211882097,352.11030563369866,19657460.0,23.272382690485376,0.042595505951497525,5.0123890450076685,5.0123890450076685,6118.7,5159.9,5717.133520552008,5513.1,6147.5,1,481.0,2.548170014141411,53611618.26870316
2017-11-03,7152.1,7024.8,7445.6,6938.9,154890.0,7152.1,0.1,6971.566666666667,78.84753338568044,85.9662795184687,6939.92239166656,5107.097608333441,6037.89199220869,85.82125603864735,363.15242665986307,19812350.0,19.338906409037058,0.018121512356223723,5.077563605932007,5.077563605932007,6275.525000000001,5212.75,5911.865498085767,5513.1,6147.5,0,482.0,2.548934097888108,53987316.18555048
2017-11-04,7363.8,7147.0,7492.2,6957.8,106600.0,7363.8,0.1,7180.233333333334,80.6238873943175,104.53338684527847,7178.979398458811,5035.610601541189,6164.168945331672,93.93366720211661,375.3843961841585,19918950.0,22.595145340125857,0.029599697990799978,5.09769950547487,5.09769950547487,6339.45,5236.05,6126.58832835376,5513.1,6147.5,0,483.0,2.549708028305429,54369881.72690546
2017-11-05,7389.5,7363.8,7599.4,7284.3,105730.0,7389.5,0.1,7301.8,80.83430880947256,108.36355419347558,7383.17586279766,4994.434137202341,6280.86714101437,90.56120154690171,371.07836788529,20024680.0,23.510337796052088,0.0034900459002145112,5.021697921175858,5.021697921175858,6393.05,5289.65,6345.086195817158,5513.1,6147.5,0,484.0,2.5504820421137517,54755206.38171113
2017-11-06,6959.2,7389.5,7429.7,6934.7,159690.0,7389.5,0.1,7237.5,67.59766485806176,73.408272203053,7463.91525296582,5049.75474703418,6345.470270441572,71.21143987768684,379.9299130363407,19864990.0,17.880615217833178,-0.05823127410514928,5.459390634503114,5.459390634503114,6423.299999999999,5542.6,6570.86268057007,5513.1,6147.5,0,485.0,2.5512320564826774,55132834.124848954
2017-11-07,7102.8,6959.3,7222.4,6957.8,101050.0,7389.5,0.1,7150.5,69.39857320548268,52.43308057264471,7551.41940646701,5114.950593532989,6417.596911351899,77.66885511286988,371.6920621051735,19966040.0,28.834956739402507,0.02063455569605699,5.23303573386796,5.23303573386796,6583.174999999999,5542.6,6755.999398067457,5513.1,6147.5,0,486.0,2.5519886057357053,55515939.83486317
2017-11-08,7444.4,7102.2,7869.1,7027.0,220220.0,7444.4,0.1,7168.8,73.21267864388133,53.83628478481239,7693.281750257097,5147.668249742904,6515.387681699337,80.82012374113712,405.2926290976611,20186260.0,29.829089640739443,0.04809370952300496,5.4442618491438015,5.4442618491438015,6735.975,5687.450000000001,6907.811506415314,5513.1,6147.5,0,487.0,2.5527617443249047,55909036.969077416
2017-11-09,7129.6,7444.4,7457.1,7040.8,126770.0,7444.4,0.1,7225.599999999999,65.15350773331627,27.179657373148302,7770.034495555848,5184.565504444153,6573.884092966066,66.60344126812086,406.0788698763996,20059490.0,21.09518309667776,-0.04228681962280367,5.695675351722391,5.695675351722391,6802.025,5687.450000000001,7869.1,5513.1,6147.5,0,488.0,2.5535172737518903,56297107.16111772
2017-11-10,6565.8,7129.6,7319.0,6406.0,222000.0,7444.4,0.1,7046.600000000001,53.74308590028484,-31.619490661783345,7780.128691905184,5230.391308094817,6573.11417935025,41.141670053741585,442.28752202808533,19837490.0,13.898622627762547,-0.07907877019748655,6.736232020897457,6.736232020897457,6814.775,5687.450000000001,7869.1,5513.1,6147.5,0,489.0,2.554240381351227,56673381.64041525
2017-11-11,6339.9,6565.8,6821.5,6197.9,135720.0,7444.4,0.1,6678.433333333334,49.96715237131771,-85.84654359912707,7778.065171948398,5268.154828051602,6550.903305126417,30.163949399461103,455.2384133117935,19701770.0,10.709670659728273,-0.03440555606323681,7.180529871319635,7.180529871319635,6762.75,5687.450000000001,7810.576,5513.1,6147.5,0,490.0,2.5549490530012777,57045682.55899994
2017-11-12,5878.1,6339.9,6490.5,5493.6,269830.0,7444.4,0.1,6261.266666666667,43.27372703940499,-149.22414944132663,7779.354396709265,5264.315603290735,6486.826799876282,16.18606609134919,493.9285266466654,19431940.0,-4.382269215128095,-0.07284026561933143,8.402860220933045,8.402860220933045,6586.675,5687.450000000001,7713.81544,5513.1,6147.5,0,491.0,2.5556279357785923,57406942.03217388
2017-11-13,6522.5,5878.1,6760.1,5828.3,178340.0,7444.4,0.1,6246.833333333333,52.779377087462045,-144.0795740072253,7741.773673329916,5402.836326670084,6490.2242475071125,43.31298673963375,525.2050604576178,19610280.0,6.501967571804121,0.10962726050934823,8.052204836452553,8.052204836452553,6651.85,5716.15,7536.1982048,5513.1,6147.5,0,492.0,2.5563450512105055,57787932.000749655
2017-11-14,6597.1,6522.5,6728.6,6419.2,96500.0,7444.4,0.1,6332.566666666667,53.745689943643754,-132.29122833949367,7719.896265974654,5511.023734025348,6500.402890601674,46.45337823616081,509.7904132820737,19706780.0,2.2615947420635005,0.011437332311230453,7.727492584348784,7.727492584348784,6651.85,5751.5,7372.790348416,5513.1,6147.5,0,493.0,2.5570652977882706,58172898.454294816
2017-11-15,7283.2,6597.1,7330.1,6596.9,131120.0,7444.4,0.1,6800.933333333334,61.540759942967,-77.63064086610916,7773.137870941953,5597.342129058046,6574.954996258657,75.33571879604291,525.7482409047827,19837900.0,8.094630294754959,0.10400024253080886,7.218643465849938,7.218643465849938,6651.85,5767.4,5493.6,5513.1,6147.5,0,494.0,2.557821779403747,58577190.554229975
2017-11-16,7853.7,7283.0,7964.6,7119.2,133940.0,7853.7,0.1,7244.666666666667,66.5836523820602,-6.164347123704488,7904.78358029308,5674.606419706919,6696.740234710214,95.51193848644272,548.580509411584,19971840.0,11.799624188588993,0.07833095342706509,6.984994453717153,6.984994453717153,6699.6,5911.700000000001,5530.33,5513.1,6147.5,0,495.0,2.558605550065935,58997011.16679759
2017-11-17,7700.0,7853.7,8000.2,7534.7,117350.0,7853.7,0.1,7612.3,64.1434046557273,25.886354174322605,7958.026773225556,5818.7032267744435,6792.288783785431,88.02361764940558,542.6461873107565,19854490.0,7.660687070930211,-0.01957039357245627,7.047353081957877,7.047353081957877,6717.4,5941.15,5627.7008,7700.0,6147.5,0,496.0,2.5593806096105016,59415768.525583416
2017-11-18,7780.9,7700.0,7857.5,7458.9,74380.0,7853.7,0.1,7778.2,64.87313932227454,46.46459870600552,8050.333064933953,5889.736935066048,6886.442232948724,91.25109710364637,532.3571739314168,19928870.0,5.6641951166517215,0.010506493506493353,6.841845723906191,6.841845723906191,6717.4,6015.3,5770.050751999999,7700.0,6147.5,0,497.0,2.5601583826883703,59838793.24954719
2017-11-19,8042.6,7781.0,8100.9,7675.4,68620.0,8042.6,0.1,7841.166666666667,67.19869596653967,70.20571541164009,8169.24994017948,5962.650059820519,6996.552496477417,97.76397039082579,524.7245186506013,19997490.0,8.83821638811828,0.033633641352542876,6.524314508375417,6.524314508375417,6767.75,6065.65,5903.859706879999,7700.0,6147.5,0,498.0,2.5609474080786185,60270196.82346673
2017-11-20,8244.7,8042.6,8294.1,7947.3,75700.0,8244.7,0.1,8022.733333333334,68.9104796411753,90.72116476273362,8333.509177455511,5977.740822544489,7115.4236872890915,98.23602928048565,512.0156244612728,20073190.0,18.471950798942423,0.025128689727202724,6.210239601941522,6.210239601941522,6893.85,6218.75,6079.6229303295995,7700.0,8244.7,0,499.0,2.561744550899876,60708615.039556384
2017-11-21,8100.0,8245.9,8368.4,7819.1,115450.0,8244.7,0.1,8129.100000000001,66.24486779840146,85.80063685494088,8453.49454117057,5993.975458829431,7209.1928599282255,90.66369834423266,514.6787941426104,19957740.0,14.039533705017737,-0.017550668914575462,6.354059186945807,6.354059186945807,7014.675,6255.9,6301.07063729664,7700.0,8244.7,0,500.0,2.5625337570768316,61146405.40493828
2017-11-22,8234.5,8099.9,8304.4,8091.6,65810.0,8244.7,0.1,8193.066666666668,67.50318705711533,82.817608112573,8585.791718500386,5982.6482814996125,7306.84115898268,95.34228468067344,493.1160231324239,20023550.0,10.613346945354902,0.01660493827160492,5.988414878042673,5.988414878042673,7162.4,6255.9,6549.150160821043,7700.0,8244.7,0,501.0,2.5633279258306065,61589780.28103085
2017-11-23,8013.4,8234.5,8266.5,8012.4,68010.0,8244.7,0.1,8115.966666666667,63.32419225722517,58.32302227266479,8665.01446334453,5989.555536655466,7374.132477174806,87.6513148740782,476.0434500515365,19955540.0,12.396207360861748,-0.026850446293035457,5.940592632983958,5.940592632983958,7206.825,6255.9,6767.460141522518,7700.0,8244.7,0,502.0,2.564110582081465,62030745.84223221
2017-11-24,8200.8,8013.4,8332.9,7900.2,73000.0,8244.7,0.1,8149.566666666666,65.28583451991045,47.56604156146608,8760.125096693737,5978.144903306264,7452.862717443872,94.17002921942394,472.9474893335696,20028540.0,24.901763684547184,0.023385828736865788,5.767089666051723,5.767089666051723,7337.4,6255.9,6959.572924539816,7700.0,8244.7,0,503.0,2.564900709631248,62478568.594887376
2017-11-25,8754.7,8203.5,8762.0,8153.7,84670.0,8754.7,0.1,8322.966666666667,70.33610620084463,69.26418546608795,8954.000046114528,5920.789953885471,7576.847220544456,99.77664912495413,482.61552580974325,20113210.0,38.08892884745818,0.06754219100575565,5.5126449314053385,5.5126449314053385,7619.125,6452.7,7128.632173595038,7700.0,8244.7,0,504.0,2.5657142088007627,62941254.063986056
2017-11-26,9318.4,8754.6,9474.6,8746.6,85890.0,9318.4,0.1,8757.966666666665,74.41542439781044,110.63466617772656,9260.152492343313,5850.557507656684,7742.709390016412,95.71620546855715,500.14298825190446,20199100.0,58.52741532127727,0.06438827144276771,5.367262494118137,5.367262494118137,7975.425,6885.75,7357.303669291732,7700.0,8244.7,0,505.0,2.566549930529567,63418510.14696766
2017-11-27,9733.2,9318.4,9733.6,9316.8,106900.0,9733.2,0.1,9268.766666666666,76.92957044420821,152.41206859736235,9622.019700403578,5751.730299596422,7932.279924300563,99.98793145063965,494.1899176624828,20306000.0,49.2249904177846,0.04451407967032983,5.077363227535474,5.077363227535474,8159.05,7026.55,7696.071082205055,7700.0,8244.7,0,506.0,2.567400747202533,63907019.94631421
2017-11-28,9906.0,9732.6,9969.6,9638.2,87760.0,9906.0,0.1,9652.533333333333,77.90371030337337,176.46322861346573,9968.040863421578,5651.869136578422,8120.253264843366,98.11427046579891,482.56206640087686,20393760.0,50.15688711706658,0.017753667858463773,4.871411936209134,4.871411936209134,8312.975,7194.5,8062.826287408146,7700.0,8244.7,0,507.0,2.568256871157628,64402009.965573184
2017-11-29,9837.9,9906.0,11417.8,8938.7,233330.0,9906.0,0.1,9825.699999999999,76.53220368148894,172.3672511481899,10250.564417917947,5640.175582082054,8283.838668191616,63.246173172660875,625.1719188008141,20160430.0,35.07661467486819,-0.006874621441550599,6.354729350784355,6.354729350784355,9037.075,7986.95,8444.181029926516,7700.0,8244.7,0,508.0,2.569109081263471,64898846.02688686
2017-11-30,9946.8,9848.0,10689.1,9023.8,187010.0,9946.8,0.1,9896.9,77.22277113071866,161.7467777813165,10485.097419304462,5743.74258069554,8442.215937887653,62.8432140240976,699.4667817436132,20347440.0,26.651132587188197,0.011069435550269846,7.03207847492272,7.03207847492272,9057.35,8068.2,11417.8,7700.0,8244.7,0,509.0,2.5699641157895003,65400992.18164363
2017-12-01,10861.5,9947.1,10942.8,9420.9,131920.0,10861.5,0.1,10215.4,82.01101216410405,198.6492394269053,10849.517381366672,5831.4826186333285,8672.623943803115,85.94811690115944,758.2120116190694,20479360.0,41.05844155844156,0.091959223066715,6.980730208710301,6.980730208710301,9057.35,8068.2,11417.8,7700.0,8244.7,0,510.0,2.5708508958122867,65923570.43489011
2017-12-02,10912.7,10861.5,11175.2,10715.5,86830.0,10912.7,0.1,10573.666666666666,82.23611913065105,207.84435354235382,11072.60417830457,6111.85582169543,8885.964520583771,86.50331338178712,736.8897250748502,20566190.0,40.24984256319964,0.0047138977121023995,6.7525884984912095,6.7525884984912095,9057.35,8116.4,11369.92,7700.0,8244.7,0,511.0,2.571738090436557,66450562.11624949
2017-12-03,11246.2,10912.7,11851.1,10578.4,122130.0,11246.2,0.1,11006.800000000001,83.6695929885692,216.7330231017097,11374.211053320076,6282.618946679926,9110.748851956745,84.99751984126985,775.1618875695038,20688320.0,39.83288986148758,0.030560722827531306,6.8926560755588895,6.8926560755588895,9337.375,8483.0,9023.8,7700.0,8244.7,0,512.0,2.5726352379241653,66987053.450422786
2017-12-04,11623.9,11244.2,11624.6,10917.8,93170.0,11623.9,0.1,11260.933333333334,85.13283424775896,227.2904227444991,11686.589155426862,6472.92084457314,9350.096580341817,94.36507936507935,770.2788956002536,20781490.0,40.9863306123934,0.03358467749106353,6.626682056798954,6.626682056798954,9485.6,8483.0,9080.346,7700.0,8244.7,0,513.0,2.5735434233345273,67533785.79417929
2017-12-05,11667.1,11624.4,11901.9,11486.1,89690.0,11667.1,0.1,11512.4,85.29512793422553,216.47526434379495,12000.199225451084,6597.700774548917,9570.763572690215,94.13249369018169,744.9589744859496,20871180.0,44.03827160493828,0.003716480699249125,6.385125476647578,6.385125476647578,9559.025,8508.4,9135.76108,7700.0,8244.7,0,514.0,2.5744516262179555,68085011.60006666
2017-12-06,13749.6,11667.1,13843.2,11661.8,191580.0,13749.6,0.1,12346.866666666669,90.61415942640143,322.48111999872754,12833.041000969977,6354.448999030024,9968.747994338766,98.42503785966682,847.5619048798105,21062760.0,66.9755297832291,0.1784933702462479,6.164265905043132,6.164265905043132,10529.675000000001,9479.05,9246.4066368,7700.0,8244.7,0,515.0,2.5754200637791964,68673431.9516981
2017-12-07,16850.3,13750.1,16879.3,13401.6,297110.0,16850.3,0.1,14089.0,94.05960833254348,560.3952675402443,14463.74487245,5638.775127550002,10624.133899639835,99.67702776447528,1035.4289116741097,21359870.0,110.27653680085857,0.22551201489497874,6.1448693000961985,6.1448693000961985,12047.725,10997.099999999999,9522.214238592,7700.0,8244.7,1,516.0,2.576463316109012,69307919.54525192
2017-12-08,16047.6,16868.0,17294.8,13906.1,286760.0,16850.3,0.1,15549.166666666666,85.32712161770976,618.1320010824761,15459.287306228689,5469.902693771309,11140.654480626517,86.3561278183151,1203.5197036973875,21073110.0,95.68334796605211,-0.04763713405696035,7.49968658053159,7.49968658053159,12360.425,11204.849999999999,10110.78109950464,7700.0,8244.7,1,517.0,2.5774867486702164,69937345.34128879
2017-12-09,14843.4,16048.2,16313.2,13151.5,181980.0,16850.3,0.1,15913.766666666665,74.1980864241568,532.8787272803074,16014.81898111814,5594.451018881859,11493.296911043039,71.32261762710277,1343.3897248618598,20891130.0,69.54778576079133,-0.07503925820683466,9.050417861553687,9.050417861553687,12607.425,11335.2,10829.182989554176,14843.4,8244.7,0,518.0,2.578479451670736,70555381.72661005
2017-12-10,15059.6,14840.0,15783.2,13031.0,201620.0,16850.3,0.1,15316.866666666667,74.83275621374084,451.9032758153685,16529.79087644694,5760.969123553063,11832.944824277036,73.25067914457703,1444.01903022887,21092750.0,61.611435439560445,0.01456539606828633,9.588694455555725,9.588694455555725,12941.224999999999,11335.2,11475.744690598758,14843.4,8244.7,0,519.0,2.5794761044649035,71181128.51464343
2017-12-11,16732.5,15060.5,17399.2,15024.6,159730.0,16850.3,0.1,15545.166666666666,79.1138380203146,469.78715939456924,17289.709616370437,5864.300383629565,12299.569126726841,92.11985107263163,1510.4890994982363,21252480.0,71.91160152878805,0.11108528778984827,9.027276853418416,9.027276853418416,13124.0,11387.400000000001,12057.650221538883,14843.4,8244.7,0,520.0,2.580510727431914,71834003.76850328
2017-12-12,17083.9,16733.3,17560.7,16254.5,132850.0,17083.9,0.1,16292.0,79.88775586793072,463.2908735274366,17992.96525306814,6045.984746931857,12755.21968608619,94.46996056599399,1495.897020962648,21385330.0,72.46012517666063,0.021001045868818347,8.756179917715789,8.756179917715789,13374.525,11468.150000000001,12698.636194954217,14843.4,8244.7,0,521.0,2.58155161709017,72496487.38499385
2017-12-13,16286.8,17083.9,17268.0,15669.9,155410.0,17083.9,0.1,16701.066666666666,73.25674732548413,367.5035953040108,18385.487352208926,6480.8026477910735,13091.560668363696,85.07772142112475,1503.1972337510301,21229920.0,65.55159129489016,-0.04665796451629911,9.229543149980538,9.229543149980538,13516.6,11468.150000000001,13379.325127660626,14843.4,8244.7,0,522.0,2.582573111003229,73153896.655305
2017-12-14,16467.9,16286.8,16941.1,16023.6,107920.0,17083.9,0.1,16612.86666666667,73.78906658282375,282.3606040454915,18713.375726994745,6979.624273005255,13413.1167951862,86.5746087127448,1461.3617170545278,21337840.0,65.55977801906143,0.011119434142986995,8.874001645956847,8.874001645956847,13614.65,11468.150000000001,13964.717609788138,14843.4,8244.7,0,523.0,2.583597244195178,73818836.9395231
2017-12-15,17604.8,16467.9,17987.0,16442.2,153650.0,17604.8,0.1,16786.5,76.89790288579837,268.7059480809903,19189.57331380674,7388.436686193261,13812.324719454182,94.84113057797694,1467.3215944077758,21491490.0,62.084426644570264,0.06903733930859413,8.334781391482867,8.334781391482867,14206.025,11681.3,14468.155144417799,14843.4,8244.7,0,524.0,2.584644837092189,74503664.90989794
2017-12-16,19345.5,17594.1,19587.7,17318.5,112170.0,19345.5,0.1,17806.066666666666,80.67691422755402,338.4952655522902,19954.316895177006,7626.403104822997,14339.293793791878,97.31166683316128,1524.598623378649,21603660.0,77.27510148725796,0.09887644278833041,7.880895419496261,7.880895419496261,15006.375,12540.650000000001,15031.17032131095,14843.4,19345.5,0,525.0,2.5857261432861876,75214918.49400316
2017-12-17,19065.7,19346.6,19870.6,18750.9,117410.0,19345.5,0.1,18672.0,78.45535524831223,327.21208872718717,20533.699268875083,7980.270731124909,14789.427718192652,91.00951657581987,1495.6772931373168,21486250.0,69.53015240703526,-0.014463311881315999,7.844859056511519,7.844859056511519,15168.099999999999,12682.099999999999,15851.34566347498,14843.4,19345.5,0,526.0,2.5868004452585494,75928791.95284253
2017-12-18,18972.3,19065.7,19221.1,18114.4,139250.0,19345.5,0.1,19127.833333333332,77.68633626825844,276.85555588325406,20974.14778486835,8446.452215131649,15187.796506936209,89.2861828373785,1467.8932007703654,21347000.0,63.21802493139136,-0.004898849766858837,7.73703346863778,7.73703346863778,15168.099999999999,12682.099999999999,16655.196530779984,14843.4,19345.5,0,527.0,2.5878713601524206,76647422.36975627
2017-12-19,17523.7,18971.2,19022.0,16812.8,174540.0,19345.5,0.1,18520.566666666666,66.75691832583581,117.53166530564795,21051.104200067028,9138.075799932973,15410.263506275616,71.409950297242,1520.8436864296252,21172460.0,50.19756409047665,-0.07635342051306371,8.67878180081618,8.67878180081618,15666.5,12682.099999999999,19870.6,14843.4,19345.5,0,528.0,2.5889110760825234,77353807.15231305
2017-12-20,16462.0,17521.7,17813.6,15642.7,227680.0,19345.5,0.1,17652.666666666668,60.08492038883735,-77.31565674496733,20909.393336502286,9931.306663497715,15510.42888663032,50.16375226621441,1567.2762802560806,20944780.0,19.72711933438063,-0.060586519970097674,9.520570284631761,9.520570284631761,15884.400000000001,12682.099999999999,19809.444,14843.4,19345.5,0,529.0,2.5899259556882166,78051407.37775563
2017-12-21,15632.1,16461.1,17301.8,14953.0,163740.0,19345.5,0.1,16539.266666666666,55.42207480137422,-269.245006353799,20733.7549200744,10584.005079925602,15522.016611713147,38.03000175448858,1623.0994030949319,20781040.0,-7.2295448745719595,-0.05041307253067673,10.383118090947036,10.383118090947036,15860.199999999999,12682.099999999999,19642.77424,14843.4,19345.5,0,530.0,2.5909200538587385,78742391.40937677
2017-12-22,13665.0,15632.1,15823.7,10875.7,466980.0,19345.5,0.1,15253.033333333333,46.2585437176979,-521.2439571732357,20483.548495950323,11109.441504049679,15345.157886788083,31.00979443907103,1860.5923028738653,20314060.0,-14.847079937186871,-0.12583721956742855,13.6157504784037,13.6157504784037,14888.9,12682.099999999999,19361.3877856,14843.4,19345.5,1,531.0,2.591862540852282,79407112.95808513
2017-12-23,14396.5,13665.0,15493.2,13356.1,170170.0,19345.5,0.1,14564.533333333333,49.59601491965991,-624.2768008858825,20210.79127880681,11697.22872119319,15254.80951661779,39.1421805689891,1880.3428526685893,20484230.0,-3.010765727528731,0.05353091840468349,13.061111052468233,13.061111052468233,14888.9,12682.099999999999,18682.532762752,14843.4,19345.5,0,532.0,2.5928230621138275,80088892.83844335
2017-12-24,13790.0,14396.6,14413.7,12166.5,182420.0,19345.5,0.1,13950.5,46.990353591982654,-712.5046037765501,19968.70518751329,12155.924812486706,15115.303848368478,32.39947081123748,1906.546934620833,20301810.0,-8.430502802199264,-0.04212829507171878,13.825576030607929,13.825576030607929,14888.9,12682.099999999999,18057.98614173184,14843.4,19345.5,0,533.0,2.593766122315008,80765403.12680389
2017-12-25,13833.5,13790.0,14467.4,13010.7,107480.0,19345.5,0.1,14006.666666666666,47.20459845513686,-743.722423085891,19683.880179189768,12657.389820810233,14993.227291381005,32.883078188751405,1874.415010719345,20409290.0,-17.325564022112655,0.0031544597534445273,13.549824778395525,13.549824778395525,14910.175,12682.099999999999,17483.40325039329,14843.4,19345.5,0,534.0,2.594708952298786,81447507.54191025
2017-12-26,15756.6,13830.2,16094.7,13748.5,143140.0,19345.5,0.1,14460.033333333335,55.724198982813824,-615.9242247267066,19612.334143848955,12929.635856151046,15065.929454106623,54.26297123925781,1908.113938525106,20552430.0,-7.7693032621357005,0.13901760219756398,12.109934494276088,12.109934494276088,14847.075,12682.099999999999,16954.786990361827,14843.4,19345.5,0,535.0,2.595698845351213,82165975.29249597
2017-12-27,15416.6,15757.0,16514.6,14534.7,138710.0,19345.5,0.1,15002.233333333335,54.06313599667856,-538.1791989685269,19549.364583855084,12849.235416144915,15099.32664895361,50.48305150696506,1913.2415143447413,20413720.0,-5.342977134857669,-0.021578259269131705,12.410268894209755,12.410268894209755,15086.675,12682.099999999999,10875.7,14843.4,19345.5,0,536.0,2.596679164803862,82884536.49973142
2017-12-28,14398.7,15416.3,15505.5,13466.1,170370.0,19345.5,0.1,15190.633333333333,49.32288220733847,-537.9174298684554,19557.723131431387,12675.986868568612,15032.600301434219,39.166638873139235,1922.2528347486882,20243350.0,-12.565050795790603,-0.0660262314647847,13.350183243964302,13.350183243964302,14784.575,12682.099999999999,10988.478000000001,14843.4,19345.5,0,537.0,2.59763262682884,83591655.13024846
2017-12-29,14392.6,14398.5,15109.8,13951.1,118880.0,19345.5,0.1,14735.966666666667,49.29498809598353,-520.4376524274455,19573.943547000403,12614.686452999596,14971.647891773817,39.098822666177504,1867.7133465523532,20124470.0,-18.246160138144138,-0.000423649357233713,12.976900258135105,12.976900258135105,14730.95,12682.099999999999,11099.000440000002,14843.4,19345.5,0,538.0,2.5985845184583445,84303788.85780957
2017-12-30,12531.5,14392.1,14461.5,11962.1,182070.0,19345.5,0.1,13774.266666666668,41.570437291204776,-610.2778634421795,19758.491096296468,12177.328903703532,14739.252854462025,18.408209096265658,1912.8338217986134,19942400.0,-35.2226616008891,-0.12930950627405757,15.264204778347471,15.264204778347471,14534.15,12682.099999999999,11207.312431200002,12531.5,19345.5,0,539.0,2.5994835190266308,84986458.25585769
2017-12-31,13850.4,12532.4,14241.8,12359.4,111270.0,19345.5,0.1,13591.5,47.811674291621664,-558.3434741345179,19705.208121282318,11942.40187871768,14654.60020165612,35.644786349366115,1910.6599773844266,20053670.0,-27.354358874838063,0.10524677811913974,13.794980487093705,13.794980487093705,14805.75,12682.099999999999,11313.458182576001,12531.5,19345.5,0,540.0,2.600418358414563,85698972.75737579
2018-01-01,13444.9,13850.5,13921.5,12877.7,78430.0,19345.5,0.1,13275.6,46.178467314774764,-529.0446002485847,19610.121233243448,11673.588766756553,14539.390658641252,31.53824435633354,1848.7414075712531,19975240.0,-29.13405333038166,-0.029277132790388682,13.750503221081994,13.750503221081994,14805.75,12682.099999999999,11417.481018924482,12531.5,19345.5,0,541.0,2.601340768098422,86408993.60927069
2018-01-02,14754.1,13444.9,15306.1,12934.2,137730.0,19345.5,0.1,14016.466666666667,51.892231448349,-404.83517648254247,19539.899381082218,11590.540618917777,14559.839167342085,55.901641707144826,1886.1098784590208,20112970.0,-15.804881389204336,0.09737521290600903,12.783632200263117,12.783632200263117,14805.75,12682.099999999999,11519.423398545992,12531.5,19345.5,0,542.0,2.6022963097630556,87147763.35854566
2018-01-03,15156.6,14754.1,15435.0,14579.7,106540.0,19345.5,0.1,14451.866666666667,53.52574686686536,-284.5896965412456,19455.828521207095,11543.48147879291,14616.673532357125,66.61738846267566,1812.4806014262335,20219510.0,-7.929777669784957,0.027280552524383106,11.95835874421858,11.95835874421858,14805.75,12849.449999999999,11619.326930575073,12531.5,19345.5,0,543.0,2.6032604307408174,87898845.73900741
2018-01-04,15180.1,15156.5,15408.7,14244.7,110970.0,19345.5,0.1,15030.266666666668,53.62475728207011,-196.67046365160263,19215.946965950876,11540.893034049122,14670.333195942161,76.33403678022312,1766.1605584672168,20330480.0,-2.891486108712201,0.001550479659026438,11.634709642671766,11.634709642671766,14805.75,13144.9,11717.232391963571,12531.5,19345.5,0,544.0,2.6042237051935935,88655839.2285628
2018-01-05,16954.8,15180.1,17126.9,14832.4,141960.0,19345.5,0.1,15763.833333333334,60.47333523474207,-21.415822971679347,18725.714788884958,11792.05521111504,14887.901462995289,96.6678283767038,1803.899090005273,20472440.0,24.074643249176724,0.11690963827642764,10.639459563104685,10.639459563104685,14958.825,13233.75,11813.1797441243,12531.5,19345.5,0,545.0,2.60522657501995,89447400.34972036
2018-01-06,17172.3,16954.8,17252.8,16286.6,83930.0,19345.5,0.1,16435.733333333334,61.22901883074664,100.06376637983209,18297.41184238002,12031.018157619983,15105.463228424309,98.47846220726936,1744.0634407191817,20556370.0,19.281075261348242,0.012828225635218349,10.156260027597828,10.156260027597828,14990.3,13494.9,12025.728554359328,12531.5,17172.3,0,546.0,2.6062327083058405,90248393.90519601
2018-01-07,16228.2,17174.5,17184.8,15791.1,79010.0,19345.5,0.1,16785.100000000002,56.205881968868475,107.11137069025466,17685.53066901879,12368.489330981207,15212.390540002945,80.63394257848681,1719.0374806678115,20477360.0,17.680928208846996,-0.05497807515591957,10.592902975485954,10.592902975485954,14990.3,13664.75,12339.352841097769,12531.5,17172.3,0,547.0,2.6072164140344474,91040438.42744379
2018-01-08,14976.2,16228.3,16302.9,13902.3,142450.0,19345.5,0.1,16125.566666666666,50.31128476815845,22.172189459642993,17298.938800084543,12500.331199915458,15189.896202859807,56.96977715614193,1767.7205177629678,20334910.0,8.26038240503127,-0.07714965307304567,11.803531722085493,11.803531722085493,15089.625,13664.75,12634.159670631903,12531.5,17172.3,0,548.0,2.6081689280697655,91816803.80064164
2018-01-09,14778.5,14976.2,15324.6,14613.4,71400.0,19345.5,0.1,15327.633333333331,49.429733331018625,-48.737446574251294,17105.231792471932,12525.68820752807,15150.715612111255,53.2330315459202,1692.2547664941844,20263510.0,-6.207557467981673,-0.013200945500193684,11.450788418947692,11.450788418947692,15219.2,13773.0,12911.27809039399,12531.5,17172.3,0,549.0,2.6091151137256103,92595184.9484031
2018-01-10,15043.0,14778.5,15045.4,13613.1,87070.0,19345.5,0.1,14932.566666666666,50.6749739082033,-77.52882846694479,17047.986252331706,12524.02374766829,15140.456982386373,58.232370007749445,1673.6865688874568,20350580.0,-2.423361830753865,0.01789762154481167,11.126015880392586,11.126015880392586,15233.325,13844.849999999999,13171.76940497035,12531.5,17172.3,0,550.0,2.610066469287632,93384017.36073741
2018-01-11,13535.4,15046.7,15109.1,13048.3,167810.0,19345.5,0.1,14452.299999999997,44.02124001438835,-191.32659098453206,17055.016893086,12504.033106913997,14987.59441263529,29.73708582985238,1701.3375282526383,20182770.0,-5.995680165570509,-0.1002193711360766,12.569540081952793,12.569540081952793,15261.849999999999,13844.849999999999,17252.8,12531.5,17172.3,0,551.0,2.61097733295,94149427.75445077
2018-01-12,13886.7,13529.2,14176.4,13410.0,82370.0,19345.5,0.1,14155.033333333333,45.80687542635381,-233.3725120045811,17057.369552578093,12450.700447421907,14882.747325717643,36.377038955147725,1634.5562762345928,20265140.0,-3.515000764281642,0.025954164634957255,11.77066024494367,11.77066024494367,15099.474999999999,13885.4,17168.71,12531.5,17172.3,0,552.0,2.6118963186850035,94927243.57087597
2018-01-13,14292.2,13896.0,14640.7,13888.2,61140.0,19345.5,0.1,13904.766666666665,47.87379242685116,-224.25083164050235,17050.623291751897,12507.666708248102,14826.504723268343,39.498099480933526,1571.6593993606932,20326280.0,14.050193512348885,0.02920060201487762,10.996623328533698,10.996623328533698,15049.7,13885.4,17086.301799999997,12531.5,17172.3,0,553.0,2.6128245830599104,95718545.23019102
2018-01-14,13695.2,14291.9,14446.1,13094.7,85120.0,19345.5,0.1,13958.033333333333,45.143896779664615,-247.00255853818126,17055.990237065205,12488.469762934794,14718.761416290405,18.685287193435585,1555.9265851206437,20241160.0,-1.1205452550106778,-0.04177103594967879,11.361108893047518,11.361108893047518,14747.599999999999,13885.4,17005.541763999998,12531.5,17172.3,0,554.0,2.6137356949581525,96503372.54767314
2018-01-15,13697.5,13695.5,14396.6,13475.4,73270.0,19345.5,0.1,13894.966666666667,45.15687181712292,-249.7303417772829,16951.899355320016,12386.650644679983,14621.498424262747,17.67470939656369,1510.5889718977407,20314430.0,1.87877931408936,0.0001679420526898845,11.028209322122583,11.028209322122583,14602.65,14012.15,16926.396928719998,12531.5,17172.3,0,555.0,2.6146455116527747,97293668.29005504
2018-01-16,11362.0,13704.4,13711.0,10050.7,317100.0,19345.5,0.1,12918.233333333332,35.87709288029804,-388.3882586633678,17135.232091043104,11797.857908956892,14311.070002904391,18.20718956970883,1664.1397596193308,19997330.0,-22.99089744545584,-0.17050556670925354,14.646538986264131,14.646538986264131,13414.275,14308.599999999999,16848.8349901456,12531.5,17172.3,1,556.0,2.6154849072306217,98035803.32408382
2018-01-17,11192.3,11357.7,11769.6,9271.3,361800.0,19345.5,0.1,12083.933333333332,35.309300513564736,-465.8743610899151,17333.15351839949,11279.296481600515,14014.044288342067,24.068157614483493,1723.7226339322358,19635530.0,-26.155602179908428,-0.014935750748107823,15.400968826177246,15.400968826177246,12780.0,14404.65,16576.909590539773,12531.5,17172.3,1,557.0,2.6163174678818186,98778280.69007446
2018-01-18,11245.4,11202.0,12004.7,10660.2,242450.0,19345.5,0.1,11266.566666666666,35.65246440629549,-485.67680837509874,17455.749543660408,10841.98045633959,13750.363879928538,24.733446094092592,1696.6353029370762,19877980.0,-25.920119103299722,0.004744333157617353,15.087371751445714,15.087371751445714,12726.125,14404.65,16138.573015107388,12531.5,17172.3,0,558.0,2.617150506697319,99526783.77913618
2018-01-19,11580.2,11229.6,11973.2,10901.5,170740.0,19345.5,0.1,11339.299999999997,37.889636638216,-449.2017895410559,17525.16765748913,10677.432342510867,13543.68160564963,28.928146338407586,1651.9970670129992,20048720.0,-31.69957770071012,0.029772173510946853,14.265704107122495,14.265704107122495,12726.125,14404.65,15726.536634200944,12531.5,17172.3,0,559.0,2.617993103237262,100288572.97103594
2018-01-20,12858.9,11579.2,13082.2,11567.3,143900.0,19345.5,0.1,11894.83333333333,45.66021456111717,-318.1039113585375,17517.148553261584,10586.301446738422,13478.464309873474,45.33518670626146,1642.2044193692138,20192620.0,-25.11835921804301,0.11042123624807854,12.770955675596,12.770955675596,12609.025,14447.199999999999,15339.222436148888,12531.5,17172.3,0,560.0,2.618873060197555,101086115.6322034
2018-01-21,11594.9,12857.1,12860.2,11164.5,206960.0,19345.5,0.1,12011.333333333334,40.293730766024936,-296.1147761184867,17579.789307328363,10338.660692671636,13299.077232742668,33.04511064338131,1646.0255322714129,19985660.0,-28.550917538605642,-0.0982976770952414,14.196116674325893,14.196116674325893,12609.025,14570.949999999999,14975.147089979955,12531.5,17172.3,0,561.0,2.6197135395340916,101858188.31018764
2018-01-22,10864.8,11597.5,11970.9,10136.8,201730.0,19345.5,0.1,11772.866666666663,37.54858501512089,-308.9184377868828,17604.80522390038,9924.71477609962,13067.241305814794,26.3244841656617,1659.4594228234548,19783930.0,-27.452891921849343,-0.0629673390887373,15.273722690003083,15.273722690003083,12560.375,14570.949999999999,14632.916264581158,12531.5,17172.3,0,562.0,2.6205287674463564,102615666.2211521
2018-01-23,10903.2,10869.0,11438.0,10056.6,188370.0,19345.5,0.1,11120.966666666665,37.78865126251083,-293.11039915593756,17528.93480657721,9575.24519342279,12861.142133832433,27.95402377608005,1639.5980354789224,19972300.0,-26.222553033122438,0.0035343494588029323,15.037769053845865,15.037769053845865,12548.0,14570.949999999999,14311.219288706288,12531.5,17172.3,0,563.0,2.6213440477173258,103378845.50201875
2018-01-24,11452.3,10899.4,11549.5,10584.5,136060.0,19345.5,0.1,11073.433333333332,41.26550909197111,-226.93804578319396,17369.207210434386,9362.192789565615,12726.96669251506,37.35996437013943,1591.4124615161422,20108360.0,-23.8695738881872,0.05036136180203954,13.896007452792386,13.896007452792386,12376.599999999999,14570.949999999999,14008.824131383912,12531.5,17172.3,0,564.0,2.622176180265126,104161625.50659859
2018-01-25,11203.0,11439.9,11740.9,10983.8,181810.0,19345.5,0.1,11186.166666666666,40.16788950729572,-183.1019648384754,16827.29183709461,9328.92816290539,12581.827007513626,35.97608671359929,1531.8187142649892,19926550.0,-17.23185129364481,-0.021768553041746963,13.673290317459513,13.673290317459513,12219.4,14570.949999999999,13724.572683500877,12531.5,17172.3,0,565.0,2.622998942922719,104942572.76717973
2018-01-26,11118.1,11203.1,11655.3,10389.4,253910.0,19345.5,0.1,11257.799999999997,39.77983059277574,-144.65483617773566,16107.918651110616,9442.881348889383,12442.424435369472,34.39490445859874,1512.8245203889185,19672640.0,-19.937062080983964,-0.007578327233776605,13.60686196732282,13.60686196732282,12415.725,14570.949999999999,13457.376322490825,12531.5,17172.3,0,566.0,2.6238176507428514,105726006.63980737
2018-01-27,11467.5,11118.0,11621.7,10908.4,163490.0,19345.5,0.1,11262.866666666667,42.252421798400285,-83.55515139417889,15510.03935638351,9564.69064361649,12349.574489143808,42.44028754734483,1455.715626075424,19836130.0,-19.763927177061618,0.03142623289950608,12.694271864621095,12.694271864621095,12415.725,14570.949999999999,13206.211743141375,12531.5,17172.3,0,567.0,2.624646494650682,106523866.4502973
2018-01-28,11795.1,11471.2,12112.7,11433.3,154630.0,19345.5,0.1,11460.233333333332,44.551256439335276,-12.661015704305896,15145.295199020788,9611.324800979211,12296.767394939636,49.24199559050203,1400.2645099271797,19990760.0,-13.87420410070682,0.028567691301504272,11.871578112327828,11.871578112327828,12415.725,14570.949999999999,12970.117038552893,12531.5,11795.1,0,568.0,2.6254844389844187,107335510.79901667
2018-01-29,11244.8,11794.9,11888.1,11119.0,137420.0,19345.5,0.1,11502.466666666665,41.55848232088227,4.659034274055102,14777.692412064387,9625.557587935613,12196.580023993003,44.45120165776966,1355.1813306466668,19853340.0,-17.90618726044899,-0.046654966893031946,12.051626802136694,12.051626802136694,12360.225,14570.949999999999,12748.18801623972,12531.5,11795.1,0,569.0,2.6263035455535553,108137232.07437193
2018-01-30,10166.0,11244.5,11277.2,9917.7,264720.0,19345.5,0.1,11068.633333333331,36.396674868123746,-46.24631461810452,14326.813512033965,9588.736487966034,12003.191450279384,23.477393791492833,1355.4898070290476,19588620.0,-10.526315789473683,-0.09593767785998852,13.333560958381346,13.333560958381346,12138.625,14570.949999999999,12539.574735265336,12531.5,11795.1,0,570.0,2.6270843323144493,108911906.34005508
2018-01-31,10265.4,10166.3,10397.7,9742.2,208470.0,19345.5,0.1,10558.733333333332,37.17101592792092,-61.950103055006934,14156.574932586907,9431.975067413092,11837.687502633727,15.664670658682603,1305.4905350984013,19797090.0,-8.281586447825735,0.009777690340350143,12.717385928443134,12.717385928443134,12094.75,14570.949999999999,12343.478251149416,12531.5,11795.1,0,571.0,2.6278674879704695,109694212.75556651
2018-02-01,9181.1,10266.2,10303.0,8789.2,358400.0,19345.5,0.1,9870.833333333332,32.51997250470242,-130.16678867185374,13977.490916453056,9140.499083546945,11584.679169049563,9.128814348940127,1320.3697825913728,19438690.0,-18.356839240934065,-0.10562666822530042,14.381389839903418,14.381389839903418,11718.975,14329.9,12159.14755608045,12531.5,11795.1,0,572.0,2.6286084337431204,110445227.55843712
2018-02-02,8893.2,9179.8,9201.4,7915.8,519400.0,19345.5,0.1,9446.566666666666,31.396645740703747,-176.60044560864367,13631.018776518453,8947.071223481547,11328.347819616272,18.918395788169722,1317.886226691989,18919290.0,-23.203398905027544,-0.0313578982910544,14.81903281936748,14.81903281936748,11061.8,13893.199999999999,11889.551751594014,12531.5,11795.1,1,573.0,2.629336520184938,111190077.90267935
2018-02-03,9241.1,8894.4,9506.9,8249.3,248710.0,19345.5,0.1,9105.133333333331,34.34786995114632,-165.9690143581529,13295.09536333625,8837.58463666375,11129.562312986152,26.804061160100318,1313.580067642561,19168000.0,-28.13459938252883,0.039119776908199455,14.214542290880534,14.214542290880534,10817.225,13893.199999999999,11492.176576434613,12531.5,11795.1,0,574.0,2.630077543627649,111951445.32050516
2018-02-04,8222.2,9241.5,9382.1,7932.1,280940.0,19345.5,0.1,8785.5,30.244296940552857,-206.97531451028112,13006.347176060604,8578.802823939397,10852.67066413033,7.300626653005802,1323.3243485252353,18887060.0,-29.087788596710613,-0.11025743688521927,16.094528818628046,16.094528818628046,10763.35,13893.199999999999,11134.538918791151,12531.5,11795.1,0,575.0,2.6307745451399636,112678742.02610871
2018-02-05,6938.5,8220.8,8383.2,6651.9,593890.0,19345.5,0.1,8133.933333333332,26.025587964418776,-294.6247050731522,13330.211987069813,7812.588012930186,10479.892505641727,5.248315265162619,1352.4654664877187,18293170.0,-36.13780281275311,-0.1561260976381018,19.492188030377154,19.492188030377154,10131.4,13261.25,10812.665026912036,6938.5,11795.1,1,576.0,2.6314081770308673,113353855.13776872
2018-02-06,7701.2,6939.3,7896.2,5996.6,886880.0,19345.5,0.1,7620.633333333332,32.086872774425046,-275.6463786558156,13406.773908446194,7386.916091553805,10215.25512415204,27.87070191788884,1391.5465045957387,19180050.0,-29.367525130237,0.10992289399726163,18.0692165454181,18.0692165454181,9630.5,12933.599999999999,10313.373223682593,6938.5,11795.1,1,577.0,2.6320790015044158,114066635.46722612
2018-02-07,7594.7,7693.8,8536.5,7196.6,445620.0,19345.5,0.1,7411.466666666664,31.696326369736042,-245.67279972425854,13431.88519439719,6996.734805602813,9965.678445661368,26.129396183842633,1387.8574685531858,18734430.0,-33.68406346323446,-0.013829013660208833,18.27402620976715,18.27402620976715,9477.775000000001,12608.849999999999,9709.02497236703,6938.5,11795.1,0,578.0,2.632743639743737,114778287.64331928
2018-02-08,8164.2,7595.1,8489.9,7595.1,296100.0,19345.5,0.1,7820.033333333332,36.17033310767354,-166.67819532099884,13315.13936097598,6771.880639024018,9794.109069884094,35.44088553162962,1352.6676493708153,19030530.0,-27.1248772650183,0.07498650374603333,16.568281636545105,16.568281636545105,9209.25,12509.3,9189.285476235646,6938.5,11795.1,0,579.0,2.6334336927291977,115517657.04405607
2018-02-09,8699.8,8163.6,8735.6,7784.6,233940.0,19345.5,0.1,8152.899999999998,40.14142955904546,-62.88271502312091,12886.195045941196,6784.914954058804,9689.889158466562,44.19810009646668,1323.9771029871856,19264470.0,-21.75101860929476,0.06560348840057806,15.21847747059916,15.21847747059916,9173.2,11905.099999999999,8742.309509562656,6938.5,11795.1,0,580.0,2.6341459128767246,116282231.82219906
2018-02-10,8559.6,8697.3,9066.6,8172.2,263530.0,19345.5,0.1,8474.533333333331,39.44956324561509,8.031688441007418,12670.565434410848,6697.014565589154,9582.242571945937,41.90578963718709,1293.2930242023867,19000940.0,-25.357750163505553,-0.016115312995700903,15.10926940747683,15.10926940747683,8802.775,11649.2,5996.6,6938.5,11795.1,0,581.0,2.6348510587544154,117045325.04677902
2018-02-11,8081.9,8559.7,8564.2,7843.7,236200.0,19345.5,0.1,8447.099999999999,37.10301004176596,33.06265236690797,12557.556475948159,6531.733524051842,9439.352803189182,35.39506068064159,1252.3792367593592,18764740.0,-31.48086917448772,-0.05580868264872196,15.49609914450017,15.49609914450017,8645.575,11624.7,6058.0,6938.5,11795.1,0,582.0,2.6355340708480477,117792781.21687736
2018-02-12,8903.5,8083.6,8984.9,8083.6,238670.0,19345.5,0.1,8514.999999999998,43.34491270327559,110.86553493514293,12402.822707763065,6486.497292236934,9388.319202885452,55.04866871188879,1227.4235769908337,19003410.0,-20.821179567444503,0.10165926329204766,13.785854742414037,13.785854742414037,8614.375,11624.7,6118.172,6938.5,11795.1,0,583.0,2.6362514066578044,118577280.95843747
2018-02-13,8539.2,8906.2,8942.7,8378.0,195870.0,19345.5,0.1,8508.199999999999,41.38380703828978,141.73222557776603,12131.620924882882,6466.389075117117,9307.45070737255,57.77192065619959,1180.0861786343455,18807540.0,-16.002360810544946,-0.04091649351378668,13.819633907559789,13.819633907559789,8535.5,11624.7,6177.14056,6938.5,11795.1,0,584.0,2.6369523343141172,119351503.69681232
2018-02-14,9476.3,8542.6,9500.0,8541.6,246880.0,19345.5,0.1,8972.999999999998,47.91225394644523,224.29140877901864,11909.917738047085,6515.4222619529155,9323.531592384688,80.80299089726915,1164.4228801604636,19054420.0,-7.686987355582836,0.10974095934045325,12.287737620806261,12.287737620806261,8643.85,11624.7,6234.9297488,6938.5,11795.1,0,585.0,2.637690213064078,120165990.4949347
2018-02-15,10037.3,9475.6,10206.8,9348.5,291280.0,19345.5,0.1,9350.933333333332,51.401838419208595,310.40952720811265,11741.909757285322,6575.35024271468,9391.509535967098,95.97406298988172,1142.556960149002,19345700.0,9.32567992942021,0.059200320800312456,11.383110598955914,11.383110598955914,9065.050000000001,11624.7,6365.532558848,6938.5,11795.1,0,586.0,2.6384479561608485,121005110.00497252
2018-02-16,10178.7,10031.3,10294.3,9707.7,206440.0,19345.5,0.1,9897.433333333332,52.269804189589365,366.7584853786965,11502.230007059708,6686.1499929402935,9466.480056351184,97.31018917095194,1102.8457487097874,19552140.0,14.454864390770474,0.014087453797336114,10.834838915674764,10.834838915674764,8999.675000000001,11624.7,6596.00860531712,6938.5,11795.1,0,587.0,2.639209635683342,121853916.11276297
2018-02-17,11073.5,10177.3,11095.9,10070.9,224760.0,19345.5,0.1,10429.833333333332,57.44890907307658,448.73911626861593,11320.409772267176,6795.810227732825,9619.529574793929,99.56072402094405,1097.2853380876597,19776900.0,19.828808258757068,0.08790906500830165,9.909110381430079,9.909110381430079,9247.45,11624.7,6891.8719168917505,6938.5,11795.1,0,588.0,2.6400009046076938,122737488.08007005
2018-02-18,10398.8,11073.7,11271.6,10137.2,288910.0,19345.5,0.1,10550.333333333332,52.79691202437743,441.30303233478594,11140.43006099917,6891.18993900083,9693.745805765937,83.45402843601893,1099.9363853671125,19487990.0,26.472233708739733,-0.06092924549600409,10.577531882208644,10.577531882208644,9306.150000000001,11624.7,7312.274725202576,6938.5,11795.1,0,589.0,2.640768017574166,123603822.49802679
2018-02-19,11169.4,10396.6,11250.5,10324.8,215200.0,19345.5,0.1,10880.566666666666,57.072503332713225,469.44194628497155,11339.07147602997,6792.8885239700285,9834.284300454896,98.06255924170615,1087.4909292694617,19703190.0,60.9771564459177,0.07410470438896799,9.736341515833095,9.736341515833095,9306.150000000001,11624.7,7787.393758178267,6938.5,11795.1,0,590.0,2.64156003290893,124500875.42323257
2018-02-20,11238.7,11169.7,11791.5,11119.9,267560.0,19345.5,0.1,10935.633333333331,57.44580256128242,472.57821055074794,11525.846464394901,6703.4435356051,9968.03817660205,87.96927027791683,1057.7844343216432,19970750.0,45.93439983379215,0.006204451447705539,9.411982118231139,9.411982118231139,9496.1,11624.7,8205.498507196875,6938.5,11795.1,0,591.0,2.642353095246266,125405508.2520368
2018-02-21,10473.0,11240.9,11289.7,10252.2,327140.0,19345.5,0.1,10960.366666666667,52.05904059274467,405.51403959857424,11662.251247175516,6696.228752824483,10016.129778830425,68.58021160995138,1056.3355461558115,19643610.0,37.8987978458662,-0.06813065568081722,10.08627466968215,10.08627466968215,9569.7,11624.7,8707.538716189312,6938.5,11795.1,0,592.0,2.643119219150423,126289766.13989593
2018-02-22,9841.7,10470.1,10930.2,9743.9,316630.0,19345.5,0.1,10517.799999999997,48.05779549875769,305.6180560136139,11722.212075312367,6731.117924687634,9999.517418941812,51.338940327934324,1065.6187214303966,19326980.0,20.54702236593911,-0.06027881218371045,10.827587931255742,10.827587931255742,9610.6,11624.7,9139.29329592281,6938.5,11795.1,0,593.0,2.643861502007727,127156245.95387873
2018-02-23,10170.4,9840.6,10419.1,9597.8,271500.0,19345.5,0.1,10161.699999999999,50.20386237391407,250.94883275326526,11802.399597413474,6743.860402586528,10015.791950471164,58.936622929226395,1048.1673841853683,19598480.0,16.903836869813105,0.03339870144385615,10.30605860325423,10.30605860325423,9756.175,11624.7,9510.602234493615,6938.5,11795.1,0,594.0,2.6446146014346943,128039676.74763013
2018-02-24,9704.3,10163.8,10506.1,9394.5,239160.0,19345.5,0.1,9905.466666666665,47.22429997756972,176.19847534249703,11835.51336728532,6858.956632714677,9986.126050426292,47.13004711484876,1052.698285314985,19359320.0,13.373288471423885,-0.04582907260284752,10.847750845655895,10.847750845655895,9743.525,11624.7,11791.5,6938.5,11795.1,0,595.0,2.6453494492475977,128910612.08212137
2018-02-25,9585.2,9703.1,9860.3,9330.1,196490.0,19345.5,0.1,9819.966666666665,46.46543810616061,114.52332671518113,11709.458704038861,7249.681295961139,9947.94261705236,40.49731654035978,1015.3769792210575,19162830.0,18.600824063648414,-0.012272909947136701,10.593174677847696,10.593174677847696,9727.425,11624.7,11743.56,9585.2,11795.1,0,596.0,2.646078656252478,129781690.14086698
2018-02-26,10285.1,9590.9,10378.4,9410.3,235940.0,19345.5,0.1,9858.199999999999,51.40716103423035,116.28222368823734,11707.072409580425,7510.457590419577,9980.052843999754,55.86934231726967,1012.0000521338391,19398770.0,15.517493120682882,0.07301882068188448,9.839477031179463,9.839477031179463,9727.425,11624.7,11647.0216,9585.2,11795.1,0,597.0,2.6468323755577914,130684080.12700203
2018-02-27,10594.4,10287.8,10867.2,10120.5,202580.0,19345.5,0.1,10154.9,53.45206613089366,132.51593703971506,11681.226447189954,7836.273552810046,10038.562096952159,63.16502046216806,993.0500484099936,19601350.0,24.067828367996988,0.030072629337585477,9.373348640885691,9.373348640885691,9727.425,11590.7,11554.344736000001,9585.2,11795.1,0,598.0,2.647595710533518,131602806.64982705
2018-02-28,10333.9,10584.4,11070.7,10303.4,215220.0,19345.5,0.1,10404.466666666665,51.48685271333825,120.3058513255361,11657.900036543717,8076.569963456283,10066.689516290047,40.78166896887947,976.925044952137,19386130.0,9.049945653894458,-0.02458846182889074,9.453594915299519,9.453594915299519,9727.425,11149.75,11465.374946560001,9585.2,11795.1,0,599.0,2.648348816727618,132517268.1186674
2018-03-01,10904.5,10335.1,11047.8,10248.7,188770.0,19345.5,0.1,10610.933333333332,55.35847489824754,143.67247530262804,11738.28716609082,8216.652833909178,10146.48099092909,63.963597952384816,964.2232560269842,19574900.0,8.639773644306743,0.05521632684659239,8.842434371378644,8.842434371378644,9601.975,10660.6,11379.963948697601,9585.2,11795.1,0,600.0,2.6491203002166586,133457562.09415701
2018-03-02,10827.7,10904.5,11167.0,10677.1,201690.0,19345.5,0.1,10688.699999999999,54.725426649686376,146.46996044968816,11761.66566896488,8420.08433103512,10211.358991792988,60.84342244251241,930.3430234536282,19373210.0,6.376059811174314,-0.0070429639139804046,8.59224972481347,8.59224972481347,9571.3,10552.85,11297.969390749697,9585.2,11795.1,0,601.0,2.649888032790506,134400557.821857
2018-03-03,11402.3,10822.5,11420.7,9585.5,172200.0,19345.5,0.1,11044.83333333333,58.5450309596493,177.4654506176237,11746.210914740763,8767.579085259238,10324.781944955559,84.18786056715686,994.975664635512,19545410.0,2.9692509143450514,0.053067595149477675,8.726096179152558,8.726096179152558,9634.725,10552.85,9330.1,9585.2,11795.1,0,602.0,2.650673372996818,135369150.73460773
2018-03-04,11416.5,11402.8,11490.3,10878.4,156400.0,19345.5,0.1,11215.499999999998,58.6379006479424,188.34217077133854,11816.94778509912,8948.14221490088,10428.75509305503,84.76476801820102,967.6131171615468,19701810.0,9.7867061584029,0.0012453627776851661,8.475567092905417,8.475567092905417,9952.125,10318.650000000001,9371.912,9585.2,11416.5,0,603.0,2.6514579688659676,136343949.31090707
2018-03-05,11330.6,11415.7,11506.9,11281.2,162110.0,19345.5,0.1,11383.133333333331,57.79442443666576,179.22124194905905,11738.572853400652,9305.657146599351,10514.645084192647,81.27488421223696,914.6193230785791,19539700.0,1.4432288216018831,-0.007524197433539159,8.072117302513362,8.072117302513362,10055.9,10318.650000000001,9456.64752,9585.2,11416.5,0,604.0,2.6522386277673378,137321508.96189865
2018-03-06,10675.1,11314.2,11316.4,10412.0,230650.0,19345.5,0.1,11140.733333333332,51.68471235838101,121.28528555427783,11700.685222146765,9463.424777853235,10529.926504745728,61.787945608232285,914.9036571443949,19309050.0,-5.014814880724642,-0.05785218788060653,8.570445777036232,8.570445777036232,10123.324999999999,10221.35,9579.6626688,9585.2,11416.5,0,605.0,2.6529964696053026,138281074.19020024
2018-03-07,9902.9,10779.0,10899.0,9422.1,284540.0,19345.5,0.1,10636.199999999999,45.57273571430043,28.066159083342797,11708.495024489093,9442.174975510909,10470.209694769945,26.313855200293986,955.0462530626522,19024510.0,-5.443521436073716,-0.0723365589081133,9.644106807729576,9.644106807729576,10141.05,10196.6,11506.9,9585.2,11416.5,0,606.0,2.653725906813915,139215996.00658113
2018-03-08,9300.0,9910.7,10109.0,9037.0,256260.0,19345.5,0.1,9959.333333333332,41.45121905416537,-71.64071216524289,11784.461256284034,9278.338743715965,10358.761152410903,10.648204380744161,963.4000921296056,18768250.0,-5.504130383978385,-0.06088115602500277,10.359140775587157,10.359140775587157,10044.775000000001,9853.8,11465.204,9585.2,11416.5,0,607.0,2.65443143116252,140130675.07523447
2018-03-09,9217.0,9301.9,9420.5,8351.0,371460.0,19345.5,0.1,9473.299999999997,40.902787595312134,-136.84509011005875,11788.55706636241,9088.592933637592,10250.021995038436,27.440666687791126,970.9786569774909,18396790.0,-9.374262565877444,-0.008924731182795687,10.534649636296962,10.534649636296962,9933.25,9539.400000000001,11368.07584,9585.2,11416.5,0,608.0,2.655132597931136,141046510.2222914
2018-03-10,8762.0,9216.2,9500.0,8691.1,198730.0,19345.5,0.1,9092.999999999998,37.939368109796845,-200.43412573834217,11892.158320488563,8821.311679511438,10108.305614558585,13.023226337970152,959.4016100505272,18198060.0,-9.710128499737223,-0.049365303244005676,10.949573271519371,10.949573271519371,10000.1,9539.400000000001,11187.0512896,9585.2,11416.5,0,609.0,2.655814316390352,141946446.9903486
2018-03-11,9529.6,8732.2,9719.6,8516.4,266590.0,19345.5,0.1,9169.533333333333,45.15810085953482,-181.1969480737855,11802.940312746417,8746.549687253584,10053.190794124435,37.34592350834946,976.8157807612039,18464650.0,-0.5800609272628673,0.08760556950467935,10.250333495227542,10.250333495227542,10000.1,9539.400000000001,11016.888212224,9585.2,11416.5,0,610.0,2.6565253750126114,142885409.68019426
2018-03-12,9137.4,9535.8,9892.2,8804.1,257910.00000000003,19345.5,0.1,9142.999999999998,42.44169418483308,-184.65709116747257,11707.241438902563,8632.118561097437,9965.972623255442,24.918406793624634,984.7646535639751,18206740.0,-11.15886087641346,-0.04115597716588326,10.777296096963854,10.777296096963854,10000.1,9539.400000000001,10856.934919490559,9585.2,11416.5,0,611.0,2.6572201024543736,143811968.90387204
2018-03-13,9154.9,9138.7,9482.0,8875.1,239460.0,19345.5,0.1,9273.966666666665,42.60758744559321,-175.5951210445077,11695.716075385682,8511.833924614317,9888.727611516828,25.47292373015621,957.7743211665484,18446200.0,-13.587366910820812,0.001915205638365336,10.46187638495831,10.46187638495831,10000.1,9428.400000000001,10706.578824321125,9585.2,11416.5,0,612.0,2.6579144281746605,144744097.79352766
2018-03-14,8210.6,9154.9,9353.4,7958.5,305450.0,19345.5,0.1,8834.3,36.49517301276793,-220.13918865876505,11814.078579910849,8230.36142008915,9728.905934229511,7.104610528688998,988.9975839403662,18140750.0,-20.546937748575072,-0.10314694862860319,12.04537529462361,12.04537529462361,9756.225,9054.650000000001,10565.244094861857,9585.2,11416.5,0,613.0,2.6585682672968423,145635488.95003995
2018-03-15,8264.4,8210.2,8427.0,7691.7,326530.0,19345.5,0.1,8543.299999999997,37.04926721736047,-231.74925657831534,11873.204557406785,7980.635442593215,9589.429178588605,15.011008597190184,970.8763279446258,18467280.0,-24.211105506900825,0.00655250529802931,11.747692850595637,11.747692850595637,9518.475,9054.650000000001,10356.70456727291,9585.2,11416.5,0,614.0,2.6592234195542854,146533915.51129523
2018-03-16,8289.2,8264.3,8604.8,7929.1,236130.0,19345.5,0.1,8254.733333333332,37.32075775441186,-223.43082139867136,11928.485420470766,7783.844579529236,9465.597828246835,15.66104005032504,949.7923045200096,18703410.0,-23.444498831700177,0.003000822806253467,11.458190229696587,11.458190229696587,9320.975,9054.650000000001,10090.204110545617,9585.2,11416.5,0,615.0,2.659878604917595,147437942.1793935
2018-03-17,7874.9,8198.0,8344.8,7760.2,208050.0,19345.5,0.1,8142.833333333332,34.63356373330487,-230.57074481835576,12014.677285484766,7526.622714515233,9314.102796985231,4.801845250576636,923.7071399114375,18495360.0,-30.93586381694921,-0.04998069777541869,11.729763424442693,11.729763424442693,9266.775000000001,9054.650000000001,9850.353699491056,7874.9,11416.5,0,616.0,2.6605142067877963,148324507.6563578
2018-03-18,8201.2,7873.2,8283.6,7323.3,348020.0,19345.5,0.1,8121.7666666666655,38.39579715868664,-199.2365021556318,11997.106189238775,7335.803810761221,9208.11205441521,20.984319724639082,926.3209156320492,18843380.0,-28.163622826610602,0.04143544679932454,11.294943613520571,11.294943613520571,9011.425,9054.650000000001,9634.48832954195,7874.9,11416.5,0,617.0,2.6611634504976593,149232580.1007232
2018-03-19,8616.8,8200.9,8698.3,8127.7,316960.0,19345.5,0.1,8230.966666666665,42.90338731605901,-139.27697266994454,11900.162551947436,7234.987448052565,9151.796620661382,32.39337857804711,900.9122788011884,19160340.0,-23.951070552309684,0.05067551090084366,10.455299865393053,10.455299865393053,9011.425,9054.650000000001,9357.145729996915,7874.9,11416.5,0,618.0,2.6618295071227513,150166270.83899397
2018-03-20,8912.6,8614.1,9039.6,8326.8,253440.0,19345.5,0.1,8576.866666666665,45.935554524893824,-71.84676131345782,11817.955971716794,7175.064028283206,9129.015990122203,44.447241099644835,887.4756874582465,19413780.0,-16.510383977667654,0.03432828892396267,9.957539746631134,9.957539746631134,9011.425,9054.650000000001,9113.084242397284,7874.9,11416.5,0,619.0,2.662506690455642,151119171.5084057
2018-03-21,8905.9,8912.4,9173.4,8775.1,218190.0,19345.5,0.1,8811.766666666665,45.8761265595627,-22.409964396663213,11637.661044139219,7155.498955860781,9107.766848205802,56.811573392684046,852.5345669255146,19195590.0,-10.0677579294954,-0.0007517447209569594,9.572694134512115,9.572694134512115,8908.875,8942.35,7323.3,7874.9,11416.5,0,620.0,2.6631825303358148,152076518.91909224
2018-03-22,8726.2,8903.7,9096.2,8499.1,223010.0,19345.5,0.1,8848.233333333332,44.22357982351624,2.1679713563576115,11449.870632116144,7133.139367883854,9071.427148376679,54.610922963135984,834.2892407165492,18972580.0,-6.1698924731182725,-0.020177635050921183,9.560739390760574,9.560739390760574,8876.725,8894.05,7360.302000000001,7874.9,11416.5,0,621.0,2.6638499451780513,153029716.95793107
2018-03-23,8916.8,8725.3,8917.0,8305.6,210110.0,19345.5,0.1,8849.633333333331,46.42785371736206,33.50317818923543,11099.522617695397,7234.937382304603,9056.700753293186,62.03044104480512,818.3685806653672,19182690.0,-3.2570250623847317,0.021842268112121976,9.177828152087827,9.177828152087827,8831.725,8894.05,7396.56396,7874.9,11416.5,0,622.0,2.664524092788044,153997142.35960612
2018-03-24,8547.4,8917.3,9008.8,8523.6,177430.0,19345.5,0.1,8730.133333333331,42.89007696454785,31.616816045736527,10671.935232350037,7375.614767649963,9008.195919646216,47.65074545525319,794.5708249035551,19005260.0,-2.4492125085596936,-0.041427417907769604,9.296052892149136,9.296052892149136,8831.725,8894.05,7432.1006808,7874.9,11416.5,0,623.0,2.665181917712499,154950622.7587892
2018-03-25,8473.2,8549.1,8679.0,8392.2,149520.0,19345.5,0.1,8645.8,42.194572211806275,27.773617536999666,10158.059279599816,7603.750720400184,8957.243927298958,44.762349643816435,758.301480267587,18855740.0,-11.085460040295496,-0.008681002410089511,8.949410851479806,8.949410851479806,8831.725,8894.05,7466.9266671840005,7874.9,11416.5,0,624.0,2.665835550584463,155904837.50257087
2018-03-26,8143.5,8474.0,8515.7,7865.9,247180.0,19345.5,0.1,8388.033333333333,39.15618335094208,6.53666392335623,9770.178904604461,7738.471095395541,8879.744505651439,37.995089637281694,750.551374534188,18608560.0,-10.877273622693542,-0.038910919133267274,9.216569958054743,9.216569958054743,8831.725,8894.05,7501.05613384032,7874.9,11416.5,0,625.0,2.666473839260346,156845836.91623837
2018-03-27,7801.7,8146.5,8218.3,7760.6,223100.0,19345.5,0.1,8139.466666666666,36.24249778390581,-25.276174327683066,9600.823045050394,7697.7069549496055,8777.073600351303,23.565341608787733,729.6334192103174,18385460.0,-14.781155446809905,-0.04197212500767489,9.352236297349519,9.352236297349519,8941.05,8894.05,7534.503011163514,7874.9,11416.5,0,626.0,2.6670956567551984,157771896.94817984
2018-03-28,7954.9,7803.0,8110.4,7754.5,167360.0,19345.5,0.1,7966.699999999998,38.453145705418656,-30.402737527287286,9530.222589876408,7633.7974101235895,8698.771352698797,34.13869520566454,702.938174981009,18552820.0,-3.1142669232455695,0.01963674583744557,8.836543199550077,8.836543199550077,8939.525000000001,8894.05,7567.280950940244,7874.9,11416.5,0,627.0,2.6677234661552336,158710993.16333956
2018-03-29,7129.2,7955.2,7980.7,6954.9,348750.0,19345.5,0.1,7628.5999999999985,32.01093595578047,-80.93593473199297,9571.698126278066,7383.541873721932,8549.288366727484,7.856659905341455,725.9997339109369,18204070.0,-13.73602439378539,-0.10379765930432816,10.183467063779062,10.183467063779062,8647.525,8894.05,9173.4,7874.9,11416.5,0,628.0,2.6683108176356756,159604406.95367646
2018-03-30,6853.7,7132.4,7288.1,6603.8,417310.0,19345.5,0.1,7312.5999999999985,30.193336846081905,-121.98314875940247,9675.201401348484,7089.208598651516,8387.803760372484,9.725249066002478,723.0211814887272,17786760.0,-17.31771461660957,-0.03864388711215849,10.549355552310828,10.549355552310828,8452.675,9197.65,9129.029999999999,7874.9,11416.5,0,629.0,2.668883018196112,160483550.88468307
2018-03-31,6938.2,6856.5,7221.5,6804.9,245300.0,19345.5,0.1,6973.7,31.478465474292534,-131.6805862736594,9578.68672791265,6926.583272087346,8249.746259384629,13.013698630136975,701.1339542395324,18032060.0,-11.894754219101193,0.012329106905758946,10.10541573087447,10.10541573087447,8383.2,9197.65,9028.020799999998,7874.9,11416.5,0,630.0,2.669458670708567,161371972.81783217
2018-04-01,6825.2,6939.1,7047.7,6460.1,257529.99999999997,19345.5,0.1,6872.366666666665,30.665437839698427,-133.52409742844338,9535.560952880773,6738.489047119226,8114.075187062283,13.45593926215308,693.0243860795656,17774530.0,-16.77803248305127,-0.016286644951140072,10.153905908684955,10.153905908684955,8207.0,9125.8,8931.051967999998,7874.9,11416.5,0,631.0,2.670027461130448,162256480.84743226
2018-04-02,7068.4,6825.4,7121.3,6787.6,199310.0,19345.5,0.1,6943.933333333332,34.58160694311785,-107.31209951691778,9423.220033656522,6642.179966343478,8014.487074008732,22.41919433899677,667.3583585024537,17973840.0,-17.969547859994428,0.03563265545331995,9.441434532602198,9.441434532602198,7927.049999999999,9125.8,8782.794849919997,7874.9,11416.5,0,632.0,2.6706078841724152,163160923.1471385
2018-04-03,7424.2,7067.2,7519.3,7032.9,230800.0,19345.5,0.1,7105.933333333332,39.92743393602953,-57.45907336428229,9405.85530328857,6580.90469671143,7958.269257436472,35.53237754763571,654.4327614665643,18204640.0,-16.699952875704067,0.05033670986361849,8.81485899445818,8.81485899445818,7832.025000000001,9125.8,8643.433158924798,7874.9,11416.5,0,633.0,2.6712049882842006,164092160.89594796
2018-04-04,6808.9,7423.8,7432.9,6726.9,239510.0,19345.5,0.1,7100.499999999997,34.653572702370624,-57.24405920444667,9417.204440698859,6424.005559301141,7848.805518632998,13.231667994385615,658.1161356475241,17965130.0,-23.54618848179297,-0.08287761644352254,9.665527994940799,9.665527994940799,7757.675,9125.8,8512.43316938931,7874.9,11416.5,0,634.0,2.6717700415725645,164986716.3211696
2018-04-05,6782.0,6808.7,6918.2,6592.5,221700.0,19345.5,0.1,7005.033333333333,34.43940058468367,-50.47167653063207,9410.238668325894,6280.251331674106,7747.204993048903,12.629968219092078,634.3721259584153,17743430.0,-22.280030253718692,-0.003950711568682097,9.353761810062155,9.353761810062155,7730.700000000001,9125.8,8389.293179225951,7874.9,11416.5,0,635.0,2.672332728173866,165883040.32307538
2018-04-06,6624.3,6783.7,6859.7,6523.4,174900.0,19345.5,0.1,6738.399999999999,33.146065680947785,-48.17659706735424,9435.449289926888,6129.98071007311,7640.261660377579,6.4425000980892175,613.0812598185286,17568530.0,-25.709895926789873,-0.02325272780890586,9.255034642430575,9.255034642430575,7698.275,9125.8,8273.541588472395,6624.3,11416.5,0,636.0,2.672886028653987,166771807.9856404
2018-04-07,6905.7,6624.5,7071.9,6616.1,177100.0,19345.5,0.1,6770.666666666665,37.64590955627488,-20.67597598239081,9401.255939923381,6034.624060076618,7570.303407008286,20.082022623822592,601.846884117205,17745630.0,-19.20701031892739,0.0424799601467325,8.715219081587747,8.715219081587747,7480.375,9125.8,8164.735093164051,6624.3,11416.5,0,637.0,2.673453321922284,167683987.41084105
2018-04-08,7030.5,6905.9,7113.4,6903.9,132510.0,19345.5,0.1,6853.499999999999,39.58799745967068,11.23464085640012,9294.316386551292,5982.933613448708,7518.893558721782,27.748589219692526,573.8221066802619,17878140.0,-17.02662512392013,0.01807202745558012,8.161896119483137,8.161896119483137,7448.225,9125.8,8062.456987574208,6624.3,11416.5,0,638.0,2.6740260916110845,168608503.4953404
2018-04-09,6781.9,7035.7,7192.5,6633.2,241190.0,19345.5,0.1,6906.033333333333,37.108580868270195,20.38142864482893,9118.94482247121,5945.235177528787,7448.7036959863735,18.302809691730147,572.7848133459574,17636950.0,-16.720083502179655,-0.03536021620083929,8.445786775770173,8.445786775770173,7403.225,9125.8,7966.315568319756,6624.3,11416.5,0,639.0,2.674585003016933,169519461.6270679
2018-04-10,6854.8,6782.6,6899.5,6671.6,134230.0,19345.5,0.1,6889.066666666666,38.32836373231492,35.25172518168347,8909.505162233057,5949.56483776694,7392.141439225767,23.916863600557477,548.1501838212462,17771180.0,-12.137098324724093,0.010749200076674681,7.9965890153067365,7.9965890153067365,7419.05,9125.8,7875.942634220571,6624.3,11416.5,0,640.0,2.6751468089906396,170439271.82528645
2018-04-11,6962.1,6855.6,6988.6,6818.4,142070.0,19345.5,0.1,6866.2666666666655,40.167792756335004,55.04486242574637,8707.573852465637,5975.086147534363,7351.1851116804555,33.01328422990926,521.1537421197287,17913250.0,-12.480358018328317,0.015653264865495675,7.485582541470658,7.485582541470658,7419.05,9125.8,7790.992076167337,6624.3,11416.5,0,641.0,2.675713239396193,171370380.82397938
2018-04-12,7926.6,6963.3,8009.6,6779.3,398300.0,19345.5,0.1,7247.833333333332,53.572565196758895,131.4649949414753,8487.187874087365,6096.452125912635,7405.98652961565,94.64343336560181,571.8070462540338,18311550.0,11.184985692644343,0.13853578661610721,7.2137744588352355,7.2137744588352355,7541.625,9125.8,6460.1,6624.3,11416.5,0,642.0,2.6763251879955967,172368925.0617587
2018-04-13,7887.4,7926.9,8228.0,7756.6,296950.0,19345.5,0.1,7592.033333333333,53.05233276296638,175.01833693163076,8345.187909319926,6172.4520906800735,7451.835431557017,80.7342044233271,564.6351143787457,18014600.0,15.082364270394091,-0.004945373804657871,7.158697598432255,7.158697598432255,7596.225,8983.5,6491.09,6624.3,11416.5,0,643.0,2.6769343692922494,173369491.89400688
2018-04-14,8004.4,7891.1,8180.2,7839.3,164710.0,19345.5,0.1,7939.466666666664,54.47336843338043,205.25769009617272,8232.491653928559,6238.26834607144,7504.4606285515865,87.35222580462694,548.6540347802638,18179310.0,15.367098094606668,0.014833785531353838,6.8544055117218505,6.8544055117218505,7596.225,8983.5,6560.5664,6624.3,11416.5,0,644.0,2.6775478307680087,174381815.2247275
2018-04-15,8363.6,8004.6,8411.5,8004.6,160260.0,19345.5,0.1,8085.133333333332,58.6149792727103,240.55571052014756,8287.243730616286,6205.526269383713,7586.283425832387,97.4630581007362,538.5430322959593,18339570.0,22.539998827873184,0.044875318574783885,6.439129469318945,6.439129469318945,7665.275,8983.5,6627.263744,6624.3,8363.6,0,645.0,2.6781760022851264,175420574.3355
2018-04-16,8070.0,8362.2,8412.9,7908.5,197700.0,19345.5,0.1,8145.999999999999,54.26925621997443,234.96557895796195,8335.281488450706,6184.318511549294,7632.351670991207,81.85234188938874,536.1042442748193,18141870.0,14.170109218493582,-0.035104500454349874,6.643175269824278,6.643175269824278,7650.6,8983.5,6734.31791936,6624.3,8363.6,0,646.0,2.6787903860909132,176446203.50427955
2018-04-17,7908.6,8070.0,8171.7,7852.8,162590.0,19345.5,0.1,8114.066666666666,51.98742307932685,211.94175087333207,8327.155267465703,6187.814732534298,7658.661035658712,73.3103995766076,520.5896553980464,17979280.0,6.524608712049791,-0.019999999999999907,6.582576630478799,6.582576630478799,7628.75,8983.5,6868.6044858112,6624.3,8363.6,0,647.0,2.6793965543982736,177466257.98759705
2018-04-18,8178.4,7908.5,8227.6,7895.3,163260.0,19345.5,0.1,8052.333333333332,55.365892318988415,206.23288518506,8449.906294913184,6169.983705086815,7708.159984643596,87.58930934109553,507.1403942981859,18142540.0,20.113381016023148,0.03411476114609413,6.2009732257921595,6.2009732257921595,7638.35,8983.5,6992.148126946304,6624.3,8363.6,0,648.0,2.6800137257419427,178507837.93844107
2018-04-19,8290.8,8179.0,8303.7,8126.7,155080.0,19345.5,0.1,8125.933333333332,56.731865502483885,201.16102390623,8577.476626851987,6186.123373148013,7763.649509915635,93.53797300873245,483.5589375626013,18297620.0,22.24712474196401,0.013743519514819447,5.8324762093236036,5.8324762093236036,7582.825000000001,8983.5,7105.8082767906,6624.3,8363.6,0,649.0,2.6806347773531884,179561087.76632768
2018-04-20,8867.0,8292.3,8926.2,8224.5,225960.0,19345.5,0.1,8445.4,62.98557803960491,225.8944458139615,8817.735247322717,6138.744752677285,7868.730508971289,97.43734037487552,499.14044202241547,18523580.0,33.85565267273523,0.06949872147440539,5.629191857701764,5.629191857701764,7772.950000000001,8983.5,7210.3756146473515,6624.3,8363.6,0,650.0,2.6812788224877306,180653588.83022574
2018-04-21,8923.1,8867.0,9027.7,8614.5,206010.0,19345.5,0.1,8693.633333333331,63.538142342868014,234.30624886496972,9026.210711492691,6140.059288507307,7969.146650974023,95.63165587805386,493.0018390208144,18729590.0,29.2135482282752,0.006326829818428026,5.525006320906573,5.525006320906573,8068.0250000000015,8983.5,7381.958053182617,6624.3,8363.6,0,651.0,2.681924095380683,181754532.9093038
2018-04-22,8806.7,8923.6,9022.3,8766.5,161890.0,19345.5,0.1,8865.599999999999,61.487118097649535,220.50443845811563,9186.19065244625,6153.90934755375,8048.913636595545,90.77051576529547,476.0588505193276,18567700.0,25.26420595974683,-0.013044793849671055,5.4056440042164215,5.4056440042164215,8088.700000000001,8983.5,7579.447086800703,6624.3,8363.6,0,652.0,2.6825636582860803,182853907.7270503
2018-04-23,8952.8,8809.3,9001.0,8785.3,147540.0,19345.5,0.1,8894.199999999999,63.09730497894031,209.7526417264457,9356.54750367807,6136.412496321927,8134.998052157874,96.82101778362542,457.46178976794715,18715240.0,32.010203630251105,0.016589641977130976,5.109706346259798,5.109706346259798,8092.075000000001,8983.5,7753.237436384618,6624.3,8363.6,0,653.0,2.683208072334706,183967049.21842155
2018-04-24,9645.3,8952.7,9734.8,8937.0,260790.00000000003,19345.5,0.1,9134.933333333332,69.58773260534697,235.86806423985576,9636.77303210548,6139.82696789452,8278.836332904742,96.9717475892404,481.7716619273794,18976030.0,40.70870047266148,0.0773501027611474,4.994885197219158,4.994885197219158,8445.625,8983.5,7906.1729440184645,6624.3,8363.6,0,654.0,2.683878030682548,185124584.25303733
2018-04-25,8873.1,9645.0,9753.1,8768.1,395670.0,19345.5,0.1,9157.066666666664,57.453174618029024,189.71080871417064,9714.08050001449,6271.62949998551,8335.4328726281,70.40823189185555,517.7165432182809,18580360.0,27.44861464213384,-0.08005971820472135,5.8346749525901975,5.8346749525901975,8454.775000000001,8983.5,8162.1807318558795,6624.3,8363.6,0,655.0,2.684517194385918,186243820.22658914
2018-04-26,9287.0,8874.5,9303.6,8669.8,248390.0,19345.5,0.1,9268.466666666665,61.34413642403338,175.93582010045583,9814.803550277275,6437.176449722727,8426.058313330186,76.65414475331829,526.0082187026894,18828750.0,17.162465622082603,0.04664660603396786,5.663919658691606,5.663919658691606,8465.400000000001,8888.25,8416.727814758939,6624.3,8363.6,0,656.0,2.685171587281752,187392535.97676376
2018-04-27,8940.9,9282.8,9386.3,8920.2,184910.0,19345.5,0.1,9033.666666666666,56.67663240378151,134.27709888002985,9854.300012142303,6601.199987857697,8475.090854917788,57.560873654509315,521.7290602239258,18643840.0,13.356746202804473,-0.03726714762571337,5.835308081109573,5.835308081109573,8539.075,8679.55,8630.54736439751,8940.9,8363.6,0,657.0,2.685811419617427,188526531.2294088
2018-04-28,9352.4,8940.8,9428.9,8895.5,199780.0,19345.5,0.1,9193.433333333332,60.522660429583006,125.36743070198611,9943.231994413836,6744.4580055861625,8558.64410683038,78.9138557069936,522.5626987793596,18843620.0,16.840737594323123,0.04602444944021289,5.587471651975532,5.587471651975532,8563.525,8284.55,8669.8,8940.9,8363.6,0,658.0,2.6864662579683323,189690045.80820763
2018-04-29,9415.1,9352.2,9565.1,9182.8,184720.0,19345.5,0.1,9236.133333333331,61.08947333606934,114.90595517134466,9968.918657999728,6982.091342000274,8640.211334751295,82.21333473662054,512.5439345808339,19028340.0,12.572337271031614,0.0067041614986529385,5.443850140527811,5.443850140527811,8661.025,8176.150000000001,8843.127999999999,8940.9,8363.6,0,659.0,2.687122442861057,190862809.4810164
2018-04-30,9245.1,9415.8,9456.7,9135.4,156830.0,19345.5,0.1,9337.533333333331,58.63143614621278,88.90798040439347,9924.029919601853,7266.010080398148,8697.819779060696,73.2673788349208,498.88365353934586,18871510.0,14.56133828996283,-0.018056101369077315,5.396195320108445,5.396195320108445,8674.85,8176.150000000001,8895.5,8940.9,8363.6,0,660.0,2.6877711113587286,192031369.07473543
2018-05-01,9074.9,9245.1,9245.1,8851.0,173350.0,19345.5,0.1,9245.033333333333,56.19360145379358,54.31948290068931,9811.695348492623,7589.624651507377,8733.732181054915,63.494455807944846,491.399106857964,18698160.0,14.74723718483675,-0.01840975219305374,5.414925859876847,5.414925859876847,8674.85,8176.150000000001,9753.1,8940.9,8363.6,0,661.0,2.688412146010648,193195377.01997077
2018-05-02,9243.2,9076.8,9265.7,8991.9,137480.0,19345.5,0.1,9187.733333333332,58.05099785265391,37.638272478645035,9841.711532336534,7691.268467663466,8782.252925716351,68.64854894244961,475.85631351096663,18835640.0,13.019661547490966,0.01854565890533233,5.14817718442711,5.14817718442711,8698.025000000001,8176.150000000001,9735.058,8940.9,8363.6,0,662.0,2.6890586985869724,194374994.18327743
2018-05-03,9749.7,9244.2,9809.4,9171.4,201180.0,19345.5,0.1,9355.933333333332,63.11913300953029,54.55280795901609,9936.730928524667,7782.4790714753335,8874.390742314794,96.23320083286018,487.43800540304045,19036820.0,17.59661311333046,0.05479703998615193,4.99951798930265,4.99951798930265,8730.449999999999,8134.75,8851.0,8940.9,8363.6,0,663.0,2.6897231921961646,195589747.1338508
2018-05-04,9708.6,9747.6,9800.9,9549.0,161550.0,19345.5,0.1,9567.166666666666,62.45969576285538,56.566928622649925,10007.378256046493,7882.251743953508,8953.839243046717,91.56414762741657,470.6138621599661,18875270.0,9.491372504793057,-0.004215514323517633,4.847391613208559,4.847391613208559,8730.449999999999,8134.75,8870.168,8940.9,8363.6,0,664.0,2.690385144703049,196808140.1865446
2018-05-05,9853.5,9709.5,9992.8,9691.3,158450.0,19345.5,0.1,9770.599999999999,63.89197415573184,60.87733241223367,10116.771691176566,7921.848308823437,9039.52121989941,89.47089947089952,458.5343005771114,19033720.0,10.426869585682102,0.01492491193374934,4.653517030264489,4.653517030264489,8877.05,8226.45,8888.95264,8940.9,9853.5,0,665.0,2.691051322305396,198040805.3159775
2018-05-06,9656.4,9859.6,9957.7,9446.7,150950.0,19345.5,0.1,9739.5,60.51007785827097,44.4366507090873,10137.95398817699,8059.306011823011,9098.271579908991,74.57294028722602,462.2818505358892,18882770.0,9.648335926056285,-0.02000304460344049,4.787310493930338,4.787310493930338,8903.974999999999,8226.45,8933.1065344,8940.9,9853.5,0,666.0,2.6917092843943498,199268194.49943233
2018-05-07,9431.6,9651.1,9675.6,9204.2,165080.0,19345.5,0.1,9647.166666666666,56.816215990918266,13.982408932919554,10066.933902866609,8282.626097133392,9130.017143727182,57.58125472411196,462.9331469261828,18717690.0,5.348047538200352,-0.023279897270204186,4.908320400845909,4.908320400845909,8903.974999999999,8226.45,8975.494273024,8940.9,9853.5,0,667.0,2.6923578537866786,200488235.13363597
2018-05-08,9196.4,9373.9,9404.4,9079.8,157450.0,19345.5,0.1,9428.133333333331,53.15974980679632,-24.354371574101947,9991.913783123742,8459.446216876258,9136.33932051507,39.803476946334115,454.99506500288413,18560240.0,-4.654080225602103,-0.02493744433606182,4.947534524410466,4.947534524410466,9148.3,8226.45,9016.18650210304,8940.9,9853.5,0,668.0,2.6929964411282232,201699751.94287422
2018-05-09,9319.1,9194.9,9377.9,8988.0,147890.0,19345.5,0.1,9315.699999999999,54.79421326654466,-42.726246845223386,9912.300114825219,8641.88988517478,9153.745099513633,49.07785336356773,450.3454175026781,18708130.0,5.026428193077955,0.013342177373754982,4.832499034270242,4.832499034270242,9168.974999999999,8226.45,9992.8,8940.9,9853.5,0,669.0,2.693638718895377,202924571.5135443
2018-05-10,9025.7,9319.2,9393.3,9013.4,152710.0,19345.5,0.1,9180.4,50.27647505775083,-74.0785703945154,9903.2839837317,8666.776016268297,9141.550328131383,15.300402872657282,445.3136019667725,18555420.0,-2.813610423172168,-0.03148372696934254,4.933840056358759,4.933840056358759,9206.599999999999,8226.45,9972.704,8940.9,9853.5,0,670.0,2.6942686399155464,204136782.21400097
2018-05-11,8408.3,9026.0,9028.7,8359.6,270620.0,19345.5,0.1,8917.699999999999,42.3615100795028,-132.4313298742175,9971.41374739235,8547.166252607652,9071.716963547442,2.9818760715159773,461.2983446834317,18284800.0,-5.956894719770944,-0.0684046666740531,5.486226046685201,5.486226046685201,9049.5,8226.45,9953.00992,8940.9,9853.5,0,671.0,2.694872445671628,205313589.5257152
2018-05-12,8459.5,8409.6,8646.1,8184.1,210870.0,19345.5,0.1,8631.166666666666,43.16064722783743,-161.6781636170674,10011.917026124545,8471.942973875455,9013.410586066733,15.226405705755504,461.34846292032944,18495670.0,-9.547281981095757,0.006089221364604214,5.453613841483887,5.453613841483887,9005.625,8226.45,9889.2735232,8940.9,9853.5,0,672.0,2.69547742970305,206499136.04102203
2018-05-13,8693.5,8489.1,8758.4,8330.0,149800.0,19345.5,0.1,8520.433333333332,46.791591428708216,-159.11443344575983,10026.237548818859,8431.692451181141,8982.942911203236,28.163874606070657,458.99500128316305,18645470.0,-7.664283969368359,0.027661209291329314,5.279749252696417,5.279749252696417,9016.25,8226.45,9786.963111808,8940.9,9853.5,0,673.0,2.696091104480306,207705911.42806414
2018-05-14,8674.1,8693.4,8878.3,8305.1,212050.0,19345.5,0.1,8609.033333333333,46.526229347924335,-152.5555950900652,9988.562960982952,8372.24703901705,8953.529300612452,27.09128103057446,467.1525011915085,18433420.0,-6.176244713415755,-0.0022315523091964717,5.3856019782053295,5.3856019782053295,9065.325,8226.45,9690.791325099519,8940.9,9853.5,0,674.0,2.696703005907493,208916811.64528304
2018-05-15,8477.0,8674.0,8842.1,8436.5,179620.0,19345.5,0.1,8614.866666666667,43.807953119790064,-154.82921926744015,10015.947171621045,8305.252828378956,8908.14555769698,16.19395145684745,462.75589396354366,18253800.0,-6.588502352643001,-0.022722818505666376,5.458958286699819,5.458958286699819,9009.150000000001,8226.45,9600.389845593549,8940.9,9853.5,0,675.0,2.697305791921809,210119548.71242365
2018-05-16,8344.4,8477.0,8496.4,8120.1,188030.0,19345.5,0.1,8498.499999999998,42.028914065322105,-158.05054628526585,10036.928137870971,8190.0118621290285,8854.455504582982,11.977358893576088,456.5804729661476,18065770.0,-9.723905141076694,-0.015642326294679765,5.471699258977849,5.471699258977849,8909.35,8226.45,9515.412454857937,8940.9,9853.5,0,676.0,2.6979020296030662,211318216.1068868
2018-05-17,8063.0,8344.6,8458.7,8022.3,154360.0,19345.5,0.1,8294.799999999997,38.459466337033575,-170.83284700891141,10099.045354842781,8040.10464515722,8779.078789860794,2.0654656178634783,455.1390106114228,17911410.0,-17.300019487779117,-0.03372321556972335,5.6447849511524595,5.6447849511524595,8857.675,8226.45,9403.787458469302,8940.9,9853.5,0,677.0,2.6984851711268587,212501589.5615397
2018-05-18,8245.7,8064.4,8273.6,7939.8,150320.0,19345.5,0.1,8217.699999999999,41.90900345136571,-158.93057110679695,10094.664624673153,7933.815375326848,8728.280809874052,14.900146127618154,446.4719384248926,18061730.0,-15.068083966792322,0.02265905990326189,5.414603228651207,5.414603228651207,8816.425,8226.45,9265.63871262237,8940.9,9853.5,0,678.0,2.699075286134294,213703467.56483862
2018-05-19,8245.1,8244.7,8389.1,8153.2,107890.0,19345.5,0.1,8184.5999999999985,41.90069694892212,-143.51596062361762,10069.205711012299,7842.274288987702,8682.263589886046,15.129590167996437,431.43108568025747,17953840.0,-16.323133911807982,-7.276519883092636e-05,5.232575537958999,5.232575537958999,8725.275,8226.45,9106.538067107685,8940.9,9853.5,0,679.0,2.6996644198571755,214910482.42465544
2018-05-20,8529.0,8243.9,8580.4,8184.7,113760.0,19345.5,0.1,8339.933333333332,47.23029386927031,-108.22471896253855,10039.914223512706,7799.955776487294,8667.667057515946,33.94400276529553,428.8788652745248,18067600.0,-11.67515844414067,0.03443257207311001,5.028477726281215,5.028477726281215,8687.675,8226.45,8966.529499054763,8940.9,9853.5,0,680.0,2.7002645603033155,216143268.54991302
2018-05-21,8403.3,8529.5,8550.6,8375.5,115520.0,19345.5,0.1,8392.466666666665,45.251017850779476,-88.21826423096564,10025.838439941152,7746.871560058847,8642.489242514426,31.64686603850876,410.7518034692016,17952080.0,-10.902710038593675,-0.014737952866690218,4.887982143553147,4.887982143553147,8687.675,8226.45,8843.321959168192,8940.9,9853.5,0,681.0,2.7008584912924216,217372400.99082267
2018-05-22,8006.0,8403.8,8414.5,7979.3,137510.0,19345.5,0.1,8312.766666666665,39.60202438419307,-95.97259947137667,10013.04587644582,7635.944123554182,8581.871219417813,4.55452356381148,412.4981032214015,17814570.0,-12.944195554782304,-0.04727904513702941,5.152362018753454,5.152362018753454,8687.675,8226.45,8734.899324068008,8940.9,9853.5,0,682.0,2.7014343635679365,218577116.99401814
2018-05-23,7512.3,8005.7,8047.4,7467.6,237600.0,19345.5,0.1,7973.866666666666,33.93315773052201,-126.65364680818851,9951.884409284483,7473.365590715517,8480.007293758974,2.3212338370462606,424.448238705587,17576970.0,-19.388138339539225,-0.0616662503122658,5.6500437776125425,5.6500437776125425,8442.525000000001,8258.099999999999,8639.487405179847,8940.9,9853.5,0,683.0,2.7019868320149425,219747578.95760822
2018-05-24,7592.9,7512.3,7736.6,7293.4,211110.0,19345.5,0.1,7703.733333333333,35.555058523485755,-133.15720831241774,9849.16266082533,7364.517339174671,8395.520884829548,17.259263527920233,425.78765022661656,17788080.0,-15.874669000742337,0.010729070990242562,5.607707861642015,5.607707861642015,8290.0,8258.099999999999,8475.423168454668,8940.9,9853.5,0,684.0,2.702542151697516,220929336.1492689
2018-05-25,7477.7,7593.9,7653.4,7355.6,161820.0,19345.5,0.1,7527.633333333331,34.260457301654455,-136.3578690146666,9684.32778295851,7291.772217041489,8308.10937198864,11.628493911287793,416.6456752104296,17626260.0,-11.067635550586914,-0.01517206864307441,5.571842614847207,5.571842614847207,8290.0,8258.099999999999,8286.299461501922,8940.9,9853.5,0,685.0,2.703091162568329,222106305.16968435
2018-05-26,7361.3,7478.5,7619.3,7331.5,103070.0,19345.5,0.1,7477.299999999999,32.954773169988314,-137.08634558993774,9539.189704465258,7207.400295534742,8217.937050846864,4.284181967316585,407.44241269539896,17523190.0,-12.981854719546071,-0.015566283750350962,5.534924710246817,5.534924710246817,8290.0,8258.099999999999,8127.435547661614,8940.9,9853.5,0,686.0,2.703633732370486,223278105.5139262
2018-05-27,7366.7,7361.9,7411.8,7267.5,103290.0,19345.5,0.1,7401.899999999999,33.08218571208329,-128.1416781384503,9408.17000509618,7131.929994903818,8136.866855528115,6.158430593493907,388.646526074299,17626480.0,-15.261977339391503,0.0007335660820777523,5.275720825801227,5.275720825801227,8277.05,8258.099999999999,7993.989860035756,8940.9,9853.5,0,687.0,2.7041756581003957,224454948.20607844
2018-05-28,7119.3,7367.3,7446.9,7090.6,152290.0,19345.5,0.1,7282.433333333332,30.24618975397877,-129.44401026733374,9326.1061819015,7006.2838180985,8039.955726430198,1.6385954895803494,386.33605992613474,17474190.0,-17.92462618600201,-0.03358355844543681,5.426601771608651,5.426601771608651,8188.6,8304.45,7863.2216852293195,7119.3,9853.5,0,688.0,2.704704646786743,225614762.07962343
2018-05-29,7467.7,7119.3,7533.0,7069.8,186970.0,19345.5,0.1,7317.899999999999,38.27147448738203,-98.78309962782976,9142.670459978262,7004.579540021737,7985.455181055893,26.340526942936567,391.8263413599822,17661160.0,-11.906334788250563,0.048937395530459504,5.246948074507308,5.246948074507308,8170.75,8313.0,7708.697348183456,7119.3,9853.5,0,689.0,2.7052495752857513,226809365.37650576
2018-05-30,7400.1,7469.2,7565.2,7306.8,140370.0,19345.5,0.1,7329.033333333333,37.37300412418514,-76.01854473481933,9005.197539069797,6979.492460930201,7929.707068574379,21.8654839136767,382.2958884056978,17520790.0,-11.316571592924587,-0.00905231865232925,5.166090842092644,5.166090842092644,8136.724999999999,8313.0,7580.917878546765,7119.3,9853.5,0,690.0,2.705790398252869,228002851.21918565
2018-05-31,7502.6,7400.8,7611.9,7355.0,144520.0,19345.5,0.1,7456.799999999999,39.68514710643253,-48.36798197420853,8962.458277327738,6931.661722672262,7889.0302049006295,28.650867205084094,373.33903923386225,17665310.0,-6.95026665013022,0.013851164173457109,4.976128798468028,4.976128798468028,8036.175,8332.2,7069.8,7119.3,9853.5,0,691.0,2.7063351635084647,229209824.5155284
2018-06-01,7530.8,7502.5,7610.4,7375.8,135920.0,19345.5,0.1,7477.833333333332,40.337770314087386,-23.735864337083513,8902.894600207519,6898.355399792482,7854.9130425291405,30.51767509598836,363.42910786001494,17801230.0,-8.669973440702433,0.0037586969850451624,4.825903062888603,4.825903062888603,7887.950000000001,8386.05,7080.642,7119.3,9853.5,0,692.0,2.7068803457063098,230423964.1583064
2018-06-02,7646.6,7530.8,7694.5,7467.9,121180.0,19345.5,0.1,7559.999999999999,43.062244624474964,3.3576202509786413,8786.76811521518,6909.791884784821,7835.0737051454125,38.183503243744234,353.65560015572817,17922410.0,-7.258856775539411,0.015376852392840146,4.625004579234275,4.625004579234275,7809.625,8386.05,7091.267159999999,7119.3,9853.5,0,693.0,2.7074299918144593,231652782.95919272
2018-06-03,7729.3,7646.6,7775.0,7611.3,116680.0,19345.5,0.1,7635.566666666666,44.994098002929675,28.45353935922776,8660.265805944013,6941.814194055985,7825.000018941088,44.53673689897352,340.08734300174757,18039090.0,-9.376245749794816,0.010815264300473304,4.3999759745610545,4.3999759745610545,7826.974999999999,8531.3,7115.3964736,7119.3,7729.3,0,694.0,2.7079825125819026,232893500.0103466
2018-06-04,7504.3,7729.3,7759.9,7468.4,141010.0,19345.5,0.1,7626.733333333333,40.9256301680639,31.28030704685517,8561.746753463975,6943.063246536026,7794.457159994317,32.31203986019187,336.61681850162273,17898080.0,-10.698178096700097,-0.029110009962092342,4.48565247260401,4.48565247260401,7826.974999999999,8531.3,7154.972685184,7119.3,7729.3,0,695.0,2.7085237404243454,234119815.4969259
2018-06-05,7631.5,7507.4,7672.6,7391.0,145230.0,19345.5,0.1,7621.699999999998,44.00803934375086,42.40630526546073,8480.16277547317,6953.357224526829,7778.937430471049,57.457037643207876,332.68704575150684,18043310.0,-4.677741693729702,0.01695028183841263,4.359392593218985,4.359392593218985,7735.825,8531.3,7192.174324072959,7119.3,7729.3,0,696.0,2.7090699757835015,235361987.6448212
2018-06-06,7661.0,7631.5,7699.1,7504.4,130660.0,19345.5,0.1,7598.933333333332,44.72833914372835,51.81921888401172,8443.528907908305,6949.7910920916975,7767.705294235711,83.8343732274532,322.8308281978278,18173970.0,1.979420417182485,0.00386555722990245,4.213951549377729,4.213951549377729,7698.224999999999,8531.3,7227.1438646285815,7119.3,7729.3,0,697.0,2.7096166634386147,236611615.36879453
2018-06-07,7697.8,7661.0,7754.7,7657.7,124000.0,19345.5,0.1,7663.433333333332,45.66732530129185,60.01272624130695,8372.48793556179,6966.042064438209,7761.047647165644,89.05275099262623,306.7000547551258,18297970.0,1.3815538200160749,0.004803550450332983,3.984255953066146,3.984255953066146,7757.474999999999,8531.3,7260.015232750867,7119.3,7729.3,0,698.0,2.7101641307045563,237869367.7691668
2018-06-08,7622.1,7697.9,7710.5,7556.9,112880.0,19345.5,0.1,7660.299999999999,44.01098154943511,59.696147861155566,8289.857990065979,6986.372009934023,7747.814537911773,78.3182076006807,295.76433655833114,18185090.0,1.931075063187886,-0.009833978539322885,3.88035235116741,3.88035235116741,7769.525,8531.3,7290.914318785814,7119.3,7729.3,0,699.0,2.7107072261833935,239125490.3469224
2018-06-09,7515.8,7622.1,7689.0,7493.3,97560.0,19345.5,0.1,7611.899999999999,41.72255058265875,51.97332806125485,8096.13973330752,7078.77026669248,7725.717915253509,63.244469653998884,288.6168839470218,18087530.0,2.0988140681673073,-0.01394628776846274,3.840135234399821,3.840135234399821,7765.675,8531.3,7319.959459658666,7119.3,7729.3,0,700.0,2.711244495879667,240377101.30065718
2018-06-10,6775.1,7515.8,7516.3,6668.1,275690.0,19345.5,0.1,7304.333333333332,30.012229874023305,-0.5911210562412634,7986.787469415947,7025.302530584053,7635.1828757055555,9.666636552534108,328.58710652223454,17811840.0,-8.030732892611338,-0.09855238297985569,4.849922606636574,4.849922606636574,7422.9,8330.45,7775.0,7119.3,7729.3,0,701.0,2.71174448501576,241563513.61814284
2018-06-11,6885.9,6775.2,6910.8,6657.2,174880.0,19345.5,0.1,7058.933333333332,33.03981713673146,-24.16383139671126,7945.511538637834,6954.568461362164,7563.822601828836,20.459831812488797,323.23088462778924,17986720.0,-3.278412203446976,0.016354002154949532,4.694097861249644,4.694097861249644,7417.45,8325.0,7752.862,7119.3,7729.3,0,702.0,2.71224930896246,242765138.28898755
2018-06-12,6558.2,6885.9,6887.2,6476.0,178260.0,19345.5,0.1,6739.733333333333,29.038766549314772,-56.258332431404995,8030.578132155176,6774.091867844826,7468.049020702279,6.327944572748254,329.51439286866145,17808460.0,-12.179118068481595,-0.04759000275926162,5.024463921024998,5.024463921024998,7323.075,8234.4,7709.03552,7119.3,7729.3,0,703.0,2.7127361864990513,243937861.42450666
2018-06-13,6312.3,6558.5,6624.6,6129.1,237480.0,19345.5,0.1,6585.466666666664,26.450347646953418,-86.66317098104292,8118.473139505931,6558.13686049407,7357.977685397301,11.13068837717965,341.37050766375705,17570980.0,-14.699801354035758,-0.037495044371931296,5.408020969595188,5.408020969595188,7148.325,8060.95,7635.0533888,7119.3,7729.3,0,704.0,2.713208836717119,245088465.79860163
2018-06-14,6647.1,6312.3,6711.5,6283.6,201540.0,19345.5,0.1,6505.866666666666,34.95197588986572,-77.15864966512476,8129.49946793651,6464.050532063489,7290.275048692796,31.472142900540746,347.55118568777436,17772520.0,-11.40271372590835,0.05303930421557923,5.228613766721944,5.228613766721944,7148.325,8060.95,7514.577117696,7119.3,7729.3,0,705.0,2.713698764265974,246278402.43670386
2018-06-15,6410.3,6647.3,6655.8,6395.7,143530.0,19345.5,0.1,6456.566666666666,32.12366284115977,-79.44027393911563,8166.1333484733605,6332.31665152664,7206.467901198244,17.08487757457925,341.3046724243619,17628990.0,-14.878897328305094,-0.035624558077958834,5.3243166844665915,5.3243166844665915,7140.875,8060.95,7403.73894828032,7119.3,7729.3,0,706.0,2.7141751510815344,247447417.2785978
2018-06-16,6505.8,6410.0,6564.2,6358.0,108790.0,19345.5,0.1,6521.066666666666,34.428176892973994,-67.60194927859868,8176.275615081393,6236.084384918608,7139.73762489365,22.887174190412537,331.65433867976463,17737780.0,-14.919048989093191,0.014897898694288925,5.097825612219322,5.097825612219322,7095.8,8060.95,7301.767832417894,7119.3,7729.3,0,707.0,2.7146558874107574,248630600.3697201
2018-06-17,6460.3,6505.8,6593.0,6452.1,90670.0,19345.5,0.1,6458.799999999998,33.83869925935548,-56.37831079682485,8196.216050931363,6150.243949068637,7075.029279665683,20.309050772626932,318.02902877406717,17647110.0,-16.418045618620056,-0.006993759414676171,4.922821367027338,4.922821367027338,6998.65,8060.95,7207.954405824463,7119.3,7729.3,0,708.0,2.7151333379434437,249812900.96370786
2018-06-18,6719.8,6460.5,6794.5,6410.9,135700.0,19345.5,0.1,6561.966666666666,40.134363509368534,-26.535422339980187,8167.670332356935,6103.9996676430665,7041.1979196975235,36.337352362204726,322.7126695759195,17782810.0,-10.454006369681382,0.0401684132315836,4.802414797701115,4.802414797701115,6887.375,8060.95,7121.646053358506,7119.3,7729.3,0,709.0,2.715623735785627,251026727.37200367
2018-06-19,6752.4,6719.8,6839.5,6681.5,120540.0,19345.5,0.1,6644.166666666665,40.89525857360047,-1.0065105646712027,8140.718664329616,6066.181335670383,7013.6933559168065,38.34276574803146,310.94747889192524,17903350.0,-11.519360545109091,0.00485133486115652,4.604991986433346,4.604991986433346,6736.0,8060.95,7042.242369089826,7119.3,7729.3,0,710.0,2.716114985952082,252248168.97100475
2018-06-20,6765.4,6752.3,6812.7,6575.1,121480.0,19345.5,0.1,6745.866666666665,41.216118777658544,19.23168429282788,8096.872999762759,6036.307000237243,6990.046369639015,39.14247047244091,305.70837325678764,18024830.0,-11.690379845973116,0.0019252413956518666,4.518703598557183,4.518703598557183,6730.1,8060.95,6969.19097956264,7119.3,7729.3,0,711.0,2.7166060680914828,253475218.21119094
2018-06-21,6728.0,6765.8,6797.5,6695.1,99290.0,19345.5,0.1,6748.5999999999985,40.53436146815661,31.832597512917232,8043.734932553385,6009.165067446615,6965.089572530537,37.87150626027569,291.18634659558853,17925540.0,-12.598404739016345,-0.005528128418127443,4.327977803144895,4.327977803144895,6718.175,8060.95,6901.983701197629,7119.3,7729.3,0,712.0,2.7170943737295175,254702603.15475106
2018-06-22,6055.7,6728.2,6739.7,5955.0,278220.0,19345.5,0.1,6516.366666666665,30.702896242723654,-1.6043378182461652,8005.731196266483,5888.078803733519,6878.481041813344,5.807381776239898,326.4373218387608,17647320.0,-20.550766849031113,-0.0999256837098692,5.390579484432201,5.390579484432201,6631.125,7973.9,6840.153005101818,7119.3,7729.3,0,713.0,2.7175450737996134,255859224.30387086
2018-06-23,6167.3,6055.2,6259.0,6032.8,142900.0,19345.5,0.1,6316.999999999999,33.58269364949237,-12.113762040942277,7915.630141988931,5821.979858011069,6810.749514021597,13.597642989816189,319.27751313599214,17790220.0,-17.942201761622183,0.01842891820929049,5.176941500105267,5.176941500105267,6631.125,7973.9,6797.5,7119.3,7729.3,0,714.0,2.7180013525233284,257032524.9322813
2018-06-24,6154.6,6167.9,6248.3,5785.3,240600.0,19345.5,0.1,6125.866666666666,33.41252468550995,-15.60667099528115,7849.591412564583,5753.048587435416,6748.259084114778,32.81208351843626,329.5434050548498,17549620.0,-9.15853640536671,-0.0020592479691274868,5.3544244151504525,5.3544244151504525,6546.275,7889.049999999999,6739.7,7119.3,7729.3,0,715.0,2.7184561093566955,258208070.9618301
2018-06-25,6256.6,6155.1,6331.2,6101.7,210690.0,19345.5,0.1,6192.833333333332,36.208348544166874,-7.163203252769733,7733.311560489396,5731.838439510604,6701.43440943718,42.77157636809151,322.397447550932,17760310.0,-9.138965131645817,0.016572969811198046,5.152917679745101,5.152917679745101,6546.275,7889.049999999999,6625.172,7119.3,7729.3,0,716.0,2.7189158004640928,259399194.99371135
2018-06-26,6082.1,6256.9,6267.7,6060.0,176660.0,19345.5,0.1,6164.433333333333,33.608509546884505,-9.310124030352142,7596.377771357826,5710.882228642175,6642.450179966972,28.154050464807458,314.20477272586544,17583650.0,-7.259613918453225,-0.02789054758175369,5.166057327664218,5.166057327664218,6546.275,7871.5,6524.38736,7119.3,7729.3,0,717.0,2.719364820599539,260573642.1609359
2018-06-27,6154.9,6081.1,6187.3,6025.4,133420.0,19345.5,0.1,6164.533333333332,35.683336471169184,-2.179022109611765,7411.144260477082,5741.825739522919,6596.016829493928,35.059760956175246,303.3258603883036,17717070.0,-2.4935443499200063,0.011969549990956896,4.928201276841275,4.928201276841275,6546.275,7730.450000000001,6435.6968768,7119.3,7729.3,0,718.0,2.719817195258388,261760404.15160006
2018-06-28,5883.5,6154.9,6178.4,5854.0,156050.0,19345.5,0.1,6040.166666666665,31.70533491119791,-11.567532906885106,7226.991287349725,5752.118712650274,6528.158083827839,9.315120470498941,304.8311560748533,17561020.0,-11.487716447774222,-0.04409494874002817,5.1811193350021805,5.1811193350021805,6539.575,7594.85,6357.649251584,5883.5,7729.3,0,719.0,2.7202530553809443,262917945.25251207
2018-06-29,6213.3,5883.2,6284.9,5818.5,206960.0,19345.5,0.1,6083.899999999999,40.40032125351547,7.575488566587865,7000.168500015544,5848.691499984457,6498.171599653759,40.59950673496491,316.3717877837923,17767980.0,-3.073179102382104,0.05605506926149406,5.091847935618629,5.091847935618629,6532.0,7589.299999999999,6288.96734139392,5883.5,7729.3,0,720.0,2.720707138247249,264118974.323851
2018-06-30,6398.9,6213.4,6498.5,6204.0,189330.0,19345.5,0.1,6165.233333333333,44.669631275658816,34.37823970843499,6958.4274008188995,5852.8125991811,6488.717161591496,58.205274141529074,314.80951722780713,17957310.0,-1.6431491899535882,0.02987140488951101,4.919744287733941,4.919744287733941,6516.25,7589.299999999999,5785.3,5883.5,7729.3,0,721.0,2.7211706744249837,265345488.81261015
2018-07-01,6366.8,6398.5,6445.1,6284.7,128509.99999999999,19345.5,0.1,6326.333333333332,44.08148983367423,50.605456133089945,6886.684720622529,5872.645279377471,6477.1060033446865,55.16031113640676,303.7802659972495,17828800.0,-1.4473012089221864,-0.005016487208738929,4.7713178676454335,4.7713178676454335,6455.95,7407.0,5799.564,5883.5,7729.3,0,722.0,2.721631652007151,266572259.00806907
2018-07-02,6619.5,6349.1,6680.0,6275.0,179920.0,19345.5,0.1,6461.733333333333,49.696522839000764,77.41340536429107,6894.746246226767,5870.713753773234,6490.667336359478,79.13109466894328,311.01024699744596,18008720.0,-1.4926039465460308,0.03969026826663313,4.6983948485149325,4.6983948485149325,6501.325,7331.799999999999,5813.54272,5883.5,6619.5,0,723.0,2.722105371857464,267831914.7432537
2018-07-03,6513.5,6618.6,6676.6,6513.5,150190.0,19345.5,0.1,6499.933333333332,47.540061068723496,86.37999911769805,6906.778232939381,5878.801767060619,6492.841875753813,70.8779443254818,300.44522935477124,17858530.0,-3.5380013032403244,-0.016013294055442273,4.612654169874434,4.612654169874434,6498.575,7331.799999999999,5848.201011200001,5883.5,6619.5,0,724.0,2.7225726576721203,269083716.04708874
2018-07-04,6598.4,6513.8,6774.5,6442.3,143040.0,19345.5,0.1,6577.133333333332,49.43271791556619,95.67984777289576,6899.943624186361,5880.76637581364,6502.895030443926,80.32997431337677,302.7134272580019,18001570.0,-2.4684423685221866,0.013034466876487238,4.587679244331988,4.587679244331988,6516.825,7331.799999999999,5881.472970752001,5883.5,6619.5,0,725.0,2.723043637115206,270349331.9470332
2018-07-05,6546.5,6598.0,6693.6,6466.1,166180.0,19345.5,0.1,6552.799999999999,48.28586308267816,95.75273057316554,6911.258136600896,5883.071863399104,6507.047884687362,76.95107157298827,297.34103959671603,17835390.0,-2.697681331747919,-0.007865543161978628,4.5419848712551145,4.5419848712551145,6473.65,7313.700000000001,5935.054592506881,5883.5,6619.5,0,726.0,2.7235110570193046,271613189.7705098
2018-07-06,6617.7,6546.5,6638.2,6458.3,132690.0,19345.5,0.1,6587.533333333333,49.99967861493496,97.67622386896912,6923.848631232872,5881.671368767128,6517.586181383804,84.1488071168621,288.9523939112363,17968080.0,9.280512574929405,0.010876040632398887,4.366356799359843,4.366356799359843,6322.275,7182.85,5985.421316956468,5883.5,6619.5,0,727.0,2.723981426636937,272889376.28271854
2018-07-07,6765.5,6617.7,6805.9,6531.1,114570.0,19345.5,0.1,6643.233333333333,53.44847703705703,105.32462045046796,6962.313838289713,5873.726161710288,6541.197021252013,96.04154418969237,287.94150863186223,18082650.0,9.69954437111864,0.022334043549873783,4.256027028776325,4.256027028776325,6324.225,7182.85,6032.76603793908,5883.5,6619.5,0,728.0,2.724458657952583,274186566.1224263
2018-07-08,6714.8,6765.4,6784.0,6694.3,267600.0,19345.5,0.1,6699.333333333332,52.120406869481606,103.25247153166305,6961.5134803288665,5874.026519671134,6557.730638275631,90.77374924042945,273.7814008724435,17815050.0,9.10213498846391,-0.007493902889660786,4.077283029612848,4.077283029612848,6408.674999999999,7182.85,6094.616754903954,5883.5,6619.5,0,729.0,2.724932457190078,275482381.8713741
2018-07-09,6667.1,6715.1,6793.8,6637.7,289480.0,19345.5,0.1,6715.799999999999,50.84046483458712,95.15241820491934,6947.941014785818,5879.06898521418,6568.146767963665,85.94288029167517,265.37558652441186,17525570.0,6.5610715084870375,-0.007103711205099117,3.980375073486401,3.980375073486401,6426.424999999999,7182.85,6151.5194145116375,5883.5,6619.5,0,730.0,2.72540296561884,276777056.882197
2018-07-10,6307.2,6668.4,6686.8,6291.5,315270.0,19345.5,0.1,6563.033333333333,42.38328979393141,63.55806310296799,6901.4927528822645,5879.697247117734,6543.294694824269,49.49361960704882,274.6559017726682,17210300.0,3.7010243172588324,-0.05398149120307183,4.3546407561622935,4.3546407561622935,6426.424999999999,7182.85,6203.869861350707,5883.5,6619.5,0,731.0,2.7258534015678255,278033291.7442943
2018-07-11,6389.1,6307.2,6409.7,6296.6,243820.0,19345.5,0.1,6454.466666666666,44.64011400530083,46.94394530257637,6860.579155011433,5886.720844988567,6528.609485793387,57.78813044358928,263.1161945031919,17454120.0,3.8050983769029676,0.0129851598173516,4.118204355906025,4.118204355906025,6430.549999999999,7167.950000000001,6252.0322724426505,5883.5,6619.5,0,732.0,2.72630752314082,279303437.57973206
2018-07-12,6250.6,6389.1,6389.4,6088.8,289240.0,19345.5,0.1,6315.633333333331,41.667763502956895,26.417681683462618,6851.93524576353,5914.854754236471,6502.132391908302,43.761393558841455,265.79360918153526,17164880.0,6.239483300756358,-0.021677544568092566,4.252289527109961,4.252289527109961,6379.875,7099.9,6805.9,5883.5,6619.5,0,733.0,2.7267532491477735,280560590.0205142
2018-07-13,6230.2,6250.8,6333.8,6144.5,233220.0,19345.5,0.1,6289.966666666666,41.23227459650974,11.992036369550775,6850.05346215633,5923.02653784367,6476.234068869417,19.718309859154893,260.32977995428274,16931660.0,0.2719971673667719,-0.0032636866860782376,4.178514011657454,4.178514011657454,6379.875,6916.35,6791.558,5883.5,6619.5,0,734.0,2.7271970565241737,281819082.6082807
2018-07-14,6254.8,6229.5,6313.5,6192.5,243710.0,19345.5,0.1,6245.2,42.01923068962406,4.990819180495436,6847.023579914519,5936.076420085481,6455.145109929472,23.148793752614715,250.37765281469112,17175370.0,-2.251949553829556,0.0039485088761195275,4.002968165483966,4.002968165483966,6379.875,6780.15,6777.50284,5883.5,6619.5,0,735.0,2.7276414468884096,283084532.5852898
2018-07-15,6362.9,6254.8,6399.6,6238.5,180670.0,19345.5,0.1,6282.633333333331,45.474534752002896,8.327504921363456,6848.379173753325,5945.350826246675,6446.35986136476,38.223399804769166,244.00067761364178,17356040.0,-0.06125526166992125,0.01728272686576693,3.8347400967112764,3.8347400967112764,6373.175,6780.15,6763.7287832,5883.5,6619.5,0,736.0,2.728090991094401,284367354.5076527
2018-07-16,6729.9,6362.8,6749.2,6344.1,312120.0,19345.5,0.1,6449.199999999998,55.22938139421639,34.472286454293496,6878.73877267722,5979.771227322778,6473.363684091925,89.40175707711614,255.5077720698102,17668160.0,1.6677996827554897,0.05767810275188978,3.796605775268729,3.796605775268729,6368.450000000001,6780.15,6750.230207536,5883.5,6619.5,0,737.0,2.728559169765534,285698465.578446
2018-07-17,7322.0,6729.8,7453.2,6666.0,337750.0,19345.5,0.1,6804.933333333332,65.84581546319586,87.82897472478638,7064.462694888519,5910.7573051114805,6554.186190368884,90.38405159777193,293.48578835053803,18005910.0,12.412681354110692,0.08798050491091991,4.008273536609369,4.008273536609369,6695.125,6780.15,6088.8,5883.5,6619.5,0,738.0,2.7290557376506857,287100842.0936317
2018-07-18,7383.6,7321.6,7581.2,7249.3,333320.0,19345.5,0.1,7145.166666666665,66.72973387659268,121.38906253461394,7193.3493887090235,5931.880611290976,6633.177981762324,86.75958188153314,296.2296606112139,18339230.0,11.8998545101843,0.008413001912045859,4.011994970085241,4.011994970085241,6759.125,6780.15,6116.088,5883.5,6619.5,0,739.0,2.729554369221981,288514859.64511585
2018-07-19,7477.5,7383.9,7558.4,7288.8,247250.0,19345.5,0.1,7394.366666666666,68.0856230537109,142.56638975448516,7350.285193178442,5901.364806821558,6713.589602546864,93.05146073438756,294.3275419961271,18586480.0,14.221339647139693,0.012717373638875262,3.9361757538766575,3.9361757538766575,6759.125,6780.15,6174.69248,5883.5,6619.5,0,740.0,2.7300565354474413,289944026.6800835
2018-07-20,7339.4,7477.6,7683.6,7292.0,258850.00000000003,19345.5,0.1,7400.166666666665,63.95732557620703,139.74165639760585,7452.295978885096,5893.404021114905,6773.1905927804955,78.41735640832702,301.27557471068945,18327630.0,10.905601644075734,-0.018468739551989355,4.104907413558186,4.104907413558186,6818.625,6780.15,6230.952780799999,7339.4,6619.5,0,741.0,2.7305514127327695,291363330.0915755
2018-07-21,7408.7,7339.3,7460.8,7223.5,160770.0,19345.5,0.1,7408.533333333332,65.10087348683501,134.93825763264402,7553.342369563752,5896.547630436247,6833.715298229972,82.76272886882364,296.7058908027831,18488400.0,9.507057867119945,0.009442188734773982,4.004830682883409,4.004830682883409,6832.55,6780.15,6318.111613951999,7339.4,6619.5,0,742.0,2.731048706173988,292795233.04888785
2018-07-22,7412.3,7409.0,7575.3,7343.7,204160.0,19345.5,0.1,7386.799999999998,65.16270867486311,124.64609972634764,7643.3480699455595,5885.821930054442,6888.818603160451,82.98846250313518,292.0554700311557,18692560.0,10.387502233871448,0.0004859152077962836,3.940146378737446,3.940146378737446,6844.55,6780.15,6400.040917114879,7339.4,6619.5,0,743.0,2.7315453320691665,294232611.51156247
2018-07-23,7723.0,7412.4,7809.6,7379.2,272150.0,19345.5,0.1,7514.666666666665,70.08856570885973,130.76753673344365,7788.750177183592,5861.3698228164085,6968.264450478503,94.96745699674567,301.93722217178754,18964710.0,15.837470564413305,0.04191681394438973,3.9095846454977026,3.9095846454977026,6919.05,6797.450000000001,6477.054462087986,7339.4,6619.5,0,744.0,2.7320553115884807,295708570.1447047
2018-07-24,8407.0,7723.1,8479.8,7701.9,345320.0,19345.5,0.1,7847.433333333332,77.59821401290462,170.38088944033697,8092.86857106376,5738.1114289362395,7105.286883766265,96.95524884985365,335.9345634452312,19310030.0,33.292110603754445,0.08856661918943409,3.9958910841588104,3.9958910841588104,7280.549999999999,7132.549999999999,6583.658105120948,7339.4,8407.0,0,745.0,2.7325937551729855,297259474.6983915
2018-07-25,8173.7,8404.9,8484.6,8062.1,269230.0,19345.5,0.1,8101.233333333333,71.04631441284711,169.98145312328967,8281.034666627094,5712.665333372906,7207.040513883764,87.02312379998328,342.11780891342903,19040800.0,27.931946596547235,-0.027750683953848054,4.185592925033082,4.185592925033082,7431.0,7134.950000000001,6773.2722946088525,7339.4,8407.0,0,746.0,2.7331216044417816,298793257.40715367
2018-07-26,7937.0,8173.9,8304.3,7861.0,235450.0,19345.5,0.1,8172.566666666666,65.04561674344839,143.91931276199034,8396.887784033968,5728.742215966034,7276.560464942453,76.5992906286056,349.34510827675547,18805350.0,26.979809938245918,-0.028958733498904987,4.401475472807805,4.401475472807805,7570.375,7134.950000000001,6978.631619255791,7339.4,8407.0,0,747.0,2.733638444849119,300308572.91078126
2018-07-27,8187.4,7936.9,8273.8,7808.3,243220.0,19345.5,0.1,8099.366666666665,68.11381555194556,133.8960699582496,8546.28078686871,5721.539213131291,7363.307087328886,87.03372453208846,357.64188625698716,19048570.0,31.41472183878527,0.031548443996472164,4.368198527700945,4.368198527700945,7570.375,7134.950000000001,7159.347824945095,7339.4,8407.0,0,748.0,2.734165148990482,301855352.79157746
2018-07-28,8234.1,8186.8,8234.1,8077.4,147140.0,19345.5,0.1,8119.499999999999,68.666225894059,121.14629802141877,8685.903957541192,5733.8460424588075,7446.239745678516,88.84733538132764,343.28889438148815,19195710.0,31.64449702628382,0.005703886459682117,4.16911252451984,4.16911252451984,7570.375,7134.950000000001,7318.378085951684,7339.4,8407.0,0,749.0,2.7346929512786713,303412772.1988611
2018-07-29,8215.6,8231.5,8275.4,8113.3,155240.0,19345.5,0.1,8212.366666666667,68.16244241439959,102.91892595906211,8803.234885145182,5771.365114854817,7519.512150851991,87.43284279373978,330.3468304970961,19040470.0,29.11722642191455,-0.0022467543508094545,4.020970233422952,4.020970233422952,7570.375,7134.950000000001,7458.324715637482,7339.4,8407.0,0,750.0,2.73521911347758,304974246.3428002
2018-07-30,8177.1,8214.7,8262.0,7874.4,242210.0,19345.5,0.1,8208.933333333332,67.05979503398005,80.70288289261589,8873.886732580468,5887.703267419533,7582.139565056563,83.09138898053448,334.4363426044464,18798260.0,21.504034235278397,-0.00468620672866249,4.0899138154657075,4.0899138154657075,7600.425,7134.950000000001,7581.477749760984,7339.4,8407.0,0,751.0,2.735742794091325,306537695.1184503
2018-07-31,7729.4,8176.4,8176.5,7649.8,266940.0,19345.5,0.1,8040.7,55.76314198296845,30.85329357320296,8875.735829866573,6019.884170133428,7596.1643683845095,40.11577194512723,348.2123181327002,18531320.0,5.56405353728489,-0.054750461655110105,4.505036848043836,4.505036848043836,7609.3,7134.950000000001,8484.6,7339.4,8407.0,0,752.0,2.736246213262903,308059328.01556987
2018-08-01,7606.4,7728.5,7753.2,7449.2,237690.0,19345.5,0.1,7837.633333333331,53.11577706840104,-13.051994797588748,8834.295582763567,6196.904417236435,7597.139190443128,30.362382047418883,345.0542954089359,18293630.0,3.017498239341233,-0.01591326623023781,4.536367998119162,4.536367998119162,7626.8,7134.950000000001,8467.904,7339.4,8407.0,0,753.0,2.736743268481697,309572790.10855085
2018-08-02,7535.6,7606.4,7701.4,7470.6,216340.0,19345.5,0.1,7623.799999999998,51.59730631425502,-47.56889254001197,8760.508383743147,6401.231616256855,7591.278315162831,24.748235667274624,336.8932743082975,18077290.0,0.7769976596456084,-0.009307951198990194,4.4706894515141125,4.4706894515141125,7626.8,7134.950000000001,8427.155840000001,7339.4,8407.0,0,754.0,2.737236272055923,311083629.2054774
2018-08-03,7419.0,7535.6,7535.6,7293.5,226460.0,19345.5,0.1,7520.333333333332,49.107417445478745,-77.20632597835083,8654.728143010236,6623.431856989764,7574.870856575894,15.50233922765839,330.1223261434192,17850830.0,1.0845573207619201,-0.015473220446945213,4.449687641776778,4.449687641776778,7542.8,7134.950000000001,8388.037606400001,7339.4,8407.0,0,755.0,2.7377230807339723,312586383.12925005
2018-08-04,7014.3,7418.9,7484.2,6949.7,222570.0,19345.5,0.1,7322.966666666666,41.603293711970394,-120.44166259917694,8554.62274136869,6788.677258631309,7521.483155949618,4.208743240602016,344.7207314188892,17628260.0,-5.323471054301019,-0.05454913061059441,4.914542169837179,4.914542169837179,7449.625,7134.950000000001,8322.365350016002,7339.4,8407.0,0,756.0,2.738189767124706,314045929.71077603
2018-08-05,7027.1,7014.0,7087.6,6887.9,177640.0,19345.5,0.1,7153.466666666666,41.90567024646368,-143.0150481551746,8513.835759057543,6859.184240942457,7474.399045859178,8.717980835473204,334.36210774611146,17805900.0,-5.196767535043102,0.001824843533923648,4.758180582973225,4.758180582973225,7434.175,7134.950000000001,8212.552122014722,7339.4,8407.0,0,757.0,2.7386562813154054,315511857.5923755
2018-08-06,6943.6,7027.8,7143.6,6852.5,168870.0,19345.5,0.1,6994.999999999999,40.434793926961184,-157.27426970257665,8543.287203147378,6791.892796852623,7423.846755777352,5.581765823172621,331.2719571928178,17637030.0,-10.09193318658552,-0.011882568911784408,4.770896324569644,4.770896324569644,7425.325000000001,7134.950000000001,8080.08690981325,7339.4,8407.0,0,758.0,2.739117886155906,316972199.64979064
2018-08-07,6724.9,6943.6,7149.7,6689.9,232480.0,19345.5,0.1,6898.533333333333,36.79223545764727,-173.84453063993476,8595.96117281912,6673.348827180883,7357.28039808427,1.9501866607232399,340.4525316790451,17404550.0,-20.008326394671112,-0.03149662999020686,5.06256645718219,5.06256645718219,7395.25,7134.950000000001,7932.77648063566,7339.4,8407.0,0,759.0,2.7395676963705538,318409302.5979954
2018-08-08,6283.6,6725.2,6725.2,6138.8,311540.0,19345.5,0.1,6650.699999999998,30.768945876452392,-204.80425095060082,8701.896541957949,6448.023458042052,7255.025122076245,6.686677441699388,358.0202079876847,17093010.0,-23.124166534127745,-0.065621793632619,5.697692532746908,5.697692532746908,7234.675,7134.950000000001,7758.773773346667,7339.4,8407.0,0,760.0,2.7399934018255605,319791340.044413
2018-08-09,6538.8,6283.7,6620.2,6197.0,237660.0,19345.5,0.1,6515.7666666666655,37.17434262230432,-198.2442527645468,8746.212036686808,6323.647963313193,7186.813205688031,18.72133295890668,362.6759074171358,17330670.0,-17.616227793876778,0.040613660958686015,5.546520881769373,5.546520881769373,7128.85,7134.950000000001,7499.5779696112,7339.4,8407.0,0,761.0,2.740432026780161,321212514.6614204
2018-08-10,6152.3,6539.5,6570.2,6043.4,298820.0,19345.5,0.1,6324.899999999999,32.30014557982514,-209.01146396633675,8825.093778025494,6119.126221974504,7088.288138479647,4.879032258064541,374.3990568873404,17031850.0,-24.856486796785298,-0.059108704961154945,6.0855136597262875,6.0855136597262875,7068.2,7134.950000000001,7281.853494473408,6152.3,8407.0,0,762.0,2.740848960407093,322584098.71854174
2018-08-11,6231.6,6152.8,6469.6,6009.8,247340.0,19345.5,0.1,6307.566666666666,34.206276056297284,-199.8719521141085,8870.36088255707,5955.78911744293,7006.698791957777,9.789901129943512,380.49912425253035,17279190.0,-24.319597770248112,0.012889488483981637,6.105961939991821,6.105961939991821,7009.950000000001,7134.950000000001,7058.931865468195,6152.3,8407.0,0,763.0,2.741269544051986,323970975.169943
2018-08-12,6313.0,6232.1,6453.0,6169.8,216330.0,19345.5,0.1,6232.299999999999,36.19225299746403,-178.14483451973,8867.902323396569,5817.2476766034315,6940.63224034275,13.462392327501991,373.54918680592107,17495520.0,-23.15838161546327,0.013062455870081369,5.917142195563457,5.917142195563457,6997.1,7134.950000000001,6849.105492374556,6152.3,8407.0,0,764.0,2.741693831382407,325373431.45720917
2018-08-13,6255.3,6313.0,6524.1,6159.6,234090.0,19345.5,0.1,6266.633333333332,35.37708362644764,-158.13802983944953,8748.3169916314,5721.663008368601,6875.36250316725,11.330594913924402,372.9028163197839,17261430.0,-23.502219613310345,-0.009139870109298287,5.961389802563968,5.961389802563968,6913.475,7134.950000000001,6681.244393899645,6152.3,8407.0,0,765.0,2.7421142156073857,326771760.08026725
2018-08-14,6190.2,6255.3,6255.3,5898.3,3660000.0,19345.5,0.1,6252.833333333332,34.434719716895785,-140.37009588095447,8650.046751450267,5621.583248549733,6810.108931437036,15.736697396086026,371.7669008683707,13601430.0,-19.913576732993505,-0.010407174715841072,6.005733269819565,6.005733269819565,6857.725,7134.950000000001,6546.9555151197155,6152.3,8407.0,1,766.0,2.7425302632314397,328164717.9681542
2018-08-15,6256.9,6190.2,6592.8,6177.9,3740000.0,19345.5,0.1,6234.133333333331,36.30677799560342,-116.20576724133309,8565.345355252774,5538.2746447472255,6757.42236653827,19.887970717098305,374.84783652063004,17341430.0,-17.74163862010938,0.010775096119673089,5.990951374013171,5.990951374013171,6857.725,7151.55,5898.3,6152.3,8407.0,1,767.0,2.742949240664183,329571317.63974893
2018-08-16,6306.7,6256.9,6470.9,6249.8,3500000.0,19345.5,0.1,6251.2666666666655,37.73622829428928,-90.11269844025384,8409.857573237536,5505.692426762464,6714.496426867958,24.94350455017404,363.8658481977278,20841430.0,-16.307925049100277,0.007959213028816192,5.769512553280286,5.769512553280286,6751.6,7151.55,5898.3,6152.3,8407.0,1,768.0,2.743370187938421,330989145.6608935
2018-08-17,6581.7,6306.7,6581.7,6291.8,3200000.0,19345.5,0.1,6381.7666666666655,45.067707383344846,-49.601451495775336,8210.71665035544,5539.593349644561,6701.849148118628,43.09225045715366,358.5825733264615,24041430.0,-11.285887585928025,0.043604420695450896,5.448175597892057,5.448175597892057,6725.35,7151.55,5912.1900000000005,6152.3,8407.0,1,769.0,2.743805007898255,332449913.66880137
2018-08-18,6379.1,6581.8,6626.4,6295.5,3150000.0,19345.5,0.1,6422.499999999999,41.217134069828816,-32.543100822047734,7983.268811940068,5583.391188059932,6671.1111340120915,38.42096851526293,356.6052466602856,20891430.0,-9.055786037095645,-0.030782320677028685,5.590212516817194,5.590212516817194,6726.900000000001,7151.55,5925.8022,6152.3,8407.0,1,770.0,2.744228358030219,333886518.2347699
2018-08-19,6481.5,6379.1,6534.8,6316.0,2710000.0,19345.5,0.1,6480.7666666666655,43.829381644249075,-11.540238328674718,7718.747954320701,5678.352045679299,6653.052930772845,46.60380373981141,346.7620147559795,23601430.0,-7.764227063795881,0.016052421187941812,5.35002722758589,5.35002722758589,6726.900000000001,7151.55,5953.826112,6152.3,8407.0,1,771.0,2.74465640948249,335341919.78341997
2018-08-20,6268.1,6474.2,6516.4,6255.9,3100000.0,19345.5,0.1,6376.233333333333,39.85453425785769,-9.29335269824449,7544.167200273927,5706.802799726074,6616.390746889716,29.55090298865273,340.60044227340956,20501430.0,-9.728382971369317,-0.03292447735863602,5.433870587154154,5.433870587154154,6681.825,7191.450000000001,5980.72906752,6152.3,8407.0,1,772.0,2.7450722487425683,336770788.39478654
2018-08-21,6482.2,6268.1,6484.1,6257.4,1460000.0,19345.5,0.1,6410.5999999999985,45.22198808100839,8.38309725329944,7371.151548790486,5767.398451209513,6603.6106757573625,70.613133389769,332.4646963967375,21961430.0,-3.608975598150156,0.034157081093154185,5.128886742105111,5.128886742105111,6674.6,7191.450000000001,6006.5559048192,6152.3,8407.0,0,773.0,2.7454988361274113,338234786.7558229
2018-08-22,6359.6,6482.2,6840.8,6304.8,3630000.0,19345.5,0.1,6369.966666666666,42.86309921583921,13.297356303801507,7182.198275985091,5838.75172401491,6580.371563780471,48.94429708222813,347.00293236839906,18331430.0,1.209497740148959,-0.01891333189349287,5.456364116743177,5.456364116743177,6728.200000000001,7191.450000000001,6031.349668626432,6152.3,8407.0,1,774.0,2.745918140540579,339685367.9094978
2018-08-23,6521.2,6359.9,6550.2,6359.2,2760000.0,19345.5,0.1,6454.333333333332,46.80211537161357,28.061580454583805,6992.928513376378,5938.241486623622,6574.7361767537595,66.09018567639254,335.85986577065626,21091430.0,-0.2691625374686542,0.025410403170010643,5.150277031384657,5.150277031384657,6798.1,7191.450000000001,6079.916688508845,6152.3,8407.0,0,775.0,2.7463452785271083,341163519.6070461
2018-08-24,6680.4,6521.2,6721.2,6472.8,3700000.0,19345.5,0.1,6520.399999999999,50.42784388073088,48.00848646668794,6924.271694641413,5973.508305358588,6584.799398015307,82.98143236074264,329.61273250132365,24791430.0,8.583781675145872,0.024412684781941918,4.934026892122083,4.934026892122083,6812.725,7191.450000000001,6125.569687198315,6152.3,8407.0,1,776.0,2.746779906794593,342668609.72631377
2018-08-25,6734.8,6680.6,6783.4,6655.3,3590000.0,19345.5,0.1,6645.466666666664,51.64073312878574,63.36063507051378,6852.146879288546,6016.403120711453,6599.085169632897,88.75331564986737,315.2189658940862,28381430.0,8.074972719686754,0.00814322495658959,4.680450286483432,4.680450286483432,6792.875,7191.450000000001,6168.483505966416,6152.3,8407.0,0,777.0,2.747216545789739,344185864.7513109
2018-08-26,6712.7,6734.9,6892.7,6573.1,3370000.0,19345.5,0.1,6709.299999999998,51.09380577127932,70.00163076212246,6793.816869075344,6051.643130924657,6609.90562966786,81.89863234111021,315.53189690165146,25011430.0,6.331379692697606,-0.0032814634436063583,4.7005213535783135,4.7005213535783135,6700.025,7191.450000000001,6208.8224956084305,6152.3,8407.0,0,778.0,2.7476513004280414,345704624.1245473
2018-08-27,6897.6,6712.7,6902.9,6650.4,3260000.0,19345.5,0.1,6781.7,55.35417663423113,83.88522113742786,6836.637961225075,6026.092038774925,6637.305093509017,99.47242683655193,311.02961855153353,28271430.0,10.268092657426504,0.027544803134357254,4.509244063899523,4.509244063899523,6689.625,7191.450000000001,6263.532695959756,6152.3,8407.0,0,779.0,2.7480945723650763,347253721.01584816
2018-08-28,7074.6,6897.6,7129.7,6861.2,3790000.0,19345.5,0.1,6894.966666666666,59.03323165014596,100.8851778677112,6957.096773722691,5984.733226277309,6678.952227460539,94.21096869090151,307.99178865499545,32061430.0,14.287098962876815,0.025661099512874097,4.353486962584392,4.353486962584392,6704.875,7191.450000000001,6327.46942636378,6152.3,8407.0,0,780.0,2.748545723846785,348831727.2759786
2018-08-29,7029.1,7074.6,7121.4,6926.7,4110000.0000000005,19345.5,0.1,7000.433333333332,57.716556404305585,104.51787890558367,7038.901434760045,5951.9585652399555,6712.299634369059,88.56688260029554,299.89951803678144,27951430.0,12.341574901308967,-0.006431459022418262,4.266542203650274,4.266542203650274,6692.4,7191.450000000001,6423.7370952001265,6152.3,8407.0,0,781.0,2.748993898332711,350408561.6096759
2018-08-30,6993.7,7029.2,7050.2,6798.0,3740000.0,19345.5,0.1,7032.466666666666,56.65774658894663,99.98815186781079,7098.203682884411,5976.796317115589,6739.099669191053,84.43579766536965,296.4924096055828,24211430.0,10.893177097372636,-0.005036206626737538,4.239421330705961,4.239421330705961,6620.625,7191.450000000001,6508.4526437761115,6152.3,8407.0,0,782.0,2.7494395785304597,351985500.81807935
2018-08-31,7033.8,6993.7,7080.2,6698.0,4210000.0,19345.5,0.1,7018.866666666665,57.6064770602084,95.17016921567522,7159.418514547651,5995.80148545235,6767.166367363334,89.02494850080114,302.61438034804115,28421430.0,6.8690459911573045,0.005733731787179952,4.302288668259563,4.302288668259563,6634.225,7191.450000000001,6583.002326522978,6152.3,8407.0,0,783.0,2.749886438595117,353572867.8369557
2018-09-01,7189.6,7032.4,7264.3,7020.4,3520000.0,19345.5,0.1,7072.366666666666,61.16344405896564,97.59087177797586,7247.315014360011,5995.56498563999,6807.398141900159,92.5922253074177,298.4204960374668,31941430.0,12.705554075026257,0.022150189086979966,4.150724602724307,4.150724602724307,6724.925,7191.450000000001,6648.606047340221,6152.3,8407.0,0,784.0,2.750339995376015,355186407.31282085
2018-09-02,7293.9,7189.6,7334.8,7117.3,3900000.0,19345.5,0.1,7172.433333333332,63.378660141313055,100.91270574371529,7340.124395861133,6006.615604138867,6853.731652195382,96.20910186300857,292.64046060621916,35841430.0,12.534135616755377,0.014507065761655724,4.012126031426523,4.012126031426523,6785.25,7191.450000000001,6698.0,6152.3,8407.0,0,785.0,2.7507976825857234,356819092.2781807
2018-09-03,7264.2,7289.8,7330.7,7182.8,3870000.0,19345.5,0.1,7249.233333333333,62.28911711364755,95.84364796926087,7402.460281541084,6051.679718458915,6892.823875795822,93.44718767403003,282.30185627720346,31971430.0,15.891577990140544,-0.004071895693661842,3.8862071016382185,3.8862071016382185,6785.25,7191.450000000001,6799.888,6152.3,8407.0,0,786.0,2.7512531993880813,358453059.7586189
2018-09-04,7377.5,7264.2,7409.9,7234.5,3920000.0,19345.5,0.1,7311.866666666665,64.77676397316681,94.68854906042465,7478.797103630701,6087.4028963693,6938.98350667241,97.06813862998827,274.66600940026035,35891430.0,13.811668877850117,0.015597037526499768,3.7230228315860434,3.7230228315860434,6842.125,7191.450000000001,6885.47392,6152.3,7377.5,0,787.0,2.75171320754219,360107441.0539119
2018-09-05,6706.8,7377.5,7407.5,6691.8,4550000.0,19345.5,0.1,7116.166666666665,45.600166974428845,45.79833314620419,7465.04654266079,6141.163457339211,6916.870791751228,33.08270676691733,306.16843730024175,31341430.0,5.4594628592993235,-0.09091155540494744,4.565044988671821,4.565044988671821,6852.475,7191.450000000001,7409.9,6152.3,7377.5,0,788.0,2.7521399919491643,361673351.368163
2018-09-06,6514.0,6706.8,6732.9,6337.8,4019999.9999999995,19345.5,0.1,6866.0999999999985,41.771918470478234,-0.0543455454502606,7466.827996054721,6132.612003945278,6878.502144917778,16.435034045331584,312.5206917787959,27321430.0,-0.11040912715450865,-0.028746943400727698,4.79767718420012,4.79767718420012,6763.975,7191.450000000001,7409.9,6152.3,7377.5,0,789.0,2.7525561034692765,363215058.72818184
2018-09-07,6390.9,6514.1,6540.6,6316.2,3300000.0,19345.5,0.1,6537.233333333333,39.49220245612367,-37.151266535319444,7465.948195719076,6134.671804280925,6832.063845401799,6.830026515497836,306.2263566517391,24021430.0,-4.333572839949704,-0.018897758673626086,4.791599878761037,4.791599878761037,6758.575,7191.450000000001,7407.5,6152.3,7377.5,0,790.0,2.752964988456176,364742245.4215858
2018-09-08,6184.3,6390.9,6484.3,6132.3,3460000.0,19345.5,0.1,6363.066666666666,35.946443532115936,-72.05966600429173,7490.968695712698,6079.931304287302,6770.372050601628,4.070131496556044,309.49590260518625,20561430.0,-8.173962107263764,-0.03232721525919657,5.004542189175594,5.004542189175594,6712.6,7191.450000000001,7342.022,6184.3,7377.5,0,791.0,2.7533619703593053,366240971.9738555
2018-09-09,6238.5,6184.3,6432.6,6148.8,2840000.0,19345.5,0.1,6271.233333333333,37.531029662156946,-86.95850132047177,7493.933748652102,6074.006251347897,6719.717569591949,8.312460864120215,307.6604809905301,23401430.0,-7.064221550195896,0.008764128518991665,4.9316419169757175,4.9316419169757175,6771.1,7191.450000000001,7245.24424,6184.3,7377.5,0,792.0,2.753761201060063,367752455.10750204
2018-09-10,6321.0,6238.5,6358.5,6237.3,3110000.0,19345.5,0.1,6247.933333333332,39.96554502558684,-86.53047200848039,7502.8514609170015,6048.968539082996,6681.744467726049,14.769881026925477,294.3418752054922,26511430.0,-8.359429366736261,0.01322433277230095,4.656571352720965,4.656571352720965,6771.1,7191.450000000001,7156.2087008,6184.3,7377.5,0,793.0,2.7541641766299785,369281221.6939262
2018-09-11,6293.9,6320.7,6391.8,6189.6,3300000.0,19345.5,0.1,6284.466666666664,39.42206008690971,-83.31549438747379,7507.611154631601,6037.638845368399,6644.806899371188,12.648716343143356,287.7603126908142,23211430.0,-11.035252876487727,-0.004287296313874478,4.572050917409146,4.572050917409146,6771.1,7191.450000000001,7074.296004736,6184.3,7377.5,0,794.0,2.7545649701145676,370809856.2343516
2018-09-12,6338.0,6293.9,6353.5,6204.5,3040000.0,19345.5,0.1,6317.633333333331,40.832133311993765,-73.78853546941355,7515.133741601078,6011.796258398924,6615.58719466917,16.100500939261106,277.8488617843275,26251430.0,-9.831984180051505,0.007006784346748507,4.383857080850859,4.383857080850859,6771.1,7191.450000000001,6998.936324357121,6184.3,7377.5,0,795.0,2.754967414372638,372349719.9934712
2018-09-13,6482.9,6338.0,6867.3,6337.8,3530000.0,19345.5,0.1,6371.5999999999985,45.334635127764344,-54.203768375752404,7514.496840290022,5992.683159709976,6602.950318986392,27.44207889793359,295.82394308544696,29781430.0,-7.303716201724413,0.022862101609340435,4.563142159919897,4.563142159919897,6770.5,7191.450000000001,6929.605418408551,6184.3,7377.5,0,796.0,2.7553768101525726,373916756.21252275
2018-09-14,6483.7,6482.9,6579.4,6412.1,3200000.0,19345.5,0.1,6434.866666666665,45.35935749583662,-38.4142118267939,7511.000075247018,5971.06992475298,6591.593145749593,27.50469630557293,286.6436614364864,32981430.0,-7.820808098040893,0.0001234015641149444,4.4209889636548025,4.4209889636548025,6635.450000000001,7191.450000000001,6867.3,6184.3,7377.5,0,797.0,2.7557855195446708,375488312.12437904
2018-09-15,6519.0,6482.6,6562.9,6470.3,3160000.0,19345.5,0.1,6495.199999999998,46.50890962279433,-23.541871206253006,7507.34636210497,5955.353637895031,6584.679512821061,30.26768941765811,272.7833999053088,36141430.0,-9.32736174474241,0.005444422166355656,4.184436261778015,4.184436261778015,6635.450000000001,7101.299999999999,6867.3,6184.3,7377.5,0,798.0,2.756195343498823,377069821.95282036
2018-09-16,6500.2,6519.0,6520.8,6406.2,3340000.0,19345.5,0.1,6500.966666666664,45.954401624785625,-13.422935356949296,7489.779003211585,5933.1809967884155,6576.633844933341,28.796180338133986,261.4845856263582,32801430.0,-10.881695663499634,-0.0028838778953828026,4.022716002990034,4.022716002990034,6635.450000000001,7086.85,6808.5,6184.3,7377.5,0,799.0,2.756603460031616,378652806.9797753
2018-09-17,6251.9,6500.2,6533.5,6215.9,3260000.0,19345.5,0.1,6423.699999999998,39.29136333847673,-21.429353128768952,7454.470317726795,5886.219682273204,6545.706812082547,9.361302442078859,265.4928295101898,29541430.0,-13.93546433192919,-0.038198824651549224,4.246594307493559,4.246594307493559,6639.575000000001,7086.85,6754.404,6184.3,7377.5,0,800.0,2.756997647847296,380200050.46619976
2018-09-18,6342.0,6251.9,6388.8,6228.8,2820000.0,19345.5,0.1,6364.699999999998,42.54667884325511,-18.731942487888205,7414.419513572133,5857.560486427867,6526.306163312781,16.444479297365106,257.9576274023191,32361430.0,-14.035920027109455,0.01441161886786424,4.067449186413104,4.067449186413104,6649.775000000001,7086.85,6704.63568,6184.3,7377.5,0,801.0,2.757395972829725,381766236.30193716
2018-09-19,6390.4,6342.0,6478.7,6144.5,3540000.0,19345.5,0.1,6328.0999999999985,44.275283692273995,-12.085484983783218,7373.147878259307,5838.502121740693,6513.362719187754,35.115646258503325,263.4035111592963,35901430.0,-4.717600047712777,0.007631661936297718,4.121862655847776,4.121862655847776,6638.5,7080.15,6658.8488256,6184.3,7377.5,0,802.0,2.7577961577303345,383344562.5975211
2018-09-20,6489.2,6390.4,6537.5,6346.4,5180000.0,19345.5,0.1,6407.199999999998,47.732365823660516,-0.06830417534503397,7321.498941233418,5835.691058766581,6511.061507836539,48.55782312925165,258.238974647918,41081430.0,-0.38071845256371173,0.015460691036554897,3.979519426861832,3.979519426861832,6638.5,7037.4,6616.724919552,6184.3,7377.5,0,803.0,2.7582008210931273,384943193.11593354
2018-09-21,6766.7,6490.9,6780.5,6489.8,7730000.0,19345.5,0.1,6548.7666666666655,55.99077309907433,26.089553679869624,7252.093144355536,5862.806855644463,6535.408030899725,86.31292517006798,260.600476458781,48811430.0,5.880235960506348,0.04276336066079023,3.8512195968312617,3.8512195968312617,6638.5,6825.75,6132.3,6184.3,7377.5,1,804.0,2.7586189387277957,386590095.8482735
2018-09-22,6729.6,6766.7,6833.3,6635.5,7310000.0,19345.5,0.1,6661.833333333332,54.745379777305345,39.602775417736694,7143.075498093884,5915.394501906116,6553.902504147371,80.94908688433871,256.1147281402966,41501430.0,8.817489449088825,-0.005482731612159508,3.805794224623998,3.805794224623998,6630.0,6799.85,6145.264,6184.3,7377.5,0,805.0,2.759034461189115,388235970.1064314
2018-09-23,6704.1,6729.6,6789.4,6666.4,7340000.0,19345.5,0.1,6733.466666666664,53.85863956831497,45.13222095581007,7022.520591129503,5979.939408870496,6568.207027561907,77.4211400110681,246.60653327313256,34161430.0,7.463332531858626,-0.0037892296718973206,3.6784435386275938,3.6784435386275938,6630.0,6716.950000000001,6172.785440000001,6184.3,7377.5,0,806.0,2.759447967609254,389882548.9449838
2018-09-24,6584.1,6713.3,6728.1,6559.1,7570000.0,19345.5,0.1,6672.5999999999985,49.77292657838699,39.234092879582626,6798.09039922145,6125.029600778549,6569.720643984583,60.81903707802992,241.0632094679088,26591430.0,4.162316089226394,-0.01789949433928495,3.66129325903174,3.66129325903174,6630.0,6691.25,6199.206022400001,6184.3,7377.5,0,807.0,2.7598546364728946,391514673.0476406
2018-09-25,6445.1,6590.6,6590.6,5977.0,7340000.0,19345.5,0.1,6577.7666666666655,45.47007483362425,25.18061462430245,6765.63977657544,6131.310223424561,6557.852011224147,52.57778276985289,267.67298022020105,19251430.0,2.4023260617423334,-0.02111146550022025,4.15312377186081,4.15312377186081,6549.299999999999,6654.1,6833.3,6184.3,7377.5,0,808.0,2.7602533695617972,393128644.59031314
2018-09-26,6468.1,6443.0,6551.9,6384.1,8640000.0,19345.5,0.1,6499.0999999999985,46.29736248210742,17.033297248812552,6762.076740091044,6130.283259908955,6549.304200631371,55.161181624171654,260.5391959187581,27891430.0,2.05269801199117,0.00356860250422808,4.028063819649636,4.028063819649636,6549.299999999999,6654.1,6816.174,6184.3,7377.5,0,809.0,2.7606525926756866,394750801.31069416
2018-09-27,6689.2,6463.7,6738.3,6428.8,9340000.0,19345.5,0.1,6534.133333333332,53.58701357993735,25.618399803418548,6792.910445541867,6129.279554458131,6562.62761009505,83.17178558916264,264.03639621027537,37231430.0,3.1822178346110563,0.03418314497302144,3.9472043923081293,3.9472043923081293,6549.299999999999,6654.1,6799.39052,6184.3,7377.5,0,810.0,2.7610624572985563,396413399.55502677
2018-09-28,6636.0,6685.7,6809.2,6538.6,9570000.0,19345.5,0.1,6597.7666666666655,51.766202018347386,26.67743904683818,6798.094405522628,6169.2655944773705,6569.615456752665,76.95900969286464,264.50522505239854,27661430.0,2.348967410583466,-0.007953118459606556,3.9859135782459094,3.9859135782459094,6549.299999999999,6654.1,5977.0,6184.3,7377.5,0,811.0,2.761468900688415,398072084.92239624
2018-09-29,6603.9,6633.9,6648.4,6464.4,9420000.0,19345.5,0.1,6643.033333333332,50.64793560858322,24.24952045043615,6799.253161772875,6204.646838227125,6572.880651347649,73.21032348475995,258.7548518343701,18241430.0,1.3023469857340026,-0.004837251356238803,3.918212750562093,3.918212750562093,6549.299999999999,6654.1,5993.644,6184.3,7377.5,0,812.0,2.7618729862411295,399730151.2424627
2018-09-30,6635.2,6603.9,6673.9,6533.5,9340000.0,19345.5,0.1,6625.033333333332,51.74261452641722,23.754090062161744,6808.184500860337,6227.135499139663,6578.815827409778,76.86558449141653,250.30093384620073,27581430.0,2.07685917356389,0.004739623555777728,3.7723193550488414,3.7723193550488414,6548.7,6654.1,6009.9551200000005,6184.3,7377.5,0,813.0,2.7622779495869865,401397929.2140922
2018-10-01,6608.2,6635.2,6674.7,6072.7,9190000.0,19345.5,0.1,6615.7666666666655,50.69795214147167,20.72116694705631,6807.313736764532,6259.436263235468,6581.614320037418,73.71248394254347,275.42229571432927,18391430.0,5.699067483485024,-0.004069206655413549,4.167886802977048,4.167886802977048,6407.625,6654.1,6025.940017600001,6184.3,7377.5,0,814.0,2.7626808185769303,403065892.38190794
2018-10-02,6549.9,6608.2,6645.7,6034.9,9340000.0,19345.5,0.1,6597.7666666666655,48.4245180469764,14.212062783112291,6802.840145826334,6285.099854173666,6578.593908605283,66.90412238701384,299.3778460204486,9051430.0,3.2781456953642327,-0.0088223722042311,4.570723919761349,4.570723919761349,6407.625,6654.1,6809.2,6184.3,7377.5,0,815.0,2.7630799825502392,404728765.5095237
2018-10-03,6507.8,6549.9,6563.5,6429.6,9210000.0,19345.5,0.1,6555.299999999998,46.79271252780139,6.866827666591782,6803.136106348718,6287.29389365128,6571.851631595257,61.98762116080813,287.5579998761308,-158570.0,1.8371306960440748,-0.006427579047008303,4.4186668286691475,4.4186668286691475,6407.625,6654.1,6793.714,6184.3,7377.5,0,816.0,2.7634762601770526,406389090.83843744
2018-10-04,6584.2,6509.2,6653.0,6487.8,9310000.0,19345.5,0.1,6547.299999999998,50.08025516157417,6.929313502902808,6807.085170482427,6293.394829517572,6573.0276666814225,70.90972789910074,278.81814274212144,9151430.0,1.4639709055045307,0.011739758443713555,4.234654821270943,4.234654821270943,6422.099999999999,6654.1,6778.53772,6184.3,7377.5,0,817.0,2.763875762618185,408066746.05195624
2018-10-05,6639.1,6584.2,6682.3,6537.6,9340000.0,19345.5,0.1,6577.033333333333,52.35824456337974,10.24366663104366,6815.492437596106,6296.997562403893,6579.320269854621,77.32103234847602,269.23827540339846,18491430.0,-1.8857049965271027,0.008338142826767259,4.055342974249498,4.055342974249498,6422.099999999999,6693.45,6763.6649656,6184.3,7377.5,0,818.0,2.7642773508701004,409758153.6842973
2018-10-06,6596.3,6639.1,6661.5,6550.4,9180000.0,19345.5,0.1,6606.533333333333,50.426309025876954,9.164150167561099,6819.525441773773,6302.574558226227,6580.937387011323,74.41720740206685,257.9426843031557,9311430.0,-1.9808012363290564,-0.0064466569263906814,3.9104146916173566,3.9104146916173566,6422.099999999999,6693.45,6749.0896662879995,6184.3,7377.5,0,819.0,2.764676046953746,411447027.28848577
2018-10-07,6611.0,6596.3,6633.9,6523.8,77060.0,19345.5,0.1,6615.466666666664,51.09377623320754,9.035860121847367,6795.57896404034,6362.43103595966,6583.800493010245,76.18360970920453,247.38249256721596,9388490.0,-1.3887024358228601,0.002228522050240267,3.741982946108243,3.741982946108243,6390.375,6693.45,6734.80587296224,6184.3,7377.5,0,820.0,2.765074782011373,413142973.7962802
2018-10-08,6669.6,6611.0,6699.5,6589.9,119680.0,19345.5,0.1,6625.633333333332,53.76618782842031,12.291506431270424,6785.748549820196,6405.021450179805,6591.971874628317,83.22518625330454,237.540885955272,9508170.0,1.2985829498336903,0.008864014521252406,3.5615462089971213,3.5615462089971213,6394.674999999999,6693.45,6720.807755502995,6184.3,7377.5,0,821.0,2.7654757772207708,414853402.37025666
2018-10-09,6650.8,6669.6,6678.9,6613.3,80790.0,19345.5,0.1,6643.799999999999,52.769932466498865,12.529970122150056,6775.050113640173,6441.759886359829,6597.574553235145,79.54281286323136,225.25939410132395,9427380.0,3.1915718918247937,-0.002818759745711885,3.386951856939375,3.386951856939375,6386.174999999999,6693.45,6707.089600392935,6184.3,7377.5,0,822.0,2.765875110352724,416565351.0480083
2018-10-10,6618.0,6650.6,6653.5,6526.0,101930.0,19345.5,0.1,6646.133333333332,50.99457393177564,9.942815909641542,6772.265284271581,6457.424715728418,6599.519833879416,75.30672865814287,218.27658023694366,9325450.0,2.3175275583246955,-0.0049317375353341575,3.2982257515403997,3.2982257515403997,6386.174999999999,6693.45,6699.5,6184.3,7377.5,0,823.0,2.766272070181918,418276397.13109404
2018-10-11,6239.1,6618.0,6622.5,6206.2,245280.0,19345.5,0.1,6502.633333333332,35.94868168244406,-16.389713100482854,6802.059009981897,6374.870990018105,6565.194135414709,26.37220715484963,232.4211102200191,9080170.0,-6.7287568020092,-0.0572529465095194,3.725234572614946,3.725234572614946,6429.0,6693.45,6686.208,6239.1,7377.5,0,824.0,2.7666484975379597,419925393.3532531
2018-10-12,6291.3,6239.2,6344.8,6206.8,147400.0,19345.5,0.1,6382.799999999999,38.634927856847085,-28.675837982996406,6806.088978039373,6327.011021960628,6539.108979660928,38.579596749924825,225.67674520430344,9227570.0,-5.194394213381552,0.008366591335288609,3.5871242065122226,3.5871242065122226,6429.0,6693.45,6673.181839999999,6239.1,7377.5,0,825.0,2.76702703884823,421588005.14577234
2018-10-13,6321.7,6291.3,6329.3,6282.8,94450.0,19345.5,0.1,6284.033333333333,40.20764690296006,-32.83975695012794,6800.655054842817,6294.204945157184,6518.403362550363,43.153776707794165,212.8784062611389,9322020.0,-4.273232483835307,0.004832069683531115,3.367423418718682,3.367423418718682,6429.0,6693.45,6660.4162031999995,6239.1,7377.5,0,826.0,2.7674065114157727,423260333.9877491
2018-10-14,6326.8,6321.6,6390.9,6300.0,99380.0,19345.5,0.1,6313.2666666666655,40.483228705376916,-33.23429353566562,6804.615878725006,6264.514121274995,6500.155423259853,43.921155582305204,204.1656629567718,9421400.0,-4.647938268627919,0.0008067450211177718,3.226997264917048,3.226997264917048,6429.0,6693.45,6647.905879135999,6239.1,7377.5,0,827.0,2.7677855656679005,424937850.0166039
2018-10-15,6699.8,6326.8,7358.4,6300.2,443330.0,19345.5,0.1,6449.433333333332,56.334568784029514,-7.691305813645229,6823.232020614041,6271.367979385959,6519.1691924732,50.238005289006466,265.1681156027167,9864730.0,1.386156593323452,0.0589555541505975,3.9578512135096076,3.9578512135096076,6725.0,6693.45,6034.9,6239.1,7377.5,0,828.0,2.7681831675104642,426685380.9117021
2018-10-16,6705.3,6712.4,6836.7,6645.4,155850.0,19345.5,0.1,6577.299999999998,56.51846383444796,9.33435261557819,6840.787615123495,6277.5323848765065,6536.895936047182,43.31713244228436,259.8918216310941,10020580.0,2.372555306187889,0.0008209200274635897,3.8759163889922017,3.8759163889922017,6725.0,6693.45,6061.37,6239.1,6705.3,0,829.0,2.7685803380274963,428438600.453594
2018-10-17,6686.6,6718.9,6745.9,6637.8,136710.0,19345.5,0.1,6697.233333333333,55.66016139164066,18.56333856159584,6840.419687799939,6277.640312200062,6551.15346594745,41.69415032112486,249.0495486574445,9883870.0,2.7474722640523708,-0.0027888386798502474,3.7246066559603457,3.7246066559603457,6725.0,6693.45,6087.3106,6239.1,6705.3,0,830.0,2.768975865285992,430193342.88595945
2018-10-18,6574.1,6690.1,6736.3,6530.6,134150.0,19345.5,0.1,6655.333333333333,50.67437153348362,16.39331607866351,6835.224070856966,6276.645929143035,6553.338850142932,31.930220447838973,245.9531523247699,9749720.0,-0.15339752741410428,-0.016824694164448317,3.7412444642577674,3.7412444642577674,6725.0,6693.45,6112.732387999999,6239.1,6705.3,0,831.0,2.7693649962113978,431933119.62337184
2018-10-19,6512.0,6576.4,6603.2,6506.9,121440.0,19345.5,0.1,6590.899999999999,48.11242245288554,10.371418685345118,6830.345121100218,6272.334878899782,6549.401816795986,26.540531157785125,235.2636414444292,9628280.0,-1.9144161106174082,-0.00944615993063691,3.6127709067019222,3.6127709067019222,6725.0,6693.45,6137.645740239999,6239.1,6705.3,0,832.0,2.769750246801915,433666430.1010291
2018-10-20,6572.2,6511.7,6593.7,6495.9,97770.0,19345.5,0.1,6552.7666666666655,50.7137638403722,10.032180257279276,6824.748665747699,6271.631334252302,6551.573072339225,31.765318521090094,225.4448099126843,9726050.0,-0.36535633612783475,0.009244471744471738,3.430279205025476,3.430279205025476,6725.15,6693.45,6162.060825435199,6239.1,6705.3,0,833.0,2.7701378890711092,435415018.2780683
2018-10-21,6583.0,6575.9,6643.1,6568.0,92940.0,19345.5,0.1,6555.733333333333,51.18657226701118,10.097047855497213,6822.6117955544905,6271.24820444551,6554.566113068823,32.702655788925554,214.70589491892116,9818990.0,-0.4235365300257147,0.001643285353458479,3.2615205061358217,3.2615205061358217,6758.625,6693.45,6185.987608926495,6239.1,6705.3,0,834.0,2.7705253862504344,437170128.02396864
2018-10-22,6555.8,6583.0,6612.7,6529.5,101570.0,19345.5,0.1,6570.333333333332,49.88852633096421,7.963716375912853,6822.9315024625785,6271.518497537422,6554.683626109888,30.341954521784448,205.31261671042677,9717420.0,-1.7062492503298574,-0.0041318547774570336,3.1317705956622652,3.1317705956622652,6762.924999999999,6693.45,6209.435856747966,6239.1,6705.3,0,835.0,2.770910801376562,438924969.05362993
2018-10-23,6528.7,6558.6,6573.6,6500.5,108860.0,19345.5,0.1,6555.833333333332,48.5670457928612,4.552659907744476,6823.5289261044,6273.011073895601,6552.208995051804,27.98993230341955,195.86885837396773,9608560.0,-1.8358693690984598,-0.004133744165471853,3.000120366596225,3.000120366596225,6762.974999999999,6693.45,6232.415139613006,6239.1,6705.3,0,836.0,2.771294136648946,440679488.3409345
2018-10-24,6530.7,6531.2,6593.8,6522.6,98740.0,19345.5,0.1,6538.399999999999,48.675097992701424,2.3662809711994957,6820.444780607784,6270.7452193922145,6550.160519332585,28.16351327894463,186.9639399186843,9707300.0,-1.3191296464188604,0.0003063397000935275,2.8628468605001656,2.8628468605001656,6681.474999999999,6693.45,6254.934836820747,6239.1,6705.3,0,837.0,2.77167688428425,442438915.4454486
2018-10-25,6507.0,6532.5,6544.8,6491.5,97430.0,19345.5,0.1,6522.133333333331,47.40419628140089,-0.5833874108954245,6810.867133279258,6267.112866720741,6546.049993681862,26.068079194164635,177.4165156387783,9609870.0,4.293888541616573,-0.0036290137351279173,2.726548572902694,2.726548572902694,6657.674999999999,6693.45,6277.004140084332,6239.1,6705.3,0,838.0,2.7720577258206327,444198559.6526214
2018-10-26,6510.0,6507.0,6570.5,6498.5,97170.0,19345.5,0.1,6515.899999999999,47.590735771269486,-2.1515830575507815,6805.514242910159,6263.8357570898415,6542.616660950256,21.12309408702119,169.88676452172268,9707040.0,3.476229078250915,0.0004610419548178868,2.609627719227691,2.609627719227691,6655.275,6692.25,6298.632057282645,6239.1,6705.3,0,839.0,2.7724380344592032,445963274.7029515
2018-10-27,6494.2,6510.0,6534.0,6473.7,76720.0,19345.5,0.1,6503.733333333333,46.652281549574276,-3.966559136854574,6797.870345447672,6259.799654552328,6538.005550383566,18.348450491307624,162.05913848445678,9630320.0,2.7286963949570526,-0.002427035330261118,2.495444219218022,2.495444219218022,6627.525,6667.7,6319.827416136993,6239.1,6705.3,0,840.0,2.772816844061352,447729598.4886997
2018-10-28,6486.1,6494.6,6502.2,6461.2,93970.0,19345.5,0.1,6496.7666666666655,46.14985379990437,-5.340631763206138,6781.281087835342,6258.038912164658,6533.06216463275,17.56756756756762,153.41205716413842,9536350.0,2.517860529809701,-0.001247266791906565,2.3652434770376405,2.3652434770376405,6667.224999999999,6667.7,6340.598867814253,6239.1,6705.3,0,841.0,2.773194551865465,449498925.1221589
2018-10-29,6335.0,6486.1,6498.4,6310.5,160520.0,19345.5,0.1,6438.433333333332,37.94113812638496,-15.480077035184506,6770.006469504178,6237.733530495823,6514.199101334392,4.656024325351579,155.87548165241424,9375830.0,-5.444938654885223,-0.023295971384961756,2.460544303905513,2.460544303905513,6629.549999999999,6667.7,7358.4,6239.1,6705.3,0,842.0,2.773563697959578,451244253.2856245
2018-10-30,6325.7,6336.7,6469.9,6316.5,128210.00000000001,19345.5,0.1,6382.2666666666655,37.49903041519157,-21.49733463595373,6760.765599977512,6217.744400022489,6496.246805969212,3.4910427193385005,155.69866153438463,9247620.0,-5.661193384337768,-0.0014680347277032935,2.461366513340573,2.461366513340573,6621.95,6667.7,7337.442,6239.1,6705.3,0,843.0,2.773931678879622,452992100.94612426
2018-10-31,6365.9,6327.9,6405.7,6257.8,129060.0,19345.5,0.1,6342.2,40.7148483892871,-21.40747914490266,6748.745172625159,6242.444827374839,6483.832824448335,22.591431556948685,155.14161428192853,9376680.0,-4.796159483145406,0.006355027902050336,2.437072751408733,2.437072751408733,6604.049999999999,6667.7,7316.90316,6239.1,6705.3,0,844.0,2.7743011029204583,454751951.9470065
2018-11-01,6400.5,6365.9,6421.8,6354.2,124160.0,19345.5,0.1,6364.033333333333,43.41353228606156,-17.803100797778967,6740.69449152873,6261.41550847127,6475.896364977065,37.036075785102454,148.88864183321934,9500840.0,-2.640665642445359,0.005435209475486591,2.3262032940117074,2.3262032940117074,6604.049999999999,6667.7,7274.5390336,6239.1,6705.3,0,845.0,2.774671662889882,456522770.027618
2018-11-02,6424.7,6400.5,6444.3,6390.9,135870.0,19345.5,0.1,6397.033333333332,45.28939708604923,-12.807961916789758,6734.357076256492,6278.052923743508,6471.020520693535,43.316895925252936,142.068024559418,9636710.0,-1.3406019656019685,0.0037809546129208282,2.211278729892727,2.211278729892727,6598.224999999999,6667.7,7233.869472256,6239.1,6705.3,0,846.0,2.7750428076879614,458302605.85940033
2018-11-03,6386.2,6424.5,6429.5,6346.2,112840.0,19345.5,0.1,6403.799999999998,42.85537616083749,-11.17515029627431,6729.313809618268,6289.036190381732,6462.942375865579,33.324682065922545,137.8703085194596,9523870.0,-2.83010255317854,-0.005992497704172983,2.1588786527114654,2.1588786527114654,6598.224999999999,6667.7,7194.826693365761,6386.2,6705.3,0,847.0,2.7754112717137898,460079466.7596892
2018-11-04,6478.2,6386.2,6508.9,6359.7,128759.99999999999,19345.5,0.1,6429.699999999998,49.79851870648071,-3.3816993905304216,6700.318494926153,6295.871505073846,6464.395482926,62.10200056353899,138.67957219664103,9652630.0,-1.5919793407261154,0.01440606307350234,2.140711496968927,2.140711496968927,6589.099999999999,6667.7,7157.34562563113,6386.2,6705.3,0,848.0,2.7757838347300257,461878367.169817
2018-11-05,6459.7,6478.2,6489.2,6431.7,128509.99999999999,19345.5,0.1,6441.366666666665,48.52182586673713,0.8204310183390007,6664.698205193077,6306.931794806924,6463.948294075904,60.08928571428561,132.8810313254524,9524120.0,-1.465877543549229,-0.002855731530363337,2.0570774389747575,2.0570774389747575,6582.825,6667.7,7121.3638006058845,6386.2,6705.3,0,849.0,2.7761547681068617,463678217.0415968
2018-11-06,6502.8,6460.4,6509.6,6441.6,154870.0,19345.5,0.1,6480.233333333333,51.63289940763823,6.4806068584052525,6630.430563944054,6322.819436055946,6467.648456544866,72.91666666666667,128.24667194506293,9678990.0,-0.39670991162099095,0.006672136476926216,1.9721761694202946,1.9721761694202946,6583.150000000001,6667.7,7086.821248581649,6386.2,6705.3,0,850.0,2.7765272441701008,465490811.4377114
2018-11-07,6565.3,6503.1,6594.3,6502.0,170760.0,19345.5,0.1,6509.2666666666655,55.80406033111611,13.981233621317713,6628.919256472306,6323.450743527693,6476.9486035405935,91.38187221396731,125.67905252041558,9849750.0,0.5298053807402019,0.009611244387033313,1.9142926068940576,1.9142926068940576,6617.075000000001,6667.7,7053.660398638383,6386.2,6565.3,0,851.0,2.776902232453131,467319878.43091315
2018-11-08,6474.0,6565.3,6577.3,6466.3,159300.0,19345.5,0.1,6514.033333333333,49.1375868040522,12.3952013634084,6626.132703638048,6322.437296361952,6476.667784155775,64.24962852897468,124.63054876895733,9690450.0,-0.5071461502996772,-0.013906447534766109,1.9250934317108022,1.9250934317108022,6617.075000000001,6667.7,7021.825982692848,6386.2,6565.3,0,852.0,2.7772718780094268,469136008.9153594
2018-11-09,6412.0,6473.8,6496.1,6390.0,151600.0,19345.5,0.1,6483.7666666666655,45.189610371922505,7.0385760795001,6613.44666677098,6319.103333229019,6470.508947569511,45.82466567607721,123.30693814260326,9538850.0,-1.5053763440860215,-0.009576768612913233,1.9230651613007372,1.9230651613007372,6639.175,6667.7,6991.264943385134,6386.2,6565.3,0,853.0,2.7776376469826727,470944530.6717681
2018-11-10,6427.1,6411.9,6461.7,6411.7,115870.0,19345.5,0.1,6437.7,46.320803287941864,4.503718825905068,6596.314837396605,6320.645162603396,6466.374762086701,50.31203566121848,118.07072827527445,9654720.0,-1.033229651073257,0.0023549594510294813,1.83707625951478,1.83707625951478,6508.75,6667.7,6961.926345649728,6386.2,6565.3,0,854.0,2.7780035311908144,472760432.6528197
2018-11-11,6446.1,6427.1,6451.7,6359.0,127400.0,19345.5,0.1,6428.399999999999,47.78117110032727,4.108996515542309,6583.43470982852,6322.55529017148,6464.443832364158,55.958395245170934,116.25853339846911,9782120.0,-0.6167034119116264,0.002956232204260001,1.8035483997838866,1.8035483997838866,6486.05,6667.7,6933.761291823739,6386.2,6565.3,0,855.0,2.7783697301133152,474584505.7343947
2018-11-12,6435.0,6445.0,6475.9,6409.4,130160.0,19345.5,0.1,6436.066666666666,46.9770962585087,3.1460844069157865,6574.187859848936,6322.432140151063,6461.639657853286,52.65973254086176,112.7043524414356,9651960.0,1.5785319652722969,-0.0017219714245824136,1.7514273883672975,1.7514273883672975,6486.85,6667.7,6906.72284015079,6386.2,6565.3,0,856.0,2.7787346879682224,476410846.529186
2018-11-13,6429.2,6435.0,6466.8,6386.7,137600.0,19345.5,0.1,6436.7666666666655,46.53641728693092,2.2085824397572047,6563.474881487585,6322.995118512415,6458.550166629164,50.936106983655165,110.37547012419023,9514360.0,1.6361825568711765,-0.00090132090132089,1.7167838941733067,1.7167838941733067,6463.55,6667.7,6880.765926544758,6386.2,6565.3,0,857.0,2.7790986797469426,478240481.29030585
2018-11-14,5842.4,6428.9,6453.3,5619.2,438210.0,19345.5,0.1,6235.533333333332,23.01418449253495,-35.74694402493192,6695.360991526634,6124.649008473366,6399.869198378768,22.889960004102115,162.0700794010338,9076150.0,-8.223503353807002,-0.09127107571704107,2.7740325790947864,2.7740325790947864,6118.95,6488.799999999999,6855.847289482968,6386.2,6565.3,1,858.0,2.779430186658782,479952051.57658833
2018-11-15,5718.9,5854.0,5878.5,5384.1,375860.0,19345.5,0.1,5996.833333333332,20.648603512530926,-65.26676150753224,6781.175058889945,5959.724941110055,6335.014989009362,27.664848785324683,185.80793087238848,8700290.0,-10.649168033747369,-0.021138573189100396,3.249015210484332,3.249015210484332,6001.400000000001,6371.25,6781.64845211399,6386.2,6565.3,1,859.0,2.7797539602600256,481639832.6792357
2018-11-16,5636.2,5723.5,5747.7,5539.7,224120.0,19345.5,0.1,5732.499999999997,19.223648108308154,-85.19924558003022,6843.394195470056,5811.7058045299445,6268.46118053228,20.831267559081102,187.39307866721788,8476170.0,-12.272946596728254,-0.014460822885519864,3.3248124386504716,3.3248124386504716,5989.55,6371.25,6669.8445759448705,6386.2,6565.3,0,860.0,2.7800722697230387,483312323.9128424
2018-11-17,5621.8,5636.2,5645.5,5561.4,156510.0,19345.5,0.1,5658.966666666666,18.97806182274445,-93.52474830318256,6878.653164874799,5690.016835125201,6206.874401433968,19.64138158981985,180.0150016195595,8319660.0,-11.969559362375117,-0.0025549128845675506,3.2020883279298356,3.2020883279298356,5964.650000000001,6371.25,6566.9850098692805,6386.2,6565.3,0,861.0,2.7803891107104772,484984866.1000297
2018-11-18,5658.3,5621.0,5727.9,5615.5,158680.0,19345.5,0.1,5638.7666666666655,21.708291169612608,-90.67730246335846,6903.5738304358465,5597.4261695641535,6154.629220345018,22.657411998016844,175.18535864673382,8478340.0,-12.65629341483745,0.006492582446903095,3.0960775965702387,3.0960775965702387,5959.6,6371.25,6472.354209079738,6386.2,6565.3,0,862.0,2.780707483357872,486669130.94548213
2018-11-19,4883.8,5660.4,5662.5,4831.1,478260.0,19345.5,0.1,5387.966666666666,12.264337635591914,-132.52559017802776,7060.537326751576,5296.272673248425,6033.597866026445,2.988883847549899,222.05783302910996,8000080.0,-24.395869777234232,-0.13687856776770413,4.546824870574347,4.546824870574347,5683.1,6094.75,6385.293872353359,6386.2,6565.3,1,863.0,2.780976379525036,488165411.3043961
2018-11-20,4524.6,4883.6,5013.4,4272.3,714080.0,19345.5,0.1,5022.233333333333,10.075165210330184,-173.38901298072187,7219.581768379611,4953.098231620389,5889.883783547737,10.865633074935408,259.13227352703063,7286000.0,-30.420741834286762,-0.07354928539252215,5.727186348561875,5.727186348561875,5403.700000000001,5815.35,6229.874485118023,6386.2,6565.3,1,864.0,2.7812193584074385,489564433.5528443
2018-11-21,4638.7,4523.0,4743.7,4393.0,412740.0,19345.5,0.1,4682.366666666666,15.250146983831712,-180.89292447119695,7283.781223269256,4712.718776730744,5770.723423209857,15.895878524945754,265.672825417957,7698740.0,-29.345193669748532,0.025217698802104005,5.727312079202298,5.727312079202298,5401.425,5815.35,5994.96554690386,6386.2,6565.3,0,865.0,2.7814700550599563,490997796.3718425
2018-11-22,4356.0,4646.4,4695.7,4346.7,261850.00000000003,19345.5,0.1,4506.433333333332,13.220170205201399,-192.0049305494502,7348.369409404804,4441.260590595195,5635.987859094633,3.7638276823455263,271.6247664595315,7436890.0,-32.71547729379055,-0.060943798909177116,6.235646612936903,6.235646612936903,5398.05,5815.35,5788.245681275396,6386.2,6565.3,0,866.0,2.7816993509588372,492350747.54932296
2018-11-23,4398.0,4360.9,4455.6,4223.7,348990.0,19345.5,0.1,4464.233333333333,15.029808600832126,-183.63669717764992,7368.011185254322,4222.798814745679,5518.084253466573,7.739099547109501,268.78728314099357,7785880.0,-31.409856519026825,0.009641873278236845,6.111579880422773,6.111579880422773,5230.05,5791.049999999999,5606.332199522349,6386.2,6565.3,0,867.0,2.7819312985115885,493717857.0475645
2018-11-24,3920.4,4397.3,4494.6,3821.5,382720.0,19345.5,0.1,4224.799999999998,11.97239745044648,-196.2384166756152,7404.625748657135,3930.404251342866,5365.9238483745185,3.7258890898131445,297.6667629166369,7403160.0,-39.002038244309254,-0.10859481582537511,7.592765098373556,7.592765098373556,4996.25,5589.95,5412.76369158922,3920.4,6565.3,0,868.0,2.782124621710353,494935283.45814985
2018-11-25,4062.2,3920.3,4198.4,3634.2,619950.0,19345.5,0.1,4126.866666666666,17.34826971535172,-181.34716540220006,7377.932196781747,3717.347803218254,5241.75967233885,15.061406904317838,316.7048512797342,8023110.0,-36.98205116271855,0.03616977859402093,7.79638745703644,7.79638745703644,4897.65,5496.299999999999,5158.161500934944,3920.4,6565.3,1,869.0,2.782329221837476,496200523.0383977
2018-11-26,3837.0,4061.0,4179.0,3679.8,571040.0,19345.5,0.1,3939.8666666666654,15.707615127539526,-173.0122324233871,7333.124699124457,3495.5753008755432,5107.973036878007,7.15950010590977,329.7402190454674,7452070.0,-40.37296037296037,-0.05543794003249469,8.593698698083593,8.593698698083593,4897.65,5496.299999999999,4883.848430766654,3920.4,6565.3,0,870.0,2.7825144312612444,497391517.55487245
2018-11-27,3866.5,3840.3,3920.6,3687.8,457270.0,19345.5,0.1,3921.899999999999,16.8173823355813,-152.57491484538252,7234.682839171084,3324.1371608289155,4989.737509556293,8.240218509453378,322.8159176850769,7909340.0,-39.86032476824488,0.00768829814959604,8.349047399070914,8.349047399070914,4881.3,5496.299999999999,4658.9117132286565,3920.4,6565.3,0,871.0,2.7827016915425675,498593487.8337659
2018-11-28,4265.4,3866.4,4391.8,3866.4,533040.0,19345.5,0.1,3989.633333333332,30.19960186425223,-101.70142091335231,7091.100427652793,3246.859572347208,4920.752984836647,28.124582275096902,337.286209279,8442380.0,-26.992331918389706,0.10316824001034508,7.907493066980822,7.907493066980822,4719.025,5496.299999999999,4474.463604847499,3920.4,6565.3,0,872.0,2.7829209583804926,499926663.76167345
2018-11-29,4296.5,4265.5,4440.1,4140.6,414460.0,19345.5,0.1,4142.799999999998,31.129868648236126,-57.658332547512714,6932.166760416771,3194.2432395832298,4861.300319614109,31.336645374970434,334.5871943305,8856840.0,-24.871915927888224,0.007291227083040308,7.787436153392295,7.787436153392295,4651.6,5496.299999999999,3634.2,3920.4,4296.5,0,873.0,2.7831421108663594,501270912.51120585
2018-11-30,4039.7,4296.8,4340.6,3954.5,444520.0,19345.5,0.1,4200.533333333332,27.83145689541479,-38.44691194365407,6753.1143750828405,3134.5556249171595,4783.052670127051,19.36762668959259,338.26668044974997,8412320.0,-28.325822362584724,-0.059769579890608715,8.373559433862662,8.373559433862662,4639.6,5496.299999999999,3650.3179999999998,3920.4,4296.5,0,874.0,2.7833423621034217,502534394.9797606
2018-12-01,4196.2,4038.7,4299.1,3967.1,316300.0,19345.5,0.1,4177.466666666665,32.52372366449694,-9.343125291908336,6529.3691368525315,3133.310863147469,4727.1619396387605,26.842432058079,337.81906041762494,8728620.0,-25.358426126863286,0.03874050053221767,8.050594833840735,8.050594833840735,4589.325,5496.299999999999,3666.1136399999996,3920.4,4296.5,0,875.0,2.7835546807901466,503849774.38355774
2018-12-02,4160.4,4196.2,4316.1,4105.3,298630.0,19345.5,0.1,4132.0999999999985,32.01099534749494,12.184494283985032,6269.14211877813,3166.0778812218696,4673.184612054117,25.942907853867762,328.7462703877946,8429990.0,-26.472615449870112,-0.008531528525809073,7.901794788669229,7.901794788669229,4589.325,5496.299999999999,3681.5933671999996,3920.4,4296.5,0,876.0,2.7837636576459874,505154967.13467216
2018-12-03,3897.8,4160.3,4177.0,3839.9,355100.0,19345.5,0.1,4084.799999999998,28.466042137573822,13.333388639620352,5966.424192725855,3215.6558072741445,4599.338458525153,19.112529002320215,329.34296536009504,8074890.0,-20.1891969368115,-0.06311893087203146,8.449457780288753,8.449457780288753,4571.45,5496.299999999999,3696.7634998559997,3920.4,4296.5,0,877.0,2.783950587121567,506373842.03581715
2018-12-04,3958.5,3899.9,4082.9,3809.3,326710.0,19345.5,0.1,4005.5666666666657,30.385117698891506,22.250927110604266,5770.827686656357,3222.862313343641,4538.3062243799,29.229382604776944,325.36132497723105,8401600.0,-12.511603235645147,0.01557288726974182,8.219308449595328,8.219308449595328,4562.55,5496.299999999999,3711.63022985888,3920.4,4296.5,0,878.0,2.784142135735387,507614389.5792925
2018-12-05,3771.6,3958.1,3974.1,3765.2,341600.0,19345.5,0.1,3875.9666666666653,27.902928401377082,19.718261182222818,5579.15134846963,3219.808651530371,4465.286583962767,12.943947244465388,317.0426589074289,8060000.0,-18.692737189298725,-0.04721485411140591,8.406052044422232,8.406052044422232,4559.5,5496.299999999999,3726.1996252617023,3920.4,4296.5,0,879.0,2.7843172265673304,508790668.54705983
2018-12-06,3508.6,3771.4,3887.2,3505.7,467540.0,19345.5,0.1,3746.233333333332,24.829185244195713,5.240129374285061,5388.178004527603,3198.0219954723984,4374.1735759663125,0.2932551319648184,321.64675469975543,7592460.0,-19.45362718089991,-0.06973167886308196,9.167381710646852,9.167381710646852,4481.849999999999,5171.2,4440.1,3920.4,4296.5,0,880.0,2.7844679874969867,509869988.95697933
2018-12-07,3422.2,3508.9,3626.6,3251.8,639330.0,19345.5,0.1,3567.4666666666653,23.897822629801055,-4.707965316090508,5157.500859007479,3208.73914099252,4283.509425874283,13.710975217251336,325.44341507834423,6953130.0,-22.187357889949983,-0.02462520663512513,9.509771932626505,9.509771932626505,4354.900000000001,4998.85,4421.412,3920.4,4296.5,0,881.0,2.784610073337953,510915915.3183165
2018-12-08,3430.4,3422.3,3507.7,3302.9,424400.0,19345.5,0.1,3453.7333333333318,24.18847665983391,-5.247343538035125,4831.901918552619,3311.5480814473813,4202.260909124351,15.029874610788513,316.8260282870339,7377530.0,-12.498724619936741,0.002396119455321255,9.235833380568852,9.235833380568852,4327.75,4994.05,4374.62752,3920.4,4296.5,0,882.0,2.7847525090849046,511965321.1167371
2018-12-09,3567.5,3430.3,3677.6,3424.2,327930.0,19345.5,0.1,3473.3666666666654,29.066448163114586,8.376811166428297,4698.367868465768,3313.4521315342317,4141.807489207747,26.567365143482267,312.2955976951029,7705460.0,-12.178130077298013,0.03996618470149249,8.75390603209819,8.75390603209819,4318.25,4947.450000000001,4329.7144192,3920.4,4296.5,0,883.0,2.7849074269079654,513068190.95805204
2018-12-10,3460.5,3566.9,3622.4,3412.7,394490.0,19345.5,0.1,3486.133333333332,27.575187650271843,14.567209028482694,4641.080887070541,3264.329112929459,4076.9210616641517,17.56290499032229,304.96734071688127,7310970.0,-9.812353401094605,-0.029992992291520637,8.812811464149148,8.812811464149148,4174.55,4947.450000000001,4286.597842431999,3920.4,4296.5,0,884.0,2.7850518553123993,514130035.86524075
2018-12-11,3407.7,3460.4,3485.9,3349.9,418530.0,19345.5,0.1,3478.5666666666657,26.843319903793613,19.199476995338273,4542.304763034706,3240.005236965293,4013.1857224580417,13.11958259698726,292.89824495138976,6892440.0,-11.866028708133976,-0.015257910706545363,8.5951886888925,8.5951886888925,4107.075,4947.450000000001,4245.205928734719,3920.4,4296.5,0,885.0,2.7851907761024566,515171192.4276025
2018-12-12,3466.1,3390.2,3510.2,3379.4,391170.0,19345.5,0.1,3444.766666666665,29.085211212519994,29.665072913391327,4486.187145319224,3207.132854680777,3961.0823203191803,18.034166456282055,281.3197988834333,7283610.0,-18.739156937215732,0.017137658831470004,8.116320904862333,8.116320904862333,4078.6000000000004,4932.25,4205.46969158533,3920.4,4296.5,0,886.0,2.7853348588908426,516235747.9592311
2018-12-13,3315.3,3466.2,3474.4,3284.8,435890.0,19345.5,0.1,3396.3666666666654,26.801249670051135,29.819993976858086,4419.379135744636,3165.6708642553635,3899.5792421935444,5.8321087435709025,274.76838467747376,6847720.0,-22.837193064121955,-0.0435071117394189,8.287889019921991,8.287889019921991,4051.4,4923.05,4167.322903921917,3920.4,4296.5,0,887.0,2.7854638534163008,517239728.9474283
2018-12-14,3247.8,3315.4,3336.6,3199.1,445560.0,19345.5,0.1,3343.0666666666657,25.82373618783474,28.752308172067444,4425.600978599378,3092.1890214006207,3837.505028651302,4.359892569382296,264.9635000576542,6402160.0,-19.602940812436557,-0.02036014840285949,8.15824558339966,8.15824558339966,3986.975,4896.7,4130.70198776504,3920.4,4296.5,0,888.0,2.7855856510838195,518215603.7042327
2018-12-15,3228.7,3247.8,3282.3,3177.0,332950.0,19345.5,0.1,3263.933333333332,25.539878399584197,29.99752852469578,4406.69240873015,3027.7475912698496,3779.523597351178,4.538670880519691,253.5589643392503,6069210.0,-23.05657499642534,-0.005880903996551612,7.853283499217961,7.853283499217961,3761.25,4885.65,4074.8058684991374,3228.7,4296.5,0,889.0,2.7857050897426037,519183372.1574987
2018-12-16,3247.9,3228.6,3305.0,3225.9,335690.0,19345.5,0.1,3241.4666666666653,26.41550828823567,35.00300322867463,4404.064251081666,2971.465748918334,3728.8927785558276,7.090000000000009,241.09760974358957,6404900.0,-21.932987212767994,0.0059466658407409945,7.423184511333155,7.423184511333155,3693.825,4885.65,4002.9813990192065,3228.7,4296.5,0,890.0,2.7858260634805894,520159247.2996941
2018-12-17,3526.1,3248.3,3597.4,3243.1,534780.0,19345.5,0.1,3334.233333333332,37.82470950471569,58.55193326074743,4385.42238868678,2956.0676113132195,3709.57918059813,38.53626228060491,249.1834947619046,6939680.0,-9.536148596644267,0.085655346531605,7.066830060460696,7.066830060460696,3681.825,4885.65,3936.90288709767,3228.7,4296.5,0,891.0,2.785973648190997,521248230.4192358
2018-12-18,3668.0,3526.0,3683.1,3456.9,698530.0,19345.5,0.1,3480.6666666666656,42.70448172860132,83.65726874291079,4301.536407606162,2980.2135923938376,3705.619258636403,61.59829381507967,247.54181656462566,7638210.0,-7.338638373121132,0.04024276112418823,6.748686383986523,6.748686383986523,3632.925,4885.65,3876.110656129856,3228.7,4296.5,0,892.0,2.786133761255894,522391950.08206725
2018-12-19,3687.1,3668.1,3924.7,3647.5,792400.0,19345.5,0.1,3627.0666666666657,43.34898492963263,100.39458488363243,4199.657351628873,3021.1526483711277,3703.8555197186506,68.22254915072891,249.66025823858098,8430610.0,-2.240428465372786,0.005207197382769868,6.7711821821643285,6.7711821821643285,3693.325,4885.65,3177.0,3228.7,4296.5,0,893.0,2.7862951265570772,523543345.19087696
2018-12-20,4076.0,3687.2,4140.3,3665.8,958580.0,19345.5,0.1,3810.3666666666654,54.55766192462276,134.38054336049828,4206.948558587997,3017.491441412003,3739.297851174017,93.3250285477006,265.7202397929681,9389190.0,16.171692412928238,0.10547584822760436,6.519142291289698,6.519142291289698,3733.6000000000004,4885.65,3191.954,3228.7,4076.0,1,894.0,2.7864889813750087,524834119.93102205
2018-12-21,3850.9,4075.2,4153.1,3786.9,748760.0,19345.5,0.1,3871.333333333332,48.56779369535678,137.9056905646829,4138.7351374638065,3051.174862536193,3749.926627252682,69.04005737117097,272.8973655220418,8640430.0,12.52702939629479,-0.055225711481844963,7.086586655640027,7.086586655640027,3736.8,4885.65,3229.8878400000003,3228.7,4076.0,0,895.0,2.786663690572983,526047084.43593526
2018-12-22,3964.4,3850.9,3977.2,3803.7,554590.0,19345.5,0.1,3963.766666666665,51.46149037061052,143.4481433500688,4093.746181500581,3076.5638184994195,3770.3526627524266,80.66796434791516,265.7975536990388,9195020.0,15.566697761194028,0.029473629541146185,6.704609870321835,6.704609870321835,3736.8,4885.65,3285.2805696000005,3228.7,4076.0,0,896.0,2.7868474686843454,527301168.4109013
2018-12-23,3944.4,3964.3,4037.1,3904.6,572210.0,19345.5,0.1,3919.899999999999,50.9178561611787,141.1178542036393,4102.174507470432,3072.795492529567,3786.9285996331478,78.61899395553733,256.27629986339315,8622810.0,10.56482130343378,-0.005044899606497788,6.4972188384391325,6.4972188384391325,3736.8,4885.65,3337.3497354240003,3228.7,4076.0,0,897.0,2.787029109788505,528549076.4249479
2018-12-24,4026.1,3944.5,4208.2,3941.9,716290.0,19345.5,0.1,3978.299999999999,53.09755573158956,140.14386081770078,4116.037151870371,3065.6928481296286,3809.706828239515,82.3409619860357,256.9922784445793,9339100.0,16.34445889322352,0.02071290944123305,6.383156862586109,6.383156862586109,3762.8,4885.65,3386.29475129856,3228.7,4076.0,0,898.0,2.787217003055373,529826454.8924674
2018-12-25,3762.5,4025.6,4030.7,3676.5,670940.0,19345.5,0.1,3910.9999999999986,45.99957286737841,117.7153701581293,4114.970432743603,3065.8495672563963,3805.2109398357516,56.77851047323507,263.93568712710936,8668160.0,10.41171464624234,-0.06547279004495665,7.0149019834447675,7.0149019834447675,3742.225,4885.65,3452.0471711946752,3228.7,4076.0,0,899.0,2.7873822048659065,531010019.8843188
2018-12-26,3793.7,3762.8,3841.9,3680.3,567110.0,19345.5,0.1,3860.766666666665,46.90429185689062,101.56050494531166,4135.021122902485,3074.3088770975146,3804.114659851394,59.804111714507364,256.6259951894587,9235270.0,9.451544964080664,0.00829235880398671,6.764530542464052,6.764530542464052,3789.55,4885.65,3512.539397499101,3228.7,4076.0,0,900.0,2.7875496564519455,532205749.1243005
2018-12-27,3586.9,3793.4,3822.6,3560.8,543440.0,19345.5,0.1,3714.366666666665,41.89414489473136,74.76461042834939,4136.742323605258,3089.057676394742,3783.4275493893565,39.7498060512025,256.99556696164024,8691830.0,8.192320453654267,-0.05451142683923338,7.16483779758678,7.16483779758678,3815.525,4885.65,4208.2,3228.7,4076.0,0,901.0,2.7876982739957783,533323364.71599966
2018-12-28,3861.6,3587.1,3900.3,3565.5,565240.0,19345.5,0.1,3747.3999999999983,49.596005367378396,73.2616114209533,4161.964060268881,3106.9559397311186,3790.8725446856083,66.38867339022498,262.55302646438025,9257070.0,18.898946979493804,0.07658423708494788,6.799073608462303,6.799073608462303,3788.55,4885.65,4195.2519999999995,3228.7,4076.0,0,902.0,2.787870631209333,534545171.3630276
2018-12-29,3706.8,3861.6,3899.6,3696.0,505410.0,19345.5,0.1,3718.4333333333325,45.90352049709698,60.113834364280535,4168.887202911408,3113.9627970885917,3782.865635667931,48.956530591469026,258.3420960026388,8751660.0,14.807817387803151,-0.040087010565568626,6.969410165173162,6.969410165173162,3788.55,4877.15,4182.562959999999,3228.7,4076.0,0,903.0,2.7880291218794473,535709989.5365895
2018-12-30,3815.0,3708.2,3837.7,3682.5,519169.99999999994,19345.5,0.1,3794.4666666666653,48.774306753707016,57.00359821789385,4184.9242462313605,3133.3757537686392,3785.9260513186046,59.25810796808622,250.97480343102174,9270830.0,17.46051294682718,0.02918959749649286,6.578631806841985,6.578631806841985,3788.55,4836.55,4170.1277008,3228.7,4076.0,0,904.0,2.7881965838790004,536915947.3381842
2018-12-31,3709.4,3815.1,3819.6,3658.8,545830.0,19345.5,0.1,3743.733333333332,46.1975572075239,46.57360271760996,4187.448329035943,3161.0216709640563,3778.637855954928,33.6084120857181,244.5337460430916,8725000.0,5.198377811179496,-0.027680209698558333,6.5922722284760775,6.5922722284760775,3788.55,4826.45,4157.941146784,3228.7,4076.0,0,905.0,2.7883543973952802,538082801.0207199
2019-01-01,3809.4,3709.5,3814.3,3664.4,469110.0,19345.5,0.1,3777.9333333333325,48.948072187374706,45.11724247992974,4198.548155867844,3184.2518441321563,3781.567583959221,38.39975285758419,237.77419275429935,9194110.0,3.854961832061071,0.02695853776891144,6.241775417501427,6.241775417501427,3788.55,4826.45,4145.99832384832,3228.7,4076.0,0,906.0,2.788520467006429,539287866.15531
2019-01-02,3873.8,3809.7,3894.8,3768.1,554470.0,19345.5,0.1,3797.5333333333324,50.69616027699789,46.98698763302458,4201.449195099307,3237.200804900693,3790.351623582152,48.34723509422307,229.840321843278,9748580.0,5.063600119334986,0.016905549430356492,5.933200522569002,5.933200522569002,3744.175,4826.45,4134.294357371354,3228.7,4076.0,0,907.0,2.7886915637358944,540517366.359848
2019-01-03,3780.1,3874.1,3875.8,3753.0,450320.0,19345.5,0.1,3821.0999999999985,48.11468922550263,40.64679057827718,4177.080187874146,3314.799812125854,3789.37527847909,33.873957367933244,222.19458456875813,9298260.0,-7.25956820412169,-0.024188135680726974,5.878008110070055,5.878008110070055,3711.575,4821.9,4122.824470223926,3228.7,4076.0,0,908.0,2.788854190583898,541712696.4999503
2019-01-04,3802.7,3780.5,3823.9,3720.0,488700.0,19345.5,0.1,3818.8666666666654,48.79199315611174,36.8224764512195,4134.812177715261,3414.4678222847397,3790.6442995763196,37.36484399134998,213.74497138527542,9786960.0,-1.2516554571658642,0.0059786778127561835,5.620873889217541,5.620873889217541,3711.575,4815.15,4111.583980819448,3228.7,4076.0,0,909.0,2.789018312747491,542917093.372516
2019-01-05,3785.4,3802.8,3846.7,3769.0,468450.0,19345.5,0.1,3789.3999999999983,48.27252191483978,32.14529520982855,4068.661186759521,3534.3688132404795,3790.144842473813,34.69261662032747,204.0274734291843,9318510.0,-4.515185147815559,-0.004549399111157815,5.389852417952774,5.389852417952774,3712.75,4527.75,4100.568301203059,3228.7,4076.0,0,910.0,2.789180489869128,544115561.0316428
2019-01-06,4004.1,3785.7,4034.1,3758.5,529890.0,19345.5,0.1,3864.0666666666657,54.82095454765233,42.16644198416445,4074.653233624282,3576.1767663757178,3810.5215241429737,68.4738955823293,209.13979675567114,9848400.0,1.5135381807118906,0.05777460770328102,5.223141199162637,5.223141199162637,3769.5249999999996,4462.35,4089.7729351789976,3228.7,4076.0,0,911.0,2.7893605656478355,545395028.0972407
2019-01-07,3985.9,4004.3,4028.0,3945.5,500880.0,19345.5,0.1,3925.133333333332,54.20596122965637,45.6603805226739,4088.9070185607093,3593.7129814392915,3827.2242361293575,89.81618423832668,200.0940969874089,9347520.0,-0.9984848861180751,-0.004545341025448901,5.020048094217339,5.020048094217339,3769.5249999999996,4452.45,4079.193476475418,3228.7,4076.0,0,912.0,2.7895386835848304,546668805.2824398
2019-01-08,3971.0,3985.8,4070.5,3943.1,514080.00000000006,19345.5,0.1,3986.9999999999986,53.675081576224684,44.98656240759756,4098.622350059908,3612.387649940092,3840.9171660217994,80.4787129684128,194.90166148830826,8833440.0,5.541528239202658,-0.003738177074186555,4.908125446696254,4.908125446696254,3778.625,4452.45,3560.8,3228.7,4076.0,0,913.0,2.789715110947196,547938014.9060804
2019-01-09,3978.0,3971.0,4014.2,3957.5,473420.0,19345.5,0.1,3978.299999999999,53.90349074040127,43.030871185975926,4079.269387039504,3621.9406129604968,3853.972674019723,81.85206984500687,185.0301142391434,9306860.0,4.858054142393974,0.00176278015613196,4.651335199576255,4.651335199576255,3780.0249999999996,4419.75,3570.994,3228.7,3978.0,0,914.0,2.789891647337126,549210555.4454291
2019-01-10,3603.7,3978.9,4007.7,3562.1,697310.0,19345.5,0.1,3850.899999999999,41.983327805152065,15.942496027285792,4090.9676184973405,3585.52238150266,3830.13718125594,8.18253343823759,203.6422489363474,8609550.0,0.4683710167554079,-0.09409250879839115,5.650921245840315,5.650921245840315,3766.675,4095.2,4070.5,3228.7,3978.0,0,915.0,2.7900354736157826,550341222.1722189
2019-01-11,3616.5,3603.3,3655.7,3563.1,551640.0,19345.5,0.1,3732.733333333332,42.45200125596609,-0.8110596443869014,4084.117031738029,3557.582968261971,3809.7907830410886,10.700236034618428,195.71065972660833,9161190.0,-6.347110006215038,0.0035519049865415653,5.411604029492834,5.411604029492834,3770.975,3960.35,4060.332,3228.7,3978.0,0,916.0,2.7901800228016547,551477312.5314314
2019-01-12,3597.2,3616.6,3633.9,3561.3,435060.0,19345.5,0.1,3605.799999999999,41.90234910508548,-12.25540004763262,4077.4516681219343,3529.528331878066,3789.5440417990803,7.050274941083985,186.91704117470772,8726130.0,-2.9567281752455044,-0.005336651458592634,5.196181507136321,5.196181507136321,3824.2250000000004,3936.35,4050.3673599999997,3228.7,3978.0,0,917.0,2.7903223929740664,552605958.543126
2019-01-13,3490.2,3597.3,3617.6,3473.2,452790.0,19345.5,0.1,3567.9666666666653,38.89557300662402,-25.340972523493917,4062.880586464715,3490.5094135352842,3761.035085437263,2.846140967687928,183.8801096622286,8273340.0,-8.513761467889914,-0.029745357500277958,5.268469132491794,5.268469132491794,3806.2749999999996,3835.8,4030.8046655999997,3490.2,3978.0,0,918.0,2.790454487758761,553691061.1314012
2019-01-14,3638.1,3490.4,3672.0,3490.4,539930.0,19345.5,0.1,3575.1666666666656,44.79255064448643,-22.44439042499848,4062.96235271829,3477.98764728171,3749.3269820622854,27.607567386572914,183.73153040064085,8813270.0,-1.9221437429233885,0.0423757950833763,5.050205612837494,5.050205612837494,3806.2749999999996,3835.8,3997.3483856639996,3490.2,3978.0,0,919.0,2.7905996856517663,554836630.110291
2019-01-15,3571.3,3637.5,3660.8,3545.7,544850.0,19345.5,0.1,3566.5333333333324,42.78422803647258,-23.33284420090142,4064.1180061214022,3454.5919938785987,3732.372031389687,16.423907584128635,178.8292782291665,8268420.0,-6.250328135664407,-0.0183612325114757,5.007400056818708,5.007400056818708,3806.2749999999996,3808.55,3965.89948252416,3490.2,3978.0,0,920.0,2.790738412300348,555955532.0666765
2019-01-16,3588.0,3570.6,3644.1,3561.4,487340.0,19345.5,0.1,3599.133333333332,43.4666563673457,-21.165155719055775,4064.048867513904,3454.7711324860975,3718.6223141144787,19.219822534739688,171.96290121279748,8755760.0,-7.377768599308176,0.004676168342060194,4.792722999241847,4.792722999241847,3806.2749999999996,3808.55,3936.33751357271,3490.2,3978.0,0,921.0,2.790878230669136,557081469.0645825
2019-01-17,3626.4,3588.1,3636.7,3554.8,525100.0,19345.5,0.1,3595.233333333332,45.08848204544689,-15.762487313523906,4053.756880027473,3441.543119972527,3709.8392365797667,25.648752720575963,165.52983684045475,9280860.0,-4.066029999206366,0.010702341137123872,4.564577455340137,4.564577455340137,3792.2,3808.55,3908.5492627583476,3490.2,3978.0,0,922.0,2.7910210863315266,558223208.4294927
2019-01-18,3605.6,3626.3,3627.9,3575.7,488160.0,19345.5,0.1,3606.6666666666656,44.34636178281695,-12.357492770099789,4054.5209276108317,3430.6590723891686,3699.9116902388364,22.16641553658129,157.43484849470798,8792700.0,-5.183159334157307,-0.005735715861460489,4.36639806120224,4.36639806120224,3790.575,3808.55,3882.428306992847,3490.2,3978.0,0,923.0,2.791161638745732,559356817.2658391
2019-01-19,3677.8,3605.8,3715.2,3604.1,537060.0,19345.5,0.1,3636.5999999999985,47.572103945275714,-4.419888981794841,4047.0233863739377,3424.4366136260614,3697.8058149779945,34.25414364640889,154.12521645937167,9329760.0,-2.842500132086435,0.020024406478810874,4.190690533997816,4.190690533997816,3683.0249999999996,3808.55,3857.874608573276,3490.2,3978.0,0,924.0,2.7913082129692013,560519759.780426
2019-01-20,3542.3,3676.2,3699.1,3503.9,563310.0,19345.5,0.1,3608.5666666666657,42.583652181215406,-7.30229079077067,4049.8168203337686,3404.9331796662314,3682.9957373610428,11.568725933366874,157.0591295694165,8766450.0,-11.533178492045646,-0.03684267768774807,4.433817846298069,4.433817846298069,3683.0249999999996,3758.8,3834.7941320588793,3490.2,3978.0,0,925.0,2.7914421437510537,561627901.9871475
2019-01-21,3536.7,3542.7,3561.4,3505.4,394170.0,19345.5,0.1,3585.5999999999985,42.38583338270202,-8.508804296282293,4044.1198504754097,3383.360149524589,3669.062809993324,10.631173614599026,149.8406203144582,8372280.0,-11.269725783386443,-0.0015808937695848124,4.236735383675692,4.236735383675692,3683.0249999999996,3746.55,3813.0984841353466,3490.2,3978.0,0,926.0,2.791575138270075,562733883.6710323
2019-01-22,3580.1,3536.9,3607.9,3465.2,447700.0,19345.5,0.1,3553.0333333333324,44.53623885542258,-5.455197235694698,4025.7602768171264,3372.349723182874,3660.5901614225318,20.928961748633895,149.33057600628263,8819980.0,-9.843868043314028,0.01227132637769679,4.171128627867452,4.171128627867452,3679.0249999999996,3746.55,3792.7045750872257,3490.2,3978.0,0,927.0,2.7917116763533874,563857998.4122134
2019-01-23,3561.5,3580.1,3608.3,3532.8,445870.0,19345.5,0.1,3559.433333333332,43.78202447302835,-3.8357659232120938,4017.865952112647,3358.384047887353,3651.1530031918146,17.75115207373275,144.0569634344053,8374110.0,-10.47008547008547,-0.005195385603754099,4.044839630335682,4.044839630335682,3679.0249999999996,3692.6,3766.5042090802476,3490.2,3978.0,0,928.0,2.791846097975386,564974627.8038336
2019-01-24,3574.3,3561.4,3587.0,3539.7,428600.0,19345.5,0.1,3571.9666666666653,44.478845851936825,-1.1875243201132548,4005.6018985870123,3347.8081014129884,3643.833669554499,43.64000000000014,137.14575176051923,8802710.0,-0.8158281765962659,0.00359399129580229,3.8369961044265795,3.8369961044265795,3679.0249999999996,3692.6,3742.399872353828,3490.2,3978.0,0,929.0,2.791981263229612,566096740.1885645
2019-01-25,3572.0,3574.3,3582.6,3542.2,448890.0,19345.5,0.1,3569.266666666665,44.372416383287984,1.0057903254191416,3993.979326220405,3338.090673779595,3636.9923676921658,42.72000000000007,130.23534092048214,8353820.0,-1.2304714502972487,-0.0006434826399575044,3.646006184783935,3.646006184783935,3679.0249999999996,3692.6,3720.2238825655218,3490.2,3978.0,0,930.0,2.7921157972857604,567218087.2138414
2019-01-26,3570.9,3572.0,3652.5,3556.1,432550.0,19345.5,0.1,3572.399999999999,44.317798345455735,2.8732771863294744,3935.276020108483,3353.473979891517,3630.697856483388,42.28000000000011,127.81853085473342,7921270.0,-0.7311242077171057,-0.000307950727883477,3.5794486223286404,3.5794486223286404,3679.0249999999996,3692.6,3699.82197196028,3490.2,3978.0,0,931.0,2.7922498100079163,568339157.5165448
2019-01-27,3555.6,3570.9,3583.2,3509.2,464020.0,19345.5,0.1,3566.1666666666656,43.515473652961646,3.52588515092377,3869.88258520256,3375.837414797439,3623.545679675446,36.16000000000004,123.97435007939532,7457250.0,1.8738181193054866,-0.004284634125850673,3.486735011795346,3.486735011795346,3679.0249999999996,3692.6,3681.0522142034574,3490.2,3978.0,0,932.0,2.792382008722783,569454018.8923985
2019-01-28,3442.8,3555.8,3561.2,3395.7,620850.0,19345.5,0.1,3523.099999999999,38.04668482017684,-2.8474386561593406,3797.6320916487275,3395.267908351272,3606.3318054206416,14.7417840375588,126.94046793086707,6836400.0,-5.368186690855109,-0.03172460344245687,3.68712873041905,3.68712873041905,3640.25,3692.6,3663.7840370671806,3490.2,3978.0,0,933.0,2.792503330524221,570521028.340075
2019-01-29,3414.8,3442.8,3450.1,3368.2,585460.0,19345.5,0.1,3471.0666666666657,36.810033495969726,-7.872152437013611,3689.885869996302,3446.694130003697,3588.0906810948663,13.42939481268022,123.72329165009087,6250940.0,-4.382157757679276,-0.008132915069129831,3.623148988230376,3.623148988230376,3614.85,3692.6,3636.975633360463,3490.2,3978.0,0,934.0,2.7926215961576166,571575863.9524633
2019-01-30,3460.0,3414.6,3479.0,3394.2,600250.0,19345.5,0.1,3439.199999999999,40.189682810897544,-7.098784561778032,3690.2314105446976,3431.9785894553015,3575.891568609641,26.4553314121038,120.94305653222726,6851190.0,-3.5674470457079153,0.01323649994143139,3.495464061625065,3.495464061625065,3614.85,3692.6,3604.7225573572073,3490.2,3978.0,0,935.0,2.792743720037346,572650303.9475803
2019-01-31,3437.2,3460.0,3484.7,3427.0,477070.0,19345.5,0.1,3437.333333333332,39.054982797855,-7.055254227610703,3689.2855927113887,3414.994407288612,3562.682847789675,19.88472622478386,116.42569535135387,6374120.0,-5.217295389366872,-0.006589595375722568,3.3872249316697856,3.3872249316697856,3614.85,3692.6,3576.3398504743423,3490.2,3978.0,0,936.0,2.7928632929866852,573714868.9900767
2019-02-01,3467.9,3437.7,3485.7,3415.3,481580.0,19345.5,0.1,3455.0333333333315,41.45197670459288,-4.04112849116882,3685.8710181323218,3405.4789818676786,3553.655909904944,28.731988472622557,113.1381456834,6855700.0,-3.8190592411803808,0.008931688583730946,3.262439680596326,3.262439680596326,3614.85,3692.6,3551.3630684174213,3490.2,3978.0,0,937.0,2.7929853411958074,574792739.5161523
2019-02-02,3502.5,3467.9,3514.5,3447.8,443600.0,19345.5,0.1,3469.1999999999985,44.11951873232231,0.9350028798671701,3685.612401645099,3406.967598354901,3548.7839184854256,40.58627984285287,109.82113527744285,7299300.0,-4.766436456577306,0.009977219643011681,3.135507074302437,3.135507074302437,3614.85,3692.6,3529.3835002073306,3490.2,3502.5,0,938.0,2.7931101970036765,575885524.4576712
2019-02-03,3459.1,3502.3,3507.8,3431.3,451660.0,19345.5,0.1,3476.4999999999986,41.56158411181082,1.900115504692451,3674.907894510887,3399.772105489113,3540.242592915385,31.973267674991217,107.44105418619692,6847640.0,-2.348756457668754,-0.012391149179157734,3.106040709612238,3.106040709612238,3600.7749999999996,3692.6,3514.5,3490.2,3502.5,0,939.0,2.7932306055705847,576959620.9513326
2019-02-04,3462.8,3459.0,3479.7,3437.1,503920.0,19345.5,0.1,3474.799999999999,41.871003963528665,3.3020877053952518,3672.228182203806,3391.601817796193,3532.8671078758243,33.27470981357732,102.80955031575427,7351560.0,-2.0895184776769202,0.0010696423925298237,2.968971650564695,2.968971650564695,3581.825,3692.6,3514.5,3490.2,3502.5,0,940.0,2.7933509543951898,578035321.9088591
2019-02-05,3468.4,3463.0,3485.9,3450.3,460950.0,19345.5,0.1,3463.433333333332,42.36837624796778,5.018108760900759,3666.3717227620996,3385.4982772379003,3526.7273833162217,35.24446007738312,98.00886815034323,7812510.0,-3.1200245803189803,0.0016171884024489547,2.8257660059492338,2.8257660059492338,3503.2,3717.05,3507.8,3490.2,3502.5,0,941.0,2.793471420562277,579113454.1435332
2019-02-06,3404.3,3468.5,3478.0,3383.9,514210.00000000006,19345.5,0.1,3445.1666666666656,38.32599826110334,2.3814844421234795,3656.8495775242245,3372.8104224757762,3515.0676325242007,12.697854379177045,97.72966328246157,7298300.0,-4.413870560157232,-0.018481144043362874,2.8707711800505704,2.8707711800505704,3491.5249999999996,3725.6499999999996,3491.0480000000002,3490.2,3502.5,0,942.0,2.79358544752024,580163411.4283499
2019-02-07,3397.7,3404.9,3421.8,3390.3,471360.0,19345.5,0.1,3423.466666666666,37.92477262415304,0.8190103158514148,3648.7727466228407,3360.097253377159,3503.8897627599913,10.376362996834324,92.99897304800004,6826940.0,-4.940827574630007,-0.0019387245542403786,2.7371154913029416,2.7371154913029416,3495.45,3788.2,3485.9,3397.7,3502.5,0,943.0,2.793698448001839,581210347.2300903
2019-02-08,3661.7,3397.3,3721.1,3382.5,699230.0,19345.5,0.1,3487.899999999999,57.21787983092652,17.278893334941415,3644.222191817894,3363.0378081821063,3518.9193091638012,83.16803627089826,110.54190354457147,7526170.0,2.511198208286669,0.07769962033140065,3.0188683820239635,3.0188683820239635,3548.225,3788.2,3368.2,3397.7,3502.5,0,944.0,2.7938352391005927,582370544.0753311
2019-02-09,3661.4,3661.6,3675.3,3633.2,454800.0,19345.5,0.1,3573.5999999999985,57.196125162036715,27.265595755058037,3665.480853377052,3353.689146622948,3532.4888987672484,83.08302635307459,105.65319614853068,7071370.0,2.534375087512952,-8.19291585875126e-05,2.8855955685948182,2.8855955685948182,3548.225,3788.2,3375.258,3397.7,3502.5,0,945.0,2.793971583209204,583530841.9838119
2019-02-10,3679.0,3661.0,3680.6,3617.1,501900.0,19345.5,0.1,3667.3666666666654,58.200211136999485,33.75170691332734,3689.0202483753983,3344.3797516246013,3546.4423369798915,88.07027486540099,102.64225356649277,7573270.0,3.470581617729781,0.0048069044627738755,2.789949811538265,2.789949811538265,3548.225,3788.2,3382.1748399999997,3397.7,3502.5,0,946.0,2.794109056557668,584698650.0451496
2019-02-11,3631.8,3678.8,3681.1,3623.8,517280.0,19345.5,0.1,3657.399999999999,54.50739841198295,33.49139103897834,3696.804658348474,3341.765341651526,3554.5716382199016,74.69538112779833,99.40352116888612,7055990.0,5.4897176716626,-0.012829573253601456,2.7370318070622313,2.7370318070622313,3548.225,3788.2,3388.9533432,3397.7,3502.5,0,947.0,2.794241939204164,585847031.5230418
2019-02-12,3632.0,3631.8,3656.4,3594.4,545820.0,19345.5,0.1,3647.599999999999,54.520566431178466,31.964815199047457,3706.2440197459537,3339.375980254046,3561.9457679132443,73.68576491435324,96.73184108539424,7601810.0,6.3605482019444715,5.506911173513984e-05,2.6633216157872863,2.6633216157872863,3548.225,3788.2,3395.596276336,3397.7,3502.5,0,948.0,2.794374423520355,586995668.8930817
2019-02-13,3611.5,3632.0,3663.5,3599.2,558020.0,19345.5,0.1,3625.099999999999,52.83250054890761,28.33071785161679,3710.8879916124074,3338.452008387592,3566.665218588173,67.6314235085647,94.41528100786608,7043790.0,4.378612716763006,-0.005644273127753285,2.614295473013044,2.614295473013044,3548.225,3788.2,3402.10635080928,3397.7,3502.5,0,949.0,2.7945046655902637,588135824.884799
2019-02-14,3592.6,3611.5,3624.5,3580.2,498140.0,19345.5,0.1,3612.0333333333315,51.25680189120095,23.603709066183917,3713.1773799693146,3338.222620030685,3569.135197770252,62.04961606615475,90.8356180787328,6545650.0,4.521121843360878,-0.005233282569569453,2.528408898255659,2.528408898255659,3548.225,3719.35,3408.4862237930943,3397.7,3502.5,0,950.0,2.794632801694075,589268086.652068
2019-02-15,3604.7,3592.6,3648.3,3581.4,516210.00000000006,19345.5,0.1,3602.933333333332,52.23889932243465,20.364032127015168,3717.0632337473025,3337.716766252698,3572.522321792133,65.62315416420552,89.12593107310902,7061860.0,3.9447504253294423,0.003368034292712707,2.4724923314869205,2.4724923314869205,3548.225,3719.35,3414.7384993172323,3397.7,3502.5,0,951.0,2.7947616113353084,590405609.8171786
2019-02-16,3616.8,3604.7,3641.9,3599.7,485630.0,19345.5,0.1,3604.6999999999985,53.253223795531824,18.180001444704036,3723.784295975025,3337.1157040249745,3576.739243526216,69.19669226225642,85.77407885360125,7547490.0,3.2633832976445447,0.0033567287152884706,2.3715460864189684,2.3715460864189684,3548.225,3719.35,3420.8657293308875,3397.7,3502.5,0,952.0,2.794891090094561,591548395.8413211
2019-02-17,3664.2,3616.8,3689.9,3607.9,580510.0,19345.5,0.1,3628.5666666666657,57.09707960086308,18.98344751426635,3738.8250389629166,3344.2149610370825,3585.068839380862,83.19551092734787,85.50450179262974,8128000.0,5.929287965077619,0.013105507631054891,2.3335107743198993,2.3335107743198993,3589.85,3719.35,3426.8704147442695,3397.7,3502.5,0,953.0,2.795024353736839,592711335.2688726
2019-02-18,3896.0,3664.2,3903.7,3655.1,933150.0,19345.5,0.1,3725.6666666666656,70.06175261200997,33.34197825539759,3807.516699159424,3323.6433008405766,3614.6813308683986,98.52264006139681,97.15418023601332,9061150.0,12.5101074275153,0.06326073904262874,2.4936904578032166,2.4936904578032166,3688.95,3719.35,3432.755006449384,3397.7,3502.5,0,954.0,2.7951769667146564,593968968.8169329
2019-02-19,3914.3,3896.4,3993.8,3863.7,1440000.0,19345.5,0.1,3824.833333333332,70.81165800981357,41.7428112173389,3868.582677039425,3308.007322960576,3643.2164422142655,86.99492884017667,99.5074530762981,10501150.0,12.856071964017993,0.004697125256673651,2.5421519320516595,2.5421519320516595,3734.0,3719.35,3451.5928061914087,3397.7,3502.5,1,955.0,2.7953306555320996,595234315.8590353
2019-02-20,3972.4,3914.3,3983.6,3881.2,698010.0,19345.5,0.1,3927.5666666666657,73.1142255784902,48.41389179496186,3932.2902154161884,3297.8197845838104,3674.5672572414783,96.4992638638966,99.71406357084824,11199160.0,16.68771847369503,0.014843011521855631,2.5101717745153618,2.5101717745153618,3734.0,3719.35,3484.125237819924,3397.7,3502.5,0,956.0,2.7954886543188704,596522948.9293996
2019-02-21,3936.6,3972.0,4011.5,3909.2,668160.0,19345.5,0.1,3941.0999999999985,69.4772757020119,47.54826433664686,3977.294816376856,3299.6851836231444,3699.5227565518135,88.09220985691573,99.89877331578766,10531000.0,15.860729316890843,-0.00901218407008364,2.5376917470860048,2.5376917470860048,3742.85,3719.35,3514.7057235507286,3397.7,3502.5,0,957.0,2.7956433005823436,597798124.3634279
2019-02-22,3965.2,3937.4,3983.1,3931.7,649550.0,19345.5,0.1,3958.0666666666657,70.72991796667503,46.00563735086006,4022.5917844832184,3300.6582155167816,3724.8253511659263,89.26501275214464,96.43457522180283,11180550.0,8.288499877106263,0.0072651526698166435,2.4320229804752054,2.4320229804752054,3742.85,3719.35,3554.4492656666703,3397.7,3502.5,0,958.0,2.7957998413935954,599085054.5585862
2019-02-23,4120.4,3965.2,4152.6,3939.4,727850.0,19345.5,0.1,4007.399999999999,76.39197027788055,52.09400731838977,4094.459267953594,3294.920732046405,3762.4991272453617,94.37456324248765,104.77496270595978,11908400.0,12.536188343256665,0.03914052254615141,2.5428347419172845,2.5428347419172845,3813.7,3760.4,3591.0133244133367,3397.7,4120.4,0,959.0,2.7959682968015676,600432252.213408
2019-02-24,3755.2,4120.5,4194.2,3738.7,977780.0,19345.5,0.1,3946.933333333332,51.262883563354315,29.316730894102577,4095.235106206052,3323.384893793949,3761.8039722696126,28.501628664495115,129.82675108410552,10930620.0,2.0712150040771897,-0.08863217163382198,3.4572526385839777,3.4572526385839777,3842.6499999999996,3781.2,3647.171991972003,3397.7,4120.4,0,960.0,2.7961064580349433,601635576.6811584
2019-02-25,3833.7,3755.7,3870.7,3753.8,765870.0,19345.5,0.1,3903.0999999999985,54.71146759040944,17.89012767577526,4100.523784017527,3354.6262159824732,3768.65121300584,41.28664495114006,128.90341172095512,11696490.0,5.5592268296712275,0.02090434597358337,3.362376078486974,3.362376078486974,3844.7,3781.2,3712.8153529353626,3397.7,4120.4,0,961.0,2.796250852036071,602871456.1763849
2019-02-26,3810.3,3833.5,3845.5,3775.0,2089999.9999999998,19345.5,0.1,3799.733333333332,53.49630154920742,7.6331127833386745,4091.2549287962984,3404.4950712037016,3772.617764148141,37.47557003257335,124.73173945517262,9606490.0,4.909140969163,-0.006103763987792332,3.2735411766835316,3.2735411766835316,3856.5,3781.2,3738.7,3397.7,4120.4,1,962.0,2.7963928541545418,604098121.671495
2019-02-27,3814.6,3810.3,3836.4,3701.9,2820000.0,19345.5,0.1,3819.5333333333324,53.69980760491553,0.39721474415091507,4072.920030243506,3464.5199697564935,3776.6160723245084,38.175895765472326,125.42947235123172,12426490.0,5.623702062854767,0.0011285200640369641,3.2881421997386813,3.2881421997386813,3868.2,3781.2,4194.2,3397.7,4120.4,1,963.0,2.7965347969328764,605326877.3765864
2019-02-28,3816.6,3814.6,3883.7,3783.3,2310000.0,19345.5,0.1,3813.833333333332,53.801074604013195,-4.713474007742846,4077.2399342949807,3475.6900657050196,3780.4240654364603,38.38120104438641,123.64165289757229,14736490.0,6.2350386906418755,0.0005243013684266273,3.2395758763709135,3.2395758763709135,3868.2,3781.2,4184.354,3397.7,4120.4,1,964.0,2.796676486620936,606556779.3710557
2019-03-01,3821.9,3816.7,3855.8,3816.4,1740000.0,19345.5,0.1,3817.699999999999,54.08765414672742,-8.002870749818769,4081.092150363327,3487.8878496366733,3784.374154442512,37.37594617325488,117.62439197631713,16476490.0,6.02546675174079,0.001388670544463677,3.0776418005786943,3.0776418005786943,3868.2,3781.2,4174.70492,3397.7,4120.4,0,965.0,2.7968182008813733,607789183.7638295
2019-03-02,3823.1,3821.9,3843.2,3783.6,1610000.0,19345.5,0.1,3820.5333333333315,54.15699297020406,-10.221693592140355,4084.675726158138,3498.7142738418634,3788.0623302098916,36.704758655978154,113.47979254943732,18086490.0,5.703937182039364,0.0003139799576126201,2.968266395057344,2.968266395057344,3868.2,3781.2,4165.2488216,3397.7,4120.4,0,966.0,2.796959595105097,609022405.1749079
2019-03-03,3809.5,3823.2,3836.6,3789.7,1510000.0,19345.5,0.1,3818.1666666666656,53.17680011801954,-12.574391211902011,4084.255967258683,3516.9040327413177,3790.1040130470446,28.640326470042684,108.72409308162037,16576490.0,3.965394902025004,-0.0035573225916141205,2.854025281050541,2.854025281050541,3868.2,3781.2,4155.981845168,3397.7,4120.4,0,967.0,2.797099425570672,610250324.3337458
2019-03-04,3715.9,3809.7,3828.4,3681.8,2850000.0,19345.5,0.1,3782.833333333332,46.887073884657134,-19.964420176005014,4080.7314449331616,3528.8185550668386,3783.0369641854213,6.654957064793117,111.42951500436176,13726490.0,-4.622689938398355,-0.024570153563459707,2.998722113199003,2.998722113199003,3863.175,3781.2,4146.90020826464,3715.9,4120.4,1,968.0,2.797230857705845,611439232.7997289
2019-03-05,3857.2,3715.9,3873.2,3705.7,3820000.0,19345.5,0.1,3794.199999999999,55.45307736626958,-15.088081124936643,4079.027375068249,3555.092624931751,3790.100110453476,34.23106947697107,115.43454964690736,17546490.0,-1.4587538001686218,0.03802578110282839,2.992703247093938,2.992703247093938,3785.55,3781.2,4128.296199934055,3715.9,4120.4,1,969.0,2.7973738469435454,612687377.9161209
2019-03-06,3863.0,3857.2,3887.3,3816.7,2520000.0,19345.5,0.1,3812.0333333333324,55.76841877140095,-11.39195065022718,4071.9125141793957,3589.2474858206033,3797.0429570769547,35.362997658079614,112.23208181498543,20066490.0,-2.754002618064648,0.0015036814269417942,2.905308874320099,2.905308874320099,3835.875,3781.2,4110.4363519366925,3715.9,4120.4,0,970.0,2.797516896665577,613938252.9954032
2019-03-07,3875.1,3863.1,3907.4,3847.9,2600000.0,19345.5,0.1,3865.0999999999985,56.46086357686747,-8.201293471851862,4062.508498003507,3625.6915019964927,3804.476961164864,37.72443403590942,108.46550454248647,22666490.0,-1.5622618503276942,0.0031322806109241874,2.7990375614174208,2.7990375614174208,3840.9,3781.2,4093.290897859225,3715.9,4120.4,0,971.0,2.7976605275647577,615194445.2623177
2019-03-08,3865.9,3875.1,3929.0,3810.7,2960000.0,19345.5,0.1,3867.9999999999986,55.74627561687892,-6.835340517118333,4048.50226854047,3664.6077314595286,3810.326774387258,35.92896174863389,109.16796850373746,19706490.0,-2.504287299505693,-0.002374132280457242,2.8238694354157494,2.8238694354157494,3846.3,3781.2,4076.831261944856,3715.9,4120.4,0,972.0,2.797802975615787,616447215.7777455
2019-03-09,3944.3,3865.6,3964.0,3859.7,2480000.0,19345.5,0.1,3895.0999999999985,60.35147209636968,-1.0786758562724827,4044.3384267397632,3696.7815732602367,3823.086129207519,51.22950819672135,108.82025646775621,22186490.0,-4.273856907096386,0.02027988308026596,2.7589244344435313,2.7589244344435313,3855.05,3781.2,4061.0300114670617,3715.9,4120.4,0,973.0,2.797951433403041,617732331.2147135
2019-03-10,3915.2,3944.4,3944.5,3889.2,1890000.0,19345.5,0.1,3908.4666666666653,57.941299318726415,0.27028762585626254,4046.060431992553,3696.9795680074462,3831.858878806803,82.70729978738476,104.99738100577363,20296490.0,4.26075841499787,-0.007377734959308491,2.6817884400739076,2.6817884400739076,3855.05,3781.2,4045.860811008379,3715.9,4120.4,0,974.0,2.798097094862077,619006062.6132451
2019-03-11,3870.3,3915.2,3935.5,3842.4,3190000.0,19345.5,0.1,3909.9333333333325,54.33565213585662,-2.2230606227549856,4042.7537752577255,3695.886224742274,3835.51993796806,66.79659815733527,104.1475680767898,17106490.0,0.9546912903983193,-0.011468124233755539,2.690943029656352,2.690943029656352,3855.05,3781.2,4031.298378568044,3715.9,4120.4,0,975.0,2.798238642042725,620261739.751441
2019-03-12,3886.0,3870.3,3900.1,3817.1,2900000.0,19345.5,0.1,3890.4999999999986,55.38121637207867,-3.1215727588027704,4032.138182352649,3697.861817647351,3840.3275629234827,72.36002834868886,102.63702749987624,20006490.0,1.986720205758072,0.004056533085290415,2.641199884196506,2.641199884196506,3855.3500000000004,3781.2,4017.318443425322,3715.9,4120.4,0,976.0,2.7983810659378636,621524236.4599152
2019-03-13,3865.1,3885.9,3894.7,3847.4,2280000.0,19345.5,0.1,3873.7999999999993,53.62110347952508,-5.30198282569323,4025.3113615440516,3697.538638455949,3842.6868426450555,64.95393338058109,98.68438267845649,17726490.0,1.3238609552770932,-0.005378281008749375,2.553216803665015,2.553216803665015,3865.8999999999996,3781.2,4003.897705688309,3715.9,4120.4,0,977.0,2.798521345791023,622778423.99205
2019-03-14,3879.0,3865.1,3914.7,3828.4,2860000.0,19345.5,0.1,3876.6999999999985,54.65333376212225,-5.93862199028689,4014.2530319978196,3699.976968002181,3846.145238583622,69.87951807228913,97.79978391570957,20586490.0,1.6349630561232535,0.0035962847015600374,2.521262797517648,2.521262797517648,3894.2,3781.2,3991.013797460777,3715.9,4120.4,0,978.0,2.7986623565580957,624038698.8159636
2019-03-15,3924.3,3879.0,3935.7,3874.8,3110000.0,19345.5,0.1,3889.4666666666653,57.938862590601516,-3.5568718194784736,3953.8312448300717,3740.788755169929,3853.5885491947056,85.93196314670452,95.16408506458743,23696490.0,2.679295638295091,0.011678267594740888,2.4249951600180264,2.4249951600180264,3906.0,3781.2,3978.6452455623457,3715.9,4120.4,0,979.0,2.798806661166884,625318004.1720232
2019-03-16,4006.4,3924.4,4050.6,3923.7,3460000.0,19345.5,0.1,3936.5666666666657,63.14994242847738,2.9484878900789298,3978.532700121595,3741.2072998784047,3868.142020699972,88.01518438177878,97.43093613140262,27156490.0,4.794538463550527,0.020920928573248787,2.4318823914587315,2.4318823914587315,3934.325,3781.2,3681.8,3715.9,4120.4,0,980.0,2.798957161564091,626631104.4129833
2019-03-17,3981.5,4006.4,4009.8,3956.3,1870000.0,19345.5,0.1,3970.733333333332,60.69391756987223,4.862214236550429,3996.4272775905233,3738.092722409476,3878.938018728546,81.26355748373103,94.29301212201672,25286490.0,4.515028218926368,-0.006215055910543166,2.368278591536273,2.368278591536273,3935.925,3781.2,3689.1760000000004,3715.9,4120.4,0,981.0,2.799105244392107,627934610.5251477
2019-03-18,3990.2,3981.5,4032.3,3958.5,2620000.0,19345.5,0.1,3992.699999999999,61.260828353571455,5.930864582899588,4013.1290512301257,3739.3809487698736,3889.534397897256,82.48767758770656,92.82922554187269,27906490.0,7.381791759735185,0.0021851061157853735,2.326430393009691,2.326430393009691,3935.925,3781.2,3696.40448,3715.9,4120.4,0,982.0,2.79925360071919,629242098.3589613
2019-03-19,4017.0,3990.2,4029.9,3972.4,2990000.0,19345.5,0.1,3996.233333333332,63.02974600894269,7.555399322222328,4033.0938178119864,3739.6561821880136,3901.673979049898,85.994164235098,90.30570943173893,30896490.0,4.142901586643165,0.006716455315523007,2.2480883602623583,2.2480883602623583,3935.925,3781.2,3703.4883904000003,3715.9,4120.4,0,983.0,2.7994036704338567,630560900.159309
2019-03-20,4041.2,4017.0,4050.0,3985.3,3180000.0,19345.5,0.1,4016.133333333332,64.60157911120102,9.260044625057603,4055.219738841729,3739.99026115827,3914.9621715213366,96.08170070862856,88.47673018661472,34076490.0,4.612995081542837,0.00602439631565832,2.189367766668681,2.189367766668681,3935.925,3781.2,3710.4306225920004,3715.9,4041.2,0,984.0,2.7995552319706234,631889948.162315
2019-03-21,3982.2,4041.2,4064.0,3923.8,3880000.0,19345.5,0.1,4013.4666666666653,58.11435707125609,5.594806209091608,4063.3237044591738,3747.916295540827,3921.36577423359,67.70627714172913,92.17124945899937,30196490.0,2.7637996438801555,-0.014599623874096856,2.314581122469976,2.314581122469976,3942.1,3781.2,3717.2340101401605,3715.9,4041.2,0,985.0,2.799701675199708,633195555.479307
2019-03-22,3990.4,3982.2,4005.7,3971.8,2830000.0,19345.5,0.1,4004.5999999999985,58.734580851707,3.0317618778827296,4071.0397200823522,3756.930279917647,3927.9404624018193,70.19036046982589,88.0090173547851,33026490.0,3.2204661269044728,0.0020591632765809553,2.2055186786985037,2.2055186786985037,3909.55,3788.35,3731.104649734554,3715.9,4041.2,0,986.0,2.799848353353865,634504943.8406848
2019-03-23,4002.5,3990.4,4018.2,3980.8,2000000.0,19345.5,0.1,3991.699999999999,59.68327169964017,1.535889355331939,4077.509146951805,3769.7608530481943,3935.041370744503,75.09113001215067,84.394087543729,35026490.0,1.4755469918616693,0.003032277465918165,2.1085343546215864,2.1085343546215864,3921.15,3788.35,3744.420463745172,3715.9,4041.2,0,987.0,2.79999557567881,635819710.9128175
2019-03-24,3994.7,4002.6,4005.7,3967.0,2040000.0,19345.5,0.1,3995.866666666665,58.745691586868595,-0.48615655515288125,4061.1842209349506,3813.965779065049,3940.7231449593123,71.93195625759411,81.13022414774834,32986490.0,2.030547609317532,-0.0019487820112430443,2.0309466079492413,2.0309466079492413,3933.375,3788.35,3757.2036451953654,3715.9,4041.2,0,988.0,2.8001417548081085,637131725.5433301
2019-03-25,3937.0,3994.8,4000.5,3897.9,2860000.0,19345.5,0.1,3978.0666666666657,52.211553958891216,-5.915392138994953,4059.563292784876,3823.566707215124,3940.368559725092,48.562170919400586,82.6637795657663,30126490.0,1.723380616489673,-0.014444138483490576,2.099664200298865,2.099664200298865,3926.925,3788.35,3769.475499387551,3937.0,4041.2,0,989.0,2.800282877822184,638420303.2103306
2019-03-26,3942.8,3937.1,3950.7,3899.9,2530000.0,19345.5,0.1,3958.1666666666656,52.780111051954826,-9.129674673505505,4057.919273237294,3833.1907267627066,3940.6001254655594,48.5568760611206,80.38779531106869,32656490.0,1.4616572310859544,0.0014732029464059604,2.0388504441277435,2.0388504441277435,3926.925,3788.35,3781.256479412049,3937.0,4041.2,0,990.0,2.800424054502168,639711642.7576923
2019-03-27,4041.7,3942.8,4043.3,3936.2,2780000.0,19345.5,0.1,3973.833333333332,61.24676991485485,-4.824936668908677,4068.794377772856,3838.9756222271435,3950.22868494503,90.53480475381994,82.29580993170667,35436490.0,4.569092649608029,0.025083696865171756,2.0361681948612387,2.0361681948612387,3926.925,3788.35,3792.566220235567,3937.0,4041.2,0,991.0,2.800572704837127,641044101.6551623
2019-03-28,4025.6,4041.7,4041.7,4008.4,2110000.0,19345.5,0.1,4003.3666666666654,59.38020515691067,-3.361118069855287,4073.3574898818015,3850.382510118199,3957.4069054264555,79.70401691331917,78.79610922229904,33326490.0,3.7793245681876746,-0.003983472301259394,1.9573755271835014,1.9573755271835014,3926.925,3788.35,3803.4235714261445,3937.0,4041.2,0,992.0,2.800719662622445,642370450.7076032
2019-03-29,4102.2,4025.7,4123.1,4022.6,3300000.0,19345.5,0.1,4056.4999999999986,64.86638769955576,2.168889597613145,4096.480812352463,3843.049187647538,3971.196723957269,90.71936056838342,80.346387134992,36626490.0,4.533292561730745,0.019028219395866408,1.9586170136753938,1.9586170136753938,3956.4750000000004,3788.35,3813.846628569099,3937.0,4041.2,0,993.0,2.800872198562395,643728379.4667186
2019-03-30,4111.8,4103.7,4138.1,4057.1,2550000.0,19345.5,0.1,4079.866666666665,65.49536804455406,5.676886844260707,4117.832845397504,3841.357154602497,3984.5875121518147,89.05079100749369,80.39307376820689,39176490.0,2.6307907348242834,0.0023402076934329052,1.9551795750816403,1.9551795750816403,3969.95,3788.35,3832.401830854953,3937.0,4041.2,0,994.0,2.8010250528446465,645090717.751604
2019-03-31,4102.3,4111.8,4121.9,4082.2,2430000.0,19345.5,0.1,4105.433333333332,64.26918829243053,6.501775967277169,4129.7362786866925,3852.6537213133083,3995.798225280213,85.09575353871767,77.4864256419064,36746490.0,3.0340323998493077,-0.0023104236587382365,1.8888532199475023,1.8888532199475023,3996.2,3788.35,3856.8576843865567,3937.0,4041.2,0,995.0,2.8011767461602264,646449769.7304767
2019-04-01,4145.1,4102.3,4159.1,4076.8,3220000.0,19345.5,0.1,4119.733333333333,67.2445010204562,8.924547803011805,4149.224153453133,3859.0758465468666,4010.017441920193,94.64012251148546,77.83025238177024,39966490.0,3.8820109267706018,0.01043317163542401,1.877644746369695,1.877644746369695,4006.7,3887.2,3879.3570696356323,3937.0,4041.2,0,996.0,2.8013313151623884,647826590.9812512
2019-04-02,4859.3,4145.1,4899.6,4143.5,14770000.0,19345.5,0.1,4368.899999999999,86.87895671371805,55.04867450136133,4445.7164757665,3662.0035242335,4090.9014950706505,95.97683937306577,126.2780914973581,54736490.0,20.968384366442624,0.17229982388844656,2.598688936623754,2.598688936623754,4376.95,4239.9,3907.331362672069,3937.0,4041.2,1,997.0,2.80153598052707,649468576.229097
2019-04-03,4968.7,4859.3,5278.4,4814.0,13830000.0,19345.5,0.1,4657.699999999999,88.05964200793996,87.42367071231672,4658.752374496507,3557.937625503491,4174.50135268297,77.56609923940601,150.42965639040395,68566490.0,22.95110363258438,0.022513530755458477,3.0275455630326635,3.0275455630326635,4568.45,4429.299999999999,4026.403599151421,3937.0,4041.2,1,998.0,2.801747245654308,651149285.7726495
2019-04-04,4902.4,4968.7,5042.5,4789.2,1050000.0,19345.5,0.1,4910.133333333332,83.17492834430547,98.07180773786484,4799.676367765317,3514.823632234683,4243.82503337983,72.76349148859109,157.77753807680367,67516490.0,23.10782984280046,-0.01334353050093584,3.2183734105092134,3.2183734105092134,4577.525,4429.299999999999,4143.5,3937.0,4041.2,0,999.0,2.801953764193857,652809258.1205382
2019-04-05,5010.2,4902.5,5029.4,4888.3,851720.0,19345.5,0.1,4960.433333333332,84.66446452344833,105.43090719005099,4944.7249446449705,3470.1550553550305,4316.813125438894,80.57225642883014,156.58628535703195,68368210.0,25.55633520449077,0.021989229765013052,3.125349993154604,3.125349993154604,4595.575,4429.299999999999,4302.386,3937.0,4041.2,0,1000.0,2.8021667138419972,654507316.2958224
2019-04-06,5046.2,5010.0,5198.4,4947.9,952180.0,19345.5,0.1,4986.2666666666655,85.13766967775531,105.52031883080588,5074.76781995368,3446.58218004632,4386.278542063761,83.18000724375227,163.2944078315297,69320390.0,26.076202373516548,0.00718534190251896,3.235987630920885,3.235987630920885,4599.125,4429.299999999999,4439.02796,3937.0,4041.2,0,1001.0,2.8023814550109623,656219180.5893075
2019-04-07,5173.6,5046.1,5219.5,5033.7,841270.0,19345.5,0.1,5076.666666666665,86.70154884555178,106.64097620441379,5214.7180803304645,3424.9719196695355,4461.261538057689,92.40854762767118,164.9019501292776,70161660.0,29.511602873807814,0.02524672030438757,3.1873733982000463,3.1873733982000463,4610.575,4429.9,4556.540045600001,3937.0,4041.2,0,1002.0,2.802603625368073,657974858.9695195
2019-04-08,5245.2,5173.5,5300.6,5060.5,928230.0,19345.5,0.1,5154.999999999999,87.49776713016595,104.54516971645256,5350.082349892711,3412.4276501072895,4535.922343956957,96.04483472549435,170.27323940575778,71089890.0,33.22834645669291,0.013839492809648801,3.2462678144924464,3.2462678144924464,4626.6,4450.15,4657.600439216,3937.0,4041.2,0,1003.0,2.8028296663642336,659755744.192351
2019-04-09,5158.4,5245.0,5245.9,5095.2,784620.0,19345.5,0.1,5192.399999999999,81.15420093135396,90.1962140947594,5448.949208306939,3425.2807916930606,4595.205930246771,89.57783641160945,168.87515087677505,70305270.0,30.830881606979798,-0.01654846335697402,3.2737893702848764,3.2737893702848764,4638.200000000001,4454.25,4760.48036894144,3937.0,4041.2,0,1004.0,2.803049922865661,661510491.1771592
2019-04-10,5307.8,5158.4,5404.1,5142.9,837510.0,19345.5,0.1,5237.133333333332,83.38677560057586,83.78757472019532,5560.024194135827,3446.765805864172,4663.0720321280305,93.1002364404958,175.46978295700546,71142780.0,31.32592720884777,0.02896246898263044,3.30588535658852,3.30588535658852,4712.4,4529.6,4846.89950991081,3937.0,5307.8,0,1005.0,2.8032787433497277,663315640.6040287
2019-04-11,5022.6,5307.7,5337.0,4948.0,943490.0,19345.5,0.1,5162.9333333333325,67.05582232220652,54.765597679204234,5607.1898116657685,3502.8201883342317,4697.312790972979,72.38508867173363,190.72194131721935,70199290.0,24.766494435612092,-0.053732243113907785,3.7972751426993856,3.7972751426993856,4873.825,4542.950000000001,4947.195598126864,3937.0,5307.8,0,1006.0,2.803489565701978,665029055.5957828
2019-04-12,5054.2,5022.7,5080.5,4889.2,779140.0,19345.5,0.1,5128.2,67.8081085223815,33.18401269746488,5649.136409719762,3566.0435902802383,4731.302048975553,74.02375649591681,190.76323122313224,70978430.0,23.207059626541856,0.006291562139131068,3.774350663272768,3.774350663272768,4873.825,4542.950000000001,5404.1,3937.0,5307.8,0,1007.0,2.803701897314088,666754919.8837125
2019-04-13,5051.8,5054.2,5093.4,5011.6,577160.0,19345.5,0.1,5042.866666666666,67.68169762640841,15.151830013563483,5679.2590133999565,3641.6309866000447,4761.8256633588335,73.45739471106756,182.98014327862273,70401270.0,22.86103409698915,-0.00047485259783930367,3.622078136082638,3.622078136082638,4898.6,4542.950000000001,5393.802000000001,3937.0,5307.8,0,1008.0,2.8039135995302678,668481773.2774463
2019-04-14,5134.8,5052.0,5153.5,5010.7,566380.0,19345.5,0.1,5080.2666666666655,69.77991326646205,5.705115144185015,5702.151044429976,3738.5189555700244,4797.34702875323,79.71069087621485,180.1101330444354,70967650.0,25.16880774199839,0.016429787402509888,3.5076367734758,3.5076367734758,4898.825,4542.950000000001,5383.70996,3937.0,5307.8,0,1009.0,2.8041299832360838,670238320.4188479
2019-04-15,5032.3,5135.1,5168.0,4964.2,688200.0,19345.5,0.1,5072.966666666665,64.23371869037467,-9.716362173409777,5697.114147014488,3852.5058529855114,4819.723502205303,70.50610820244327,181.8022663984043,70279450.0,21.403584955730857,-0.019961829087793093,3.6127072392028357,3.6127072392028357,4898.825,4542.950000000001,5373.8197608,5032.3,5307.8,0,1010.0,2.804339502448539,671962168.5522059
2019-04-16,5180.9,5031.4,5198.4,5014.4,631050.0,19345.5,0.1,5115.999999999999,68.18207354490632,-12.027524579965359,5705.359684234036,3958.180315765965,4854.121263900036,63.70141486420548,181.95924736994684,70910500.0,6.618237194657656,0.0295292411024779,3.5121165698999564,3.5121165698999564,4898.825,4542.950000000001,5364.1273655840005,5032.3,5307.8,0,1011.0,2.804557754201596,673737827.4468178
2019-04-17,5208.3,5182.1,5230.9,5165.5,806520.0,19345.5,0.1,5140.499999999999,68.864590444181,-13.707528330185994,5695.606247606912,4086.203752393088,4887.852572100032,68.15742397137745,173.633586843522,71717020.0,4.822186889930975,0.005288656411048365,3.3337862036273256,3.3337862036273256,4898.825,4542.950000000001,5354.62881827232,5032.3,5307.8,0,1012.0,2.804777190738661,675524543.7379165
2019-04-18,5264.7,5208.3,5293.1,5205.0,727970.0,19345.5,0.1,5217.966666666665,70.27789054250101,-13.021911009006317,5682.217193287035,4215.842806712966,4923.7428033286005,72.9740209383481,167.5240449261276,72444990.0,7.390257832898177,0.010828869304763566,3.182024520411944,3.182024520411944,4898.825,4542.950000000001,5345.320241906874,5032.3,5307.8,0,1013.0,2.804999548532847,677331872.8679128
2019-04-19,5241.0,5264.8,5282.4,5192.1,787090.0,19345.5,0.1,5237.999999999999,68.86332932378039,-15.971624725417314,5639.2652090450665,4371.714790954933,4953.957774440162,68.32394639735867,162.00804171711843,71657900.0,4.606602530837097,-0.004501681007464731,3.091166604028209,3.091166604028209,4882.05,4542.950000000001,5336.197837068737,5032.3,5307.8,0,1014.0,2.8052199929311326,679133458.4789498
2019-04-20,5290.2,5241.0,5327.0,5240.2,782320.0,19345.5,0.1,5265.299999999999,70.20411913010312,-16.356554385154595,5555.416826796302,4574.353173203698,4985.980843541099,77.87919984462994,156.63603873732427,72440220.0,4.83532162815584,0.009387521465369142,2.960871776819861,2.960871776819861,4880.05,4542.950000000001,5327.257880327362,5032.3,5307.8,0,1015.0,2.8054429049922502,680953304.4911125
2019-04-21,5243.5,5290.2,5308.2,5189.8,811410.0,19345.5,0.1,5258.233333333333,67.24420017653576,-21.196582501543162,5376.196150198513,4863.413849801487,5010.506477489565,68.80947756845985,153.90489311322966,71628810.0,1.3510901499922612,-0.008827643567350885,2.9351557759746285,2.9351557759746285,4907.875,4542.950000000001,5327.0,5032.3,5307.8,0,1016.0,2.8056625286546995,682759814.117653
2019-04-22,5346.7,5248.2,5370.2,5170.2,920770.0,19345.5,0.1,5293.466666666665,70.2311428486212,-18.960678643915912,5389.296462748809,4899.053537251191,5042.524908204845,88.8522043115167,157.19740074799898,72549580.0,1.9351025699687334,0.019681510441498906,2.9400826818037107,2.9400826818037107,4936.725,4542.950000000001,4889.2,5032.3,5307.8,0,1017.0,2.805887823797955,684602360.1347319
2019-04-23,5511.6,5346.5,5594.4,5291.4,900000.0,19345.5,0.1,5367.2666666666655,74.26875919365781,-8.426162403900264,5450.5673068806855,4892.072693119316,5087.198726471051,88.25865002836085,167.6118721231419,73449580.0,6.847084367245672,0.030841453606897717,3.0410746810933644,3.0410746810933644,5043.9,4638.1,4898.82,5032.3,5307.8,0,1018.0,2.806122219966766,686500215.1430959
2019-04-24,5415.6,5511.2,5589.6,5346.8,994040.0,19345.5,0.1,5424.633333333332,68.44825595257994,-9.873297003678715,5466.824893225932,4927.135106774067,5118.475038235712,74.64549064095303,172.98245268577463,72455540.0,2.030973284600026,-0.017417809710428944,3.194151205513233,3.194151205513233,5065.075,4638.1,4926.6431999999995,5032.3,5307.8,0,1019.0,2.8063505729323457,688369664.4155387
2019-04-25,5209.1,5415.6,5528.2,5137.4,955360.0,19345.5,0.1,5378.7666666666655,57.931072645726395,-25.783785650511504,5462.801297261225,4951.048702738775,5127.105986975169,45.363017583664295,188.54084892250503,71500180.0,3.7132162624935288,-0.03813058571534089,3.619451516048934,3.619451516048934,5100.75,4650.049999999999,4953.353472,5032.3,5307.8,0,1020.0,2.806566168127491,690173034.5574793
2019-04-26,5298.3,5209.2,5469.3,5159.3,1030000.0,19345.5,0.1,5307.666666666665,60.73744380968727,-30.995920652698544,5467.2001604960005,4971.859839504001,5143.41017869182,53.01491589971445,197.21650257089755,72530180.0,4.829646630525115,0.017123879364957517,3.722260018702179,3.722260018702179,5100.75,4702.549999999999,4978.9953331199995,5032.3,5307.8,0,1021.0,2.806786639564849,692008272.2535527
2019-04-27,5265.9,5298.2,5318.1,5225.4,833130.0,19345.5,0.1,5257.7666666666655,59.19283797105547,-36.91888806974626,5471.659520584377,4976.630479415622,5155.075875959265,47.87369089178037,189.75103810154775,71697050.0,4.238093352864315,-0.006115169016477129,3.603392356511665,3.603392356511665,5117.424999999999,4702.549999999999,5003.6115197951995,5032.3,5307.8,0,1022.0,2.8070046932273125,693834753.3826493
2019-04-28,5302.3,5265.7,5332.5,5234.4,681410.0,19345.5,0.1,5288.833333333332,60.410922971995795,-38.50209884958508,5476.72747546098,4977.27252453902,5169.0972211060025,53.64963503649642,183.20453538000865,72378460.0,3.2620549972735065,0.00691239864030857,3.4551899247497997,3.4551899247497997,5278.849999999999,4702.549999999999,5027.243059003392,5032.3,5307.8,0,1023.0,2.8072244372032062,695675453.1183201
2019-04-29,5235.0,5302.4,5322.9,5188.9,775820.0,19345.5,0.1,5267.733333333333,57.02185036564244,-43.81237738550681,5478.573303441514,4983.0866965584855,5175.373676238764,38.034482758620754,179.68992571000803,71602640.0,4.027979254019034,-0.012692605095901865,3.4324723153774217,3.4324723153774217,5278.849999999999,4705.75,5049.929336643256,5032.3,5307.8,0,1024.0,2.8074396733562845,697495556.5701821
2019-04-30,5320.8,5235.4,5336.6,5195.9,697420.0,19345.5,0.1,5286.033333333332,60.09543311824871,-41.30999460909007,5480.094356785996,4982.865643214005,5189.223802311263,40.13129102844651,176.90493101643605,72300060.0,2.7003030361520306,0.01638968481375369,3.3247806911824545,3.3247806911824545,5303.625,4705.75,5071.708163177525,5032.3,5307.8,0,1025.0,2.8076595527413395,699346541.7480274
2019-05-01,5384.2,5321.1,5396.3,5319.5,623640.0,19345.5,0.1,5313.333333333332,62.244098069081545,-35.3773279542805,5487.1311716520195,5011.9888283479795,5207.792963995906,54.00437636761492,169.75457880097633,72923700.0,3.377301614730327,0.011915501428356512,3.1528282530547966,3.1528282530547966,5303.849999999999,4705.75,5092.615836650424,5032.3,5307.8,0,1026.0,2.807882680230883,701220733.3737059
2019-05-02,5493.8,5384.6,5530.8,5370.0,722230.0,19345.5,0.1,5399.5999999999985,65.68401926252234,-24.576617854566848,5514.0376486486275,5029.042351351372,5235.031729329628,77.98687089715548,169.11496602947804,73645930.0,4.35162497388266,0.02035585602317891,3.0782876338686886,3.0782876338686886,5302.65,4705.75,5112.687203184407,5032.3,5307.8,0,1027.0,2.8081116668736916,703133117.4138204
2019-05-03,5766.8,5493.6,5844.2,5478.7,1040000.0,19345.5,0.1,5548.2666666666655,72.42366372235028,-0.8070821527802821,5612.400176166106,5002.179823833892,5285.67632653633,89.04923599320888,183.14246845594388,74685930.0,10.0324365579088,0.049692380501656475,3.175807526807656,3.175807526807656,5428.75,4836.3,5131.955715057031,5032.3,5307.8,0,1028.0,2.8083554265356385,705134733.835466
2019-05-04,5830.9,5768.0,5899.2,5605.0,920610.0,19345.5,0.1,5697.166666666665,73.72835541519336,16.515353381672014,5712.405132051652,4971.784867948349,5337.602390675726,91.03439222893145,191.0751492805193,75606540.0,10.22078560356886,0.011115349934105456,3.2769409401725174,3.2769409401725174,5461.725,4863.8,5174.690372153609,5032.3,5830.9,0,1029.0,2.808602160120431,707158944.8498328
2019-05-05,5774.9,5830.8,5838.2,5708.2,709020.0,19345.5,0.1,5790.866666666666,70.58635133221408,21.186657482070615,5766.3741850696715,4992.075814930329,5379.249782039943,83.68338146495141,186.71263861762506,74897520.0,10.13445217888814,-0.009604006242604046,3.233175269141025,3.233175269141025,5469.125,4887.0,5232.651142381321,5032.3,5830.9,0,1030.0,2.8088453518117538,709168598.9340053
2019-05-06,5745.1,5775.1,5801.4,5630.5,755390.0,19345.5,0.1,5783.633333333331,68.9035731875623,19.30733412684279,5814.384157881067,5000.485842118932,5414.092659940901,79.77159359411927,185.5831644306518,74142130.0,7.451325116426966,-0.005160262515368053,3.2302860599580825,3.2302860599580825,5469.125,4898.55,5285.975050990815,5745.1,5830.9,0,1031.0,2.8090864137483647,711171646.8836132
2019-05-07,5849.5,5745.5,6019.8,5745.5,955880.0,19345.5,0.1,5789.833333333332,71.46971773434682,21.94104678926962,5878.413655219973,5000.576344780028,5455.560025660816,80.70036264732546,191.94865268560525,75098010.0,6.130706147035337,0.018172007449826832,3.281454016336529,3.281454016336529,5529.425,4958.85,5335.03304691155,5745.1,5830.9,0,1032.0,2.8093326356545347,713209985.3875779
2019-05-08,5990.3,5849.4,6011.3,5799.1,757130.0,19345.5,0.1,5861.633333333332,74.52324358853141,29.538334304870062,5967.660356053733,4983.889643946266,5506.4876422645475,96.65684496826836,193.39517749377632,75855140.0,10.611935888913505,0.024070433370373623,3.228472321816542,3.228472321816542,5549.925,4958.85,5403.509742220394,5745.1,5830.9,0,1033.0,2.8095858262831803,715294337.5804044
2019-05-09,6191.5,5990.5,6206.0,5990.0,799960.0,19345.5,0.1,6010.433333333332,78.1259917815396,43.63569506824231,6092.813209680081,4953.786790319919,5571.726914429829,98.61469379956053,195.00980767279228,76655100.0,18.85930391046437,0.033587633340567136,3.149637530045906,3.149637530045906,5673.925,5051.95,5465.1387679983545,5745.1,5830.9,0,1034.0,2.8098488829073984,717441864.9915291
2019-05-10,6386.0,6194.3,6466.6,6157.8,907940.0,19345.5,0.1,6189.2666666666655,80.93302687037308,60.541135946738564,6249.1493532617715,4907.030646738229,5649.276732103179,93.6917899350395,203.13767855330713,77563040.0,20.529226355623496,0.031414035371073235,3.180984631276341,3.180984631276341,5816.85,5182.25,5554.042115838552,5745.1,5830.9,0,1035.0,2.81012113214455,719649192.2228184
2019-05-11,7190.3,6386.6,7373.8,6386.5,1310000.0,19345.5,0.1,6589.2666666666655,87.86688479046016,117.09844179505063,6629.303406904765,4721.556593095235,5796.040852855257,91.60144629044808,259.18498722807095,78873040.0,36.544560284092,0.12594738490447854,3.604647750831967,3.604647750831967,6310.175,5635.85,5681.800219621155,5745.1,5830.9,0,1036.0,2.8104300930839217,722077319.5444899
2019-05-12,6984.8,7190.0,7518.9,6802.6,1350000.0,19345.5,0.1,6853.7,79.87444324368471,130.83397303457406,6854.749250454268,4659.920749545732,5909.256009726185,77.07725321888414,291.83605956892296,77523040.0,31.731512739754447,-0.02858017050748929,4.1781591394016,4.1781591394016,6445.049999999999,5708.4,5952.52018448177,5745.1,5830.9,0,1037.0,2.810729390426722,724457030.8349091
2019-05-13,7806.0,6984.7,8058.3,6893.1,1200000.0,19345.5,0.1,7327.033333333333,85.53626781580144,182.23300465253396,7278.825714046926,4465.284285953073,6089.898294514167,91.1857182783678,354.21919817114275,78723040.0,49.11174785100286,0.1175695796586873,4.537781170524504,4.537781170524504,6721.125,5978.1,6234.468551275051,5745.1,5830.9,0,1038.0,2.811063008096425,727046054.9458997
2019-05-14,7994.6,7806.4,8323.9,7674.0,1330000.0,19345.5,0.1,7595.133333333332,86.47718832773548,213.75796646355224,7665.895583161578,4336.114416838423,6271.298456941389,89.0394088669951,375.33925544463256,80053040.0,50.25184182829649,0.024160901870356133,4.694909757143979,4.694909757143979,6853.924999999999,6110.9,6599.234841020041,5745.1,5830.9,0,1039.0,2.811403527630147,729684966.6140932
2019-05-15,8164.6,7994.8,8225.3,7856.5,1130000.0,19345.5,0.1,7988.399999999999,87.28041378465252,229.4994495622609,8018.35663934916,4279.203360650841,6451.612889613638,94.60712955753414,374.8721657700159,81183040.0,51.63998365588204,0.021264353438571026,4.591433331333022,4.591433331333022,6882.674999999999,6110.9,6893.1,5745.1,5830.9,0,1040.0,2.8117500524301273,732368941.5253674
2019-05-16,7871.8,8164.8,8293.3,7720.4,1180000.0,19345.5,0.1,8010.333333333333,78.61871206900551,204.46506894195443,8246.76557121524,4308.144428784761,6586.86880488853,84.11008013496416,389.0170110721576,80003040.0,43.28515781426335,-0.035862136540675604,4.941906693159856,4.941906693159856,6896.075,6111.9,7179.26,5745.1,5830.9,0,1041.0,2.812084532261505,734991224.3061924
2019-05-17,7359.5,7871.9,7924.0,6998.6,1430000.0,19345.5,0.1,7798.633333333331,66.23353238494583,140.71151604266515,8347.807426702906,4416.462573297094,6660.452728232479,64.52977306999155,427.33008170986056,78573040.0,27.618436567940623,-0.065080413628395,5.806509704597603,5.806509704597603,6943.799999999999,6130.049999999999,8323.9,5745.1,5830.9,0,1042.0,2.812397339260686,737493707.2679366
2019-05-18,7262.6,7359.9,7458.5,7189.4,865530.0,19345.5,0.1,7497.966666666666,64.17422524348751,82.22075020644218,8415.938037466934,4544.361962533065,6717.800087448433,60.59627236949582,416.0279330162991,77707510.0,24.553670959886137,-0.013166655343433642,5.728360821417936,5.728360821417936,6985.75,6166.15,8297.394,5745.1,5830.9,0,1043.0,2.8127054288394744,739976450.537211
2019-05-19,8157.2,7261.9,8253.4,7252.3,1080000.0,19345.5,0.1,7593.0999999999985,72.63378470633447,93.18259589470995,8604.719611313834,4647.800388686166,6854.885793405725,93.81079676245638,457.8187949437062,78787510.0,41.252662383764225,0.12317902679481163,5.61245028862485,5.61245028862485,7042.924999999999,6173.25,8271.41812,5745.1,5830.9,0,1044.0,2.813049334412007,742682379.0906245
2019-05-20,7965.3,8156.4,8156.4,7604.0,958810.0,19345.5,0.1,7795.033333333333,68.87666501078832,77.55108117844259,8723.715035670146,4793.254964329854,6960.639527367085,86.0921501706485,464.6317381620129,77828700.0,38.64510626446885,-0.023525229245329182,5.833198224323163,5.833198224323163,7146.95,6190.5,8253.4,5745.1,5830.9,0,1045.0,2.813385193104927,745349697.3386725
2019-05-21,7930.3,7965.0,8056.8,7813.2,804880.0,19345.5,0.1,8017.5999999999985,68.18391578546404,55.9070300429122,8807.820454389335,4963.759545610663,7052.988143808315,84.41064638783271,448.8437568647263,77023820.0,35.57227113428498,-0.00439405923191849,5.659858477796884,5.659858477796884,7175.05,6200.35,8253.4,5745.1,5830.9,0,1046.0,2.813719087210259,748014674.6073931
2019-05-22,7635.7,7928.7,7999.0,7545.9,821400.0,19345.5,0.1,7843.7666666666655,62.486961591598195,14.934565530234295,8829.53125910927,5156.238740890731,7108.484511064666,70.5128754445349,449.14777423153157,76202420.0,27.467739512211402,-0.03714865768003739,5.882208235414325,5.882208235414325,7208.825,6200.35,8228.304,5745.1,5830.9,0,1047.0,2.8140405532564823,750613748.614301
2019-05-23,7852.1,7637.2,7939.1,7486.8,815140.0,19345.5,0.1,7806.033333333333,64.81267520787725,-3.4279424250735246,8879.50179411924,5314.79820588076,7179.305033820412,78.21891879414619,449.3729332149936,77017560.0,26.820641201647426,0.028340558167555097,5.7229649802599765,5.7229649802599765,7201.174999999999,6233.7,8203.70992,5745.1,5830.9,0,1048.0,2.814370187408078,753271518.5462717
2019-05-24,7970.1,7852.8,8124.1,7775.4,868470.0,19345.5,0.1,7819.299999999999,66.04873475015103,-12.92821977371716,8925.373105861527,5482.846894138474,7254.61884012323,81.73841230515126,442.1820094139227,77886030.0,24.805825242718452,0.015027826950751999,5.548010808069192,5.548010808069192,7201.174999999999,6556.549999999999,8179.607721599999,5745.1,5830.9,0,1049.0,2.81470390540058,755963597.6737065
2019-05-25,8027.4,7971.4,8090.1,7919.1,691270.0,19345.5,0.1,7949.866666666666,66.6611708518248,-20.220068596718647,8941.24789840988,5692.222101590121,7328.21704582578,80.51009005455859,422.8118658843568,78577300.0,11.64207334881715,0.007189370271389217,5.267108477020664,5.267108477020664,7192.95,6556.549999999999,8155.987567167999,5745.1,5830.9,0,1050.0,2.8150392790567813,758675401.3724837
2019-05-26,8630.2,8029.6,8718.6,7866.5,872120.0,19345.5,0.1,8209.233333333332,72.31835179701137,9.113154799258723,9012.387719348608,5909.592280651392,7452.215422413801,95.15749109832925,453.47530403547415,79449420.0,23.556866338334675,0.07509280713556077,5.254516743939586,5.254516743939586,7486.525,6803.450000000001,6998.6,5745.1,5830.9,0,1051.0,2.8153966929908507,761532521.6004817
2019-05-27,8760.1,8628.9,8902.8,8607.3,907960.0,19345.5,0.1,8472.566666666666,73.36714076612438,29.664423932700856,9069.488323102061,6143.551676897939,7576.775858374392,92.50603928158812,442.191353747226,80357380.0,12.222649244171155,0.015051794859910483,5.047788880803028,5.047788880803028,7606.974999999999,6896.0,7033.0,5745.1,8760.1,0,1052.0,2.815758168572503,764425457.9031111
2019-05-28,8716.3,8759.4,8794.1,8568.8,763200.0,19345.5,0.1,8702.199999999999,72.37147577422898,32.48126335400832,9080.674426460539,6404.9655735394645,7685.3019671006405,90.20586072891503,426.69911419385284,79594180.0,9.02734345683335,-0.0049999429230260795,4.8954156487713005,4.8954156487713005,7692.775,6896.0,7107.792,5745.1,8760.1,0,1053.0,2.8161174702310023,767315866.8340235
2019-05-29,8647.8,8715.6,8747.2,8435.3,15430000.0,19345.5,0.1,8708.066666666666,70.7542694222527,22.384514761911532,9053.910801781745,6677.359198218256,7776.968446424389,86.60854952210902,418.4991774657206,64164180.0,5.918232369007654,-0.007858839186351996,4.839371602785918,4.839371602785918,7724.349999999999,6896.0,7179.592320000001,5745.1,8760.1,1,1054.0,2.816473702455612,770198060.474165
2019-05-30,8271.9,8647.8,9045.9,8054.7,1040000.0,19345.5,0.1,8545.333333333332,62.50057375264533,-14.945501068545695,8945.617321821705,6974.242678178296,7824.104784860162,62.19410931470716,459.406379075312,63124180.0,5.082700271856493,-0.043467702768334116,5.553819304818869,5.553819304818869,7802.275,6967.549999999999,7248.5206272000005,5745.1,8760.1,0,1055.0,2.8168154622685138,773000611.1343907
2019-05-31,8558.3,8271.4,8578.8,8135.0,858410.0,19345.5,0.1,8492.666666666666,65.7763036588691,-25.087397526647464,8980.174798483473,7076.485201516528,7894.028138683004,73.7355238351737,458.2916377127896,63982590.0,16.289150078130298,0.03462324254403448,5.354937752974185,5.354937752974185,7802.275,6967.549999999999,7356.3633895680005,5745.1,8760.1,0,1056.0,2.8171672516347512,775876214.3874141
2019-06-01,8545.7,8556.9,8615.8,8454.0,686750.0,19345.5,0.1,8458.633333333333,65.50519622297108,-36.680954740394895,8953.362487215743,7259.387512784257,7956.092125475098,72.11195361284572,437.1136635904474,63295840.0,17.66722661305869,-0.0014722550039141247,5.115012972494323,5.115012972494323,7903.174999999999,6967.549999999999,7457.73558619392,5745.1,8760.1,0,1057.0,2.817517982813207,778755813.6468008
2019-06-02,8728.6,8545.8,8807.7,8534.8,614540.0,19345.5,0.1,8610.866666666667,67.59322112871489,-36.01667477384865,9029.011507619902,7275.998492380098,8029.66430400128,79.6485151690078,425.38411619112986,63910380.0,7.004854606972987,0.02140257673449808,4.873451827224639,4.873451827224639,7939.35,6967.549999999999,7553.025451022285,5745.1,8760.1,0,1058.0,2.8178747192492977,781684006.658401
2019-06-03,8124.8,8728.6,8734.9,8102.7,739450.0,19345.5,0.1,8466.366666666667,55.623038157510486,-77.82750942810242,9032.663014420015,7285.366985579983,8038.724846477348,40.92104419216216,440.15667932033483,63170930.0,2.0024355642599776,-0.06917489631785168,5.4174463287752905,5.4174463287752905,7987.075000000001,7005.049999999999,7642.597923960948,5745.1,8760.1,0,1059.0,2.818208509488224,784477635.8939711
2019-06-04,7685.5,8118.1,8118.1,7494.0,966950.0,19345.5,0.1,8179.633333333332,48.84545872249351,-133.3937396703767,9032.725047553951,7237.394952446048,8005.084384908077,12.744532101853626,453.7740593688823,62203980.0,-3.086894568931821,-0.05406902323749507,5.90428806673453,5.90428806673453,7935.900000000001,7005.049999999999,9045.9,5745.1,8760.1,0,1060.0,2.818524398200562,787167268.4476124
2019-06-05,7779.1,7685.6,7885.0,7590.4,762940.0,19345.5,0.1,7863.133333333332,50.23678089131575,-160.35624740886192,9034.414459839018,7226.435540160983,7983.562062535879,18.747995638509416,442.40448369967646,62966920.0,1.8780203517686729,0.012178778218723707,5.687090842124108,5.687090842124108,7993.075000000001,7005.049999999999,9014.862,5745.1,8760.1,0,1061.0,2.818843493341428,789886541.2650502
2019-06-06,7784.9,7779.6,7861.4,7480.4,651820.0,19345.5,0.1,7749.833333333332,50.32693826840134,-173.2147833776935,9000.458645486797,7302.931354513203,7964.641866103891,19.450654742893644,438.0184491496996,63618740.0,-0.8558220093987687,0.0007455875358330921,5.626513495994806,5.626513495994806,8093.7,7030.15,8984.444759999998,5745.1,8760.1,0,1062.0,2.8191622534786527,792613004.6791918
2019-06-07,7985.2,7785.8,8099.4,7749.4,588870.0,19345.5,0.1,7849.733333333333,53.46262266960552,-163.75183023583378,8937.907896418814,7437.742103581186,7966.599783617806,32.245289045033545,431.7314170675782,64207610.0,0.18945809964742544,0.025729296458528728,5.406645006606951,5.406645006606951,8116.325,7091.65,8924.282969599999,5745.1,8760.1,0,1063.0,2.819488355444389,795396037.5749948
2019-06-08,7901.4,7985.3,8044.4,7770.5,485810.0,19345.5,0.1,7890.499999999997,51.9840943387353,-158.55163854488484,8935.423251553137,7414.646748446861,7960.39028041611,26.892366656020442,420.457744419894,63721800.0,-1.5696240376709771,-0.010494414667134189,5.321306912950794,5.321306912950794,8083.15,7091.65,8866.527650815999,5745.1,8760.1,0,1064.0,2.8198106010400665,798163900.5725864
2019-06-09,7635.0,7901.6,7937.5,7516.9,554480.0,19345.5,0.1,7840.533333333333,47.48797408467983,-167.58759994646488,8950.11908943861,7366.920910561388,7929.40072990029,9.875439156818931,420.4679055327588,63167320.0,-11.531598340710536,-0.0337155440807958,5.507110746990946,5.507110746990946,8083.15,7091.65,8811.08254478336,7635.0,8760.1,0,1065.0,2.820121607046307,800868550.3512287
2019-06-10,7987.8,7635.0,8012.8,7523.6,641380.0,19345.5,0.1,7841.399999999999,53.25416948996062,-145.17496280277385,8950.06999383462,7372.720006165381,7934.962565147881,32.41137016927503,425.3773408518474,63808700.0,-8.816109405143777,0.0462082514734774,5.325337900947036,5.325337900947036,8083.15,7091.65,8757.855242992026,7635.0,8760.1,0,1066.0,2.8204461037574,803669972.9174554
2019-06-11,7888.0,7987.8,8010.4,7714.5,579000.0,19345.5,0.1,7836.933333333332,51.5303940306755,-132.77885236347805,8936.276102880114,7411.743897119885,7930.489939895702,26.036410092622187,416.1289593624297,63229700.0,-9.502885398620966,-0.012494053431483021,5.2754685517549404,5.2754685517549404,8064.95,7091.65,8706.757033272344,7635.0,8760.1,0,1067.0,2.8207661203750405,806451922.8221991
2019-06-12,8133.1,7888.0,8198.1,7805.8,607890.0,19345.5,0.1,8002.966666666666,55.352653648150444,-104.99738928930742,8936.304290055084,7439.815709944915,7949.7861360961115,41.692749920153354,414.42689083654193,63837590.0,-5.951802770646858,0.03107251521298182,5.095558776315819,5.095558776315819,7978.45,7091.65,8657.702751941451,7635.0,8760.1,0,1068.0,2.8210950814719085,809301984.0650905
2019-06-13,8219.0,8132.4,8306.1,8028.6,574210.0,19345.5,0.1,8080.033333333333,56.64311009188545,-78.94949723924131,8942.084496682612,7458.925503317387,7975.4255517060055,55.646801778045635,404.64639863393177,64411800.0,-0.6395145009006352,0.010561778411675604,4.9233045216441385,4.9233045216441385,8021.175,7091.65,8610.610641863794,7635.0,8760.1,0,1069.0,2.8214267325394675,812179733.8226333
2019-06-14,8656.1,8218.6,8685.3,8153.2,643170.0,19345.5,0.1,8336.066666666666,62.57133135260559,-32.760942058785474,8994.506590928317,7469.373409071682,8040.251689638767,88.57831688389963,413.7502273029366,65054970.0,1.1427503125620873,0.05318165226913263,4.779868847436335,4.779868847436335,8173.0,7091.65,7480.4,7635.0,8760.1,0,1070.0,2.821773902266018,815169970.299589
2019-06-15,8812.5,8655.8,8856.7,8582.3,608690.0,19345.5,0.1,8562.533333333333,64.44465086216337,5.791160776978018,9026.461423388577,7455.648576611425,8113.799147768408,96.7884908813485,403.79663963844126,65663660.0,3.122037984015344,0.01806818313097125,4.582089527812099,4.582089527812099,8224.975,7091.65,7504.498,7635.0,8760.1,0,1071.0,2.8221260416311895,818204058.9781578
2019-06-16,8962.5,8812.2,9332.0,8771.1,849770.0,19345.5,0.1,8810.366666666667,66.19233079929043,37.11428601549821,9067.672781687148,7434.6772183128505,8194.627800361894,80.04428602289912,415.01830823569543,66513430.0,2.6796966294709303,0.017021276595744705,4.630608739031469,4.630608739031469,8415.325,7245.65,7558.58608,7635.0,8760.1,0,1072.0,2.8224828251427088,821280248.7756649
2019-06-17,9318.8,8961.0,9438.1,8959.8,738800.0,19345.5,0.1,9031.266666666665,69.9684365014852,75.34541124092902,9202.025225026464,7360.574774973535,8301.691819375046,93.90611431782189,419.53842907600296,67252230.0,14.695746356833386,0.039754532775453155,4.502064955530787,4.502064955530787,8468.375,7313.5,7664.9909152,7635.0,8760.1,0,1073.0,2.8228511077365166,824444644.154402
2019-06-18,9080.6,9318.9,9336.1,8962.7,723170.0,19345.5,0.1,9120.633333333333,64.76067710166116,77.79086969706987,9275.962830975734,7329.917169024264,8375.873550863138,81.73877509322163,416.24282699914556,66529060.0,18.15236484288596,-0.02556123105979302,4.583869204668695,4.583869204668695,8470.05,7313.5,7806.839641984,7635.0,8760.1,0,1074.0,2.823210746991418,827563337.9134917
2019-06-19,9255.4,9080.7,9295.1,9044.0,587570.0,19345.5,0.1,9218.266666666665,66.7183407070562,83.8577645617741,9409.632858525347,7294.597141474657,8459.637974590458,90.6676201665219,404.4469107849209,67116630.0,18.977773778457653,0.019249829306433375,4.369847989119011,4.369847989119011,8517.775,7313.5,7937.34047062528,7635.0,8760.1,0,1075.0,2.8235756981573825,830729486.293022
2019-06-20,9517.0,9255.0,9583.9,9188.4,693620.0,19345.5,0.1,9284.333333333334,69.45332855103902,97.22471336586369,9571.39193385195,7228.708066148049,8560.339119867556,96.7634252539913,403.8078457288551,67810250.0,22.249482973448607,0.02826458067722637,4.243016136690712,4.243016136690712,8613.5,7389.9,8057.401232975258,7635.0,8760.1,0,1076.0,2.8239486849443507,833961922.125937
2019-06-21,10179.3,9517.7,10184.3,9517.4,769120.0,19345.5,0.1,9650.566666666666,75.04466402209306,139.81662011290592,9886.813187715241,7076.646812284758,8714.525870356361,99.81255154832421,422.6287138910797,68579370.0,27.4770826028152,0.06959125774929076,4.1518445658451935,4.1518445658451935,8969.4,7751.9,8210.051109677732,7635.0,8760.1,0,1077.0,2.8243419111191885,837343993.8450723
2019-06-22,10721.7,10178.1,11160.5,10031.3,1090000.0,19345.5,0.1,10139.33333333333,78.51338431730585,190.5230179346325,10291.893242920805,6870.876757079195,8905.685311274803,87.95696563837964,473.09809147028835,69669370.0,35.693674538689365,0.05328460699655202,4.412528717183734,4.412528717183734,9488.650000000001,8265.25,8446.960976516404,7635.0,8760.1,0,1078.0,2.8247505912933812,840844880.2762147
2019-06-23,10897.1,10721.5,11361.3,10557.8,683790.0,19345.5,0.1,10599.366666666665,79.50544653939266,219.80198527818993,10689.719572934182,6750.280427065818,9095.343853058155,87.90421346118771,496.6982277938392,70353160.0,42.72560576293386,0.016359345999235053,4.558077174604612,4.558077174604612,9696.324999999999,8420.0,8826.856439804107,7635.0,8760.1,0,1079.0,2.8251636519302754,844390315.5442753
2019-06-24,11046.4,10897.3,11114.4,10622.6,566960.0,19345.5,0.1,10888.4,80.33763474709573,231.94918825553248,11041.002976807726,6735.087023192278,9281.158724195473,91.36503235713502,496.34835437999345,70920120.0,38.290893612759454,0.013700892898110384,4.493304193040207,4.493304193040207,9743.525,8483.15,9232.36740943545,7635.0,8760.1,0,1080.0,2.825580276612063,847975141.4394233
2019-06-25,11809.9,11046.6,11833.9,11033.7,781090.0,19345.5,0.1,11251.133333333331,83.93103043569779,271.3899067714682,11525.616627278265,6653.553372721736,9521.991226653046,99.40418559618679,518.052043352851,71701210.0,49.7198275862069,0.06911754055619923,4.386591278104396,4.386591278104396,10027.0,8732.2,9572.996623925777,7635.0,8760.1,0,1081.0,2.826016938386998,851713247.0296885
2019-06-26,13063.8,11811.6,13929.8,11747.3,1480000.0,19345.5,0.1,11973.366666666663,87.85622739481943,356.54775426854167,12264.546767454282,6442.51323254572,9859.306347924185,85.32501864027655,636.9411831133617,73181210.0,60.625099900406966,0.10617363398504631,4.875619521987184,4.875619521987184,11075.675,9780.15,9979.959231619137,7635.0,13063.8,1,1082.0,2.8264841576208224,855679374.003733
2019-06-27,11287.8,13062.4,13422.0,10493.5,1590000.0,19345.5,0.1,12053.83333333333,64.00734703153952,271.722313385244,12474.799651910911,6562.520348089089,9995.353362407595,54.26375376519059,800.6239557481216,71591210.0,37.337875653972496,-0.13594819271574887,7.092825490778731,7.092825490778731,11096.0,9837.65,13929.8,7635.0,13063.8,1,1083.0,2.8269054695014417,859344712.0420026
2019-06-28,12409.1,11288.4,12461.8,10970.5,1090000.0,19345.5,0.1,12253.566666666666,69.61540441624135,269.08093751010165,12855.85970301494,6632.230296985062,10225.233994559254,71.562412342216,849.95795890897,72681210.0,43.35670798627557,0.09933733765658515,6.849473039212917,6.849473039212917,11132.099999999999,9864.45,13929.8,7635.0,13063.8,0,1084.0,2.82735541685842,863225745.0825508
2019-06-29,11906.5,12408.0,12422.9,11490.8,834620.0,19345.5,0.1,11867.799999999997,64.74578066476735,213.8426125406229,13047.37108809754,6867.868911902458,10385.354566505992,60.7788783995968,855.8252475583294,71846590.0,35.109219858156024,-0.04050253443037777,7.187882648623267,7.187882648623267,11214.349999999999,9959.9,13861.073999999999,7635.0,13063.8,0,1085.0,2.8277918976193366,867029825.479261
2019-06-30,10818.6,11906.0,12179.3,10765.4,880770.0,19345.5,0.1,11711.4,55.668590070631254,90.69335392058179,13072.14614958091,7126.173850419089,10426.616036362564,37.40040241448695,895.6877298755916,70965820.0,20.70962343096235,-0.09137025994204839,8.279146376385036,8.279146376385036,11342.824999999999,10043.8,13793.72252,7635.0,13063.8,0,1086.0,2.828198091174206,870637252.0312572
2019-07-01,10616.6,10821.4,11254.5,10041.6,1040000.0,19345.5,0.1,11113.9,54.15052723484258,-12.23611474974632,13035.571640582652,7435.608359417349,10444.709747185178,33.297094884338954,918.3457491701921,69925820.0,13.926685839378475,-0.01867154715027819,8.650092771416386,8.650092771416386,11345.4,10158.15,13727.7180696,7635.0,13063.8,0,1087.0,2.828597818699266,874213926.261735
2019-07-02,10835.9,10615.5,10923.5,9728.5,1120000.0,19345.5,0.1,10757.033333333333,55.56715450711781,-70.18220762443207,13007.930691718382,7733.529308281617,10481.96596173897,36.67567235662532,938.106767086607,71045820.0,19.330220470012986,0.02065633065199779,8.657395943914276,8.657395943914276,11276.25,10366.2,13580.273346816,7635.0,13063.8,0,1088.0,2.8290032264201885,877845630.6072716
2019-07-03,11900.8,10835.9,11931.8,10835.9,998730.0,19345.5,0.1,11117.766666666665,61.74778425315716,-42.77178611155591,13077.022493536138,8032.617506463865,10617.093013001924,57.206732188804985,949.3777122947065,72044550.0,28.58223307474555,0.09827517788093276,7.977427671204512,7.977427671204512,11276.25,10411.45,13349.16694600704,7635.0,13063.8,0,1089.0,2.8294369418717826,881694387.1755846
2019-07-04,11163.1,11899.3,11948.0,11087.1,840340.0,19345.5,0.1,11299.933333333332,55.942468246961106,-78.2386898456416,13057.485358213946,8302.854641786054,10669.093678430312,37.297162541927314,943.0578757022274,71204210.0,17.296416938110752,-0.0619874294165097,8.44799272336741,8.44799272336741,11276.25,10464.2,13131.926929246618,7635.0,13063.8,0,1090.0,2.8298502352993653,885413655.614736
2019-07-05,10970.2,11159.7,11381.8,10810.3,772670.0,19345.5,0.1,11344.699999999999,54.499573286806935,-116.31046416020627,13007.121662788637,8568.988337211364,10697.770470960759,29.55513769547523,916.5180274377826,70431540.0,7.769689467841615,-0.017280146195949087,8.354615480463279,8.354615480463279,11150.975,10464.2,12927.72131349182,7635.0,13063.8,0,1091.0,2.8302575015650895,889105227.4382991
2019-07-06,11268.0,10969.8,11650.2,10967.9,688960.0,19345.5,0.1,11133.766666666665,56.370473982624,-122.43871285935495,12965.038704060758,8841.621295939241,10752.078045154973,36.64341989384239,899.7881683350839,71120500.0,5.095274070343316,0.027146268983245347,7.985340507056122,7.985340507056122,10958.65,10464.2,12735.76803468231,7635.0,13063.8,0,1092.0,2.830672389852591,892867261.2800595
2019-07-07,11415.9,11267.9,11524.6,11108.1,601930.0,19345.5,0.1,11218.033333333333,57.30932451627142,-117.51133084128651,12946.499482507905,9069.870517492094,10815.299183711642,40.16375883655059,865.267584882578,71722430.0,4.760899688908051,0.013125665601703806,7.579495132951218,7.579495132951218,10971.75,10464.2,12555.331952601373,7635.0,13063.8,0,1093.0,2.831090651712286,896669689.7954619
2019-07-08,12252.6,11415.8,12332.3,11304.8,695600.0,19345.5,0.1,11645.499999999998,62.257377225976015,-61.68735624963233,12962.068861983915,9371.501138016085,10952.184975739105,60.07902315949827,876.8556145338225,72418030.0,10.919394553881814,0.07329251307387064,7.1564860889429385,7.1564860889429385,11004.8,10559.599999999999,12385.722035445291,7635.0,13063.8,0,1094.0,2.831530071317682,900642545.4583032
2019-07-09,12541.5,12250.6,12772.9,12111.2,847840.0,19345.5,0.1,12069.999999999998,63.816823570897,-11.707486732900179,12993.121695124937,9669.058304875063,11103.548311383,66.95546616523458,861.4873563528351,73265870.0,6.194802665560253,0.023578669017188192,6.869093460533709,6.869093460533709,11146.1,10591.05,9728.5,7635.0,13063.8,0,1095.0,2.8319760039600554,904680705.7061158
2019-07-10,12110.6,12542.8,13134.4,11594.9,1110000.0,19345.5,0.1,12301.566666666666,59.84508646106386,-13.919887091394799,12929.927720736569,9991.612279263432,11199.45799601319,64.49438202247192,909.9168308990612,72155870.0,-7.296498721658315,-0.03435793166686596,7.51339182946395,7.51339182946395,11343.75,10705.099999999999,9789.388,7635.0,13063.8,0,1096.0,2.832410486770763,908652749.5661256
2019-07-11,11342.3,12111.6,12111.6,11029.0,943130.0,19345.5,0.1,11998.133333333331,53.45676178019603,-70.2297669264733,12867.724164584268,10170.115835415732,11213.061996392888,47.38248333773744,922.2513429776998,71212740.0,0.482822161980191,-0.06344029197562473,8.131078731630268,8.131078731630268,11661.4,10705.099999999999,9923.18848,7635.0,13063.8,0,1097.0,2.8328241135555836,912488149.236041
2019-07-12,11762.1,11343.7,11881.4,11109.8,738170.0,19345.5,0.1,11738.333333333334,56.2075312470206,-81.51320767990387,12872.156242443914,10269.723757556083,11265.351330069756,59.708153498341126,911.490532765007,71950910.0,-5.21391559420103,0.037011893531294415,7.749386017505436,7.749386017505436,11708.574999999999,10705.099999999999,10051.636940800001,7635.0,13063.8,0,1098.0,2.8332482865112234,916417972.0199311
2019-07-13,11364.9,11762.8,11798.4,10839.4,747710.0,19345.5,0.1,11489.766666666665,53.01491196126347,-115.93669836504591,12862.657153537233,10326.002846462767,11274.832155777398,48.04603775800816,914.884066138935,71203200.0,-4.54877587872171,-0.033769479939806724,8.050084612613706,8.050084612613706,11709.3,10705.099999999999,10174.947463168,7635.0,13063.8,0,1099.0,2.833661227856505,920281023.941398
2019-07-14,10200.1,11364.3,11448.7,10128.9,840760.0,19345.5,0.1,11109.033333333333,44.95142494513897,-211.78158334556565,12941.339128164433,10162.690871835566,11172.476712370026,13.846560380516175,943.8066328432969,70362440.0,-5.71700589725103,-0.10249100300046632,9.25291548948831,9.25291548948831,11559.275,10705.099999999999,13134.4,7635.0,13063.8,0,1100.0,2.8340402443178463,923906532.7932004
2019-07-15,10845.9,10199.9,11064.7,9885.4,956520.0,19345.5,0.1,10803.633333333333,49.534440207983195,-225.06890591772355,12920.623849880556,10087.006150119441,11141.374168334783,32.80777474382688,960.6275876402044,71318960.0,2.1598251794359706,0.06331310477348251,8.857057391642966,8.857057391642966,11534.5,10705.099999999999,13074.289999999999,7635.0,13063.8,0,1101.0,2.834437535272933,927683554.8636105
2019-07-16,9424.8,10844.0,11019.5,9375.3,1050000.0,19345.5,0.1,10156.933333333332,41.37195279518372,-317.3059561539788,12822.756115670913,9820.973884329087,10977.89091420766,1.3168045542816098,1009.454188523047,70268960.0,-13.022453141871008,-0.13102647083229613,10.710616549136821,10.710616549136821,11453.699999999999,10705.099999999999,12946.7344,9424.8,13063.8,0,1102.0,2.8347909985108206,931145483.9635614
2019-07-17,9723.2,9425.1,9983.6,9082.6,1030000.0,19345.5,0.1,9997.966666666665,43.47811009065835,-343.73427019887265,12898.660160261887,9588.609839738114,10858.396541425978,15.810257169653006,1001.7074607714009,71298960.0,-18.297929550954546,0.03166114930820818,10.302240628305505,10.302240628305505,11307.35,10705.099999999999,12732.448336,9424.8,13063.8,0,1103.0,2.835153456520731,934688365.6286322
2019-07-18,10651.4,9723.1,10787.1,9390.0,974490.0,19345.5,0.1,9933.133333333331,49.549377125723055,-286.5537228287081,12739.006111309818,9572.493888690182,10838.682585099694,38.71859420504467,1029.949785002015,72273450.0,-4.583852155763191,0.09546239921013644,9.669618876410754,9.669618876410754,11307.35,10705.099999999999,12440.46046912,9424.8,10651.4,0,1104.0,2.835543343845791,938453117.5795776
2019-07-19,10571.5,10651.6,10758.4,10160.7,727790.0,19345.5,0.1,10315.366666666667,49.060851176214435,-243.64773267232053,12652.464794614796,9525.535205385204,10813.236624614008,36.74663112690656,999.0748003590139,71545660.0,-3.6343913511148447,-0.0075013613233940735,9.450643715262865,9.450643715262865,11051.650000000001,10705.099999999999,12171.8316315904,9424.8,10651.4,0,1105.0,2.8359302946718556,942210602.8258324
2019-07-20,10826.7,10571.9,11155.6,10462.0,668940.0,19345.5,0.1,10683.199999999999,50.73169416585394,-189.99733972325546,12652.593579122778,9526.216420877223,10814.518850841247,43.045066390246326,977.2551717619416,72214600.0,-3.916400425985084,0.024140377429882287,9.02634386989518,9.02634386989518,10994.1,10705.099999999999,11924.693101063167,9424.8,10651.4,0,1106.0,2.8363239537108638,946034501.5269834
2019-07-21,10714.4,10827.0,10883.8,10442.5,562170.0,19345.5,0.1,10704.199999999999,49.95518198615376,-155.44495459212507,12652.1395756557,9536.4504243443,10804.9837221897,40.27345870970926,938.9726594932315,71652430.0,-6.144938200229505,-0.01037250501076048,8.763651342989169,8.763651342989169,10973.35,10705.099999999999,11697.325652978114,9424.8,10651.4,0,1107.0,2.8367137849690254,949844451.0953404
2019-07-22,10412.5,10715.1,10806.3,10196.5,591270.0,19345.5,0.1,10651.199999999999,47.83542262494654,-146.4196624600968,12655.750140549679,9490.499859450321,10767.604320076394,32.82244928180068,915.4603266722863,71061160.0,-15.01803698806784,-0.028177032778316957,8.791935910418117,8.791935910418117,10758.975,10705.099999999999,11488.147600739865,9424.8,10651.4,0,1108.0,2.837094219303293,953597141.3915551
2019-07-23,9888.7,10412.8,10414.7,9865.4,663380.0,19345.5,0.1,10338.533333333331,44.321385023448016,-167.69479797782225,12587.382287131599,9357.657712868402,10683.899146735785,19.894861543017928,889.306017624266,70397780.0,-21.152174779731286,-0.05030492196878744,8.99315398004051,8.99315398004051,10613.8,10705.099999999999,11295.703792680675,9424.8,10651.4,0,1109.0,2.8374581989953995,957237044.1122991
2019-07-24,9804.3,9887.2,9945.3,9584.0,639540.0,19345.5,0.1,10035.166666666666,43.76351804963426,-178.42268492300704,12594.254607254277,9214.905392745723,10600.127799427615,23.826345328491215,851.5913020796755,69758240.0,-19.043647713573243,-0.008534994488658909,8.685896005626875,8.685896005626875,10613.8,10705.099999999999,11118.65548926622,9424.8,10651.4,0,1110.0,2.8378189509227467,960865679.7931422
2019-07-25,9945.3,9804.7,10203.5,9776.6,545850.0,19345.5,0.1,9879.433333333332,45.008811723211835,-167.18622442178153,12593.357558790518,9113.312441209484,10537.763247101175,30.823924539088146,821.2562090739845,70304090.0,-12.316725884520777,0.014381444876227834,8.257731884146125,8.257731884146125,10613.8,10705.099999999999,10955.771050124924,9424.8,10651.4,0,1111.0,2.83818348815655,964537603.4954835
2019-07-26,9831.0,9945.2,10436.1,9724.2,493750.0,19345.5,0.1,9860.199999999999,44.1552252132579,-158.6835686370124,12565.209522761266,8997.760477238735,10470.452461662968,27.55725753000957,813.4450512829856,69810340.0,-16.417986584028366,-0.011492865976893585,8.27428594530552,8.27428594530552,10690.65,10705.099999999999,10805.91736611493,9424.8,10651.4,0,1112.0,2.8385438830024734,968191032.0345997
2019-07-27,9492.1,9830.4,10232.3,9389.1,661890.0,19345.5,0.1,9756.133333333331,41.634019083418735,-166.3119072942646,12528.300525195165,8842.289474804835,10377.276036742685,17.30696082160517,815.5704047627722,69148450.0,-16.4788075565997,-0.034472586715491804,8.592096635757864,8.592096635757864,10690.425,10705.099999999999,10668.051976825736,9424.8,10651.4,0,1113.0,2.8388929301596173,971768923.4871576
2019-07-28,9727.8,9491.1,9798.5,9401.1,518590.00000000006,19345.5,0.1,9683.633333333331,44.02773088382233,-146.60226253304577,12298.305861118059,8819.804138881942,10315.421176100526,31.12397491558123,785.70109013686,69667040.0,-4.630346761306272,0.024831175398489114,8.076863115368942,8.076863115368942,10690.425,10723.349999999999,10541.215818679677,9424.8,10651.4,0,1114.0,2.8392489108027577,975414774.820654
2019-07-29,9580.9,9728.5,9835.4,9502.5,510900.0,19345.5,0.1,9600.266666666665,42.84824695700855,-134.8734135026415,11941.607189723869,8880.44281027613,10245.466778376667,24.03762662807522,753.3581551270843,69156140.0,-11.663393540416195,-0.015101050597257304,7.863125125270949,7.863125125270949,10622.475,10723.349999999999,10424.526553185302,9424.8,10651.4,0,1115.0,2.839599640521097,979032611.677894
2019-07-30,9580.7,9580.0,9703.0,9483.0,511510.0,19345.5,0.1,9629.8,42.8465639938571,-119.09216319627077,11640.573798850139,8928.486201149859,10182.15565662651,24.02797877472264,715.2611440465782,68644630.0,1.654146507087699,-2.087486561797025e-05,7.465645976249942,7.465645976249942,10603.1,10723.349999999999,10317.172428930478,9424.8,10651.4,0,1116.0,2.8399497795893995,982659117.4459774
2019-07-31,10082.0,9580.3,10100.0,9562.4,589840.0,19345.5,0.1,9747.866666666667,48.3252034003488,-69.32223196217578,11489.347571398888,8953.68242860111,10172.617022662082,39.22445513727708,702.5710623289655,69234470.0,3.6901431627447674,0.05232394292692599,6.968568362715388,6.968568362715388,10510.55,10726.7,10218.40663461604,9424.8,10651.4,0,1117.0,2.8403149502721385,986419133.0815299
2019-08-01,10380.0,10081.9,10459.0,9890.6,608370.0,19345.5,0.1,10014.233333333332,51.31297148784716,-13.674007694000693,11210.068023937756,9094.751976062244,10192.367782408552,56.09397112935181,692.9874150197536,69842840.0,-2.5480218562818,0.029557627454870117,6.676179335450421,6.676179335450421,10516.275,10822.15,9082.6,9424.8,10651.4,0,1118.0,2.8406884397973764,990260239.7922664
2019-08-02,10520.1,10380.5,10664.8,10330.5,578290.0,19345.5,0.1,10327.366666666667,52.69767610552992,32.695801608699384,11029.145740920248,9191.194259079752,10223.580374560117,64.02490801018963,667.3668853754854,70421130.0,-0.4862129309937061,0.013497109826589693,6.343731384449629,6.343731384449629,10567.725,10867.8,9110.128,9424.8,10651.4,0,1119.0,2.8410654272466904,994144445.4943827
2019-08-03,10815.7,10519.9,10893.6,10504.5,508750.0,19345.5,0.1,10571.933333333332,55.5689922488808,80.6684245157843,11109.796641115052,9172.10335888495,10279.972719840105,94.82220006646729,647.4906792772364,70929880.0,-0.10160067241172287,0.028098592218705143,5.986581351898041,5.986581351898041,10624.925,10979.2,9172.31488,9424.8,10651.4,0,1120.0,2.841450283957937,998107495.613541
2019-08-04,10934.6,10816.1,11017.7,10568.8,585710.0,19345.5,0.1,10756.8,56.707339898360985,115.67041492105011,11127.815812373025,9162.954187626976,10342.318175093429,94.89745793933437,633.305630757434,71515590.0,2.055178078100507,0.010993278289893382,5.7917585531929285,5.7917585531929285,10655.95,11041.5,9275.5919872,9424.8,10651.4,0,1121.0,2.841837869762598,1002108477.372045
2019-08-05,11816.8,10934.8,11922.3,10934.8,769630.0,19345.5,0.1,11189.033333333331,64.06410795043948,189.15618850069376,11432.38841489132,9097.58158510868,10482.74501556072,95.83530712142743,658.61951427476,72285220.0,13.48667466986794,0.0806796773544527,5.573586032384064,5.573586032384064,10629.400000000001,11256.05,9414.960628224,9424.8,10651.4,0,1122.0,2.8422485587736146,1006313852.6812036
2019-08-06,11480.9,11817.6,12291.9,11237.0,807580.0,19345.5,0.1,11410.766666666665,59.890978701257296,204.74318462648057,11605.435088288792,9100.304911711206,10577.807395031128,72.06145790271462,686.9252632551343,71477640.0,16.101206427538493,-0.02842563130458331,5.983200474310675,5.983200474310675,10787.35,11350.45,9665.6945654016,11480.9,10651.4,0,1123.0,2.842649797287574,1010459475.3319817
2019-08-07,12013.9,11481.0,12114.5,11406.4,702850.0,19345.5,0.1,11770.533333333331,63.908464085031774,238.20776959482157,11864.717735811802,8977.2722641882,10714.578119313877,90.42303982361858,688.4377444511962,72180490.0,22.53705006986731,0.046424931843322303,5.730343555807824,5.730343555807824,10787.35,11444.8,9980.839217553408,11480.9,10651.4,0,1124.0,2.843064271578828,1014730997.1375307
2019-08-08,12191.6,12015.9,12236.6,11727.0,592150.0,19345.5,0.1,11895.466666666665,65.16136930808523,257.9060724157786,12139.243463874544,8864.756536125456,10855.246869855413,96.5447154471545,675.6636198475393,72772640.0,22.586548419856626,0.014791200193109644,5.542042224544271,5.542042224544271,10807.2,11446.25,10258.166511447,11480.9,12191.6,0,1125.0,2.8434825900209995,1019052314.1916175
2019-08-09,12089.8,12190.0,12225.3,11885.0,558720.0,19345.5,0.1,12098.433333333332,63.795072590795876,249.5184615550764,12339.344306105724,8790.965693894277,10972.823358440612,93.03775664875292,651.7090755727149,72213920.0,22.976299460889017,-0.008350011483316488,5.390569534423357,5.390569534423357,10889.25,11486.9,10502.21453007336,11480.9,12191.6,0,1126.0,2.84389770456677,1023365453.2247647
2019-08-10,11314.5,12090.5,12185.0,11281.6,570740.0,19345.5,0.1,11865.299999999997,54.43388692412476,180.41693690698835,12398.48893993301,8791.83106006699,11005.363990970076,66.18929016189291,669.6869987460924,71643180.0,19.19912348163209,-0.06412843884927788,5.918838647276436,5.918838647276436,10999.225,11506.2,10716.976786464556,11480.9,12191.6,0,1127.0,2.8442919481869566,1027523009.1962487
2019-08-11,11517.2,11314.6,11728.4,11146.1,435830.0,19345.5,0.1,11640.5,56.24177711014635,138.8859919477157,12495.157928373159,8805.632071626842,11054.110277544354,72.41980846594755,663.4450702642287,72079010.0,18.394703838483537,0.017915064739935538,5.7604719051872735,5.7604719051872735,11042.725,11506.2,10905.96757208881,11480.9,12191.6,0,1128.0,2.8446909889034604,1031737548.9759498
2019-08-12,11394.2,11505.1,11508.6,11267.3,391080.0,19345.5,0.1,11408.633333333331,54.82040321379824,95.7109105930935,12562.814055429488,8888.525944570512,11086.499774921082,68.04087009149492,633.9061366739268,71687930.0,18.926196912607388,-0.010679679088667404,5.563410653437071,5.563410653437071,11135.425,11506.2,11072.279463438153,11480.9,12191.6,0,1129.0,2.8450861288264337,1035936601.2168196
2019-08-13,10892.9,11395.0,11445.6,10793.2,540780.0,19345.5,0.1,11268.099999999999,49.346660905392596,29.408258758337922,12568.690623927094,8991.509376072907,11068.061701119073,48.74519142700128,635.2271269115034,71147150.0,13.696285240118142,-0.04399606817503654,5.8315703523534,5.8315703523534,11191.525,11506.2,12291.9,11480.9,12191.6,0,1130.0,2.8454669259222953,1040031798.735764
2019-08-14,10049.4,10894.2,10894.5,9965.5,745590.0,19345.5,0.1,10778.833333333334,41.78621776859395,-69.82004355754768,12564.730284157755,9005.879715842246,10971.046301012495,6.613084579186245,656.2109035606818,70401560.0,-0.32334854195596474,-0.0774357609084817,6.5298515688566665,6.5298515688566665,10984.6,11506.2,12261.926,11480.9,12191.6,0,1131.0,2.845822542781873,1043930049.6082128
2019-08-15,10303.4,10053.3,10448.2,9580.1,930050.0,19345.5,0.1,10415.233333333332,44.54165002102946,-114.2847741024645,12549.163375481907,9068.686624518092,10907.460939011306,26.672320967622962,671.3458390206331,71331610.0,-0.7379576107899842,0.025275140804426055,6.51576993051452,6.51576993051452,10874.425,11506.2,12170.068959999999,11480.9,12191.6,0,1132.0,2.8461851819933304,1047902517.4152389
2019-08-16,10335.6,10300.9,10734.0,9788.6,798670.0,19345.5,0.1,10229.466666666665,44.89772404820683,-135.98812387552402,12500.134983255331,9202.06501674467,10852.9979924388,27.85972416844901,690.921136233445,72130280.0,-1.7537856104029428,0.0031251819787643242,6.684867218482188,6.684867218482188,10874.425,11506.2,12014.6708224,11480.9,12191.6,0,1133.0,2.846548180573736,1051893123.9700872
2019-08-17,10218.1,10335.5,10460.7,10016.3,497770.0,19345.5,0.1,10285.699999999999,43.792774393753845,-151.53091551544185,12470.823342850521,9280.406657149479,10792.531516968438,23.526808761708097,673.3124836453419,71632510.0,-5.5253011825402,-0.01136847401215213,6.589409808529393,6.589409808529393,10871.6,11252.3,11868.596573056,11480.9,12191.6,0,1134.0,2.8469071051429085,1055864011.2508876
2019-08-18,10312.7,10219.3,10494.9,10086.7,441110.0,19345.5,0.1,10288.8,44.96707348656129,-148.5165137425989,12418.010969539206,9406.399030460794,10746.833277257158,27.015266612582067,654.3758776706745,72073620.0,-5.68745084410952,0.009258081247981664,6.345339995061182,6.345339995061182,10861.525,11108.5,11731.28677867264,11480.9,12191.6,0,1135.0,2.8472682483041516,1059868907.571508
2019-08-19,10910.7,10312.8,10923.9,10267.8,519010.0,19345.5,0.1,10480.499999999998,51.819613592901696,-101.56453143078076,12355.36107829258,9602.04892170742,10762.439631804094,49.06704034220815,654.4990292656264,72592630.0,-7.667896554058616,0.057986754196282186,5.998689628214747,5.998689628214747,10747.375,11108.5,11602.215571952282,11480.9,12191.6,0,1136.0,2.84764596087479,1064031883.602781
2019-08-20,10752.6,10911.2,10941.6,10581.0,515470.0,19345.5,0.1,10658.666666666666,50.04538970312822,-77.55567484779056,12331.361088400918,9693.10891159908,10761.502524013227,44.13702239789196,633.5062414609389,72077160.0,-6.343579336114759,-0.01449036267150594,5.89165635716886,5.89165635716886,10692.425,11108.5,11480.888637635144,11480.9,12191.6,0,1137.0,2.8480186274313857,1068167475.1147459
2019-08-21,10141.5,10753.3,10797.8,9908.0,717650.0,19345.5,0.1,10601.599999999999,43.80259328126046,-97.91834556277928,12346.12443133885,9654.495568661152,10702.454664583396,21.13306982872199,651.8129384994432,71359510.0,-15.58528038355571,-0.05683276602868148,6.427184721189599,6.427184721189599,10676.675,11108.5,11366.841319377036,11480.9,12191.6,0,1138.0,2.848372894155235,1072159135.004148
2019-08-22,10105.0,10141.1,10218.2,9777.0,520750.0,19345.5,0.1,10333.033333333333,43.45392744431637,-108.13197977619734,12366.526187119583,9592.583812880417,10645.554220337359,19.843490095266894,636.7691571780545,70838760.0,-17.115062830145348,-0.003599073115416851,6.301525553469118,6.301525553469118,10553.675,11108.5,11259.636840214414,11480.9,12191.6,0,1139.0,2.8487254819299013,1076151012.4025223
2019-08-23,10388.7,10104.9,10434.3,9921.4,436260.0,19345.5,0.1,10211.733333333332,46.98616535205012,-90.76810833806977,12367.572949791645,9548.837050208354,10621.091913638562,31.041498713962163,627.9213602367648,71275020.0,-14.070538801303567,0.028075210291934827,6.044272721676098,6.044272721676098,10574.150000000001,11108.5,11158.86462980155,11480.9,12191.6,0,1140.0,2.8490859073342767,1080226354.300847
2019-08-24,10131.0,10389.4,10415.9,9917.5,463850.0,19345.5,0.1,10208.233333333332,44.28034908692074,-91.37343776732261,12372.879793957083,9463.170206042916,10574.416493292032,25.64353209514499,618.6698345055673,70811170.0,-10.460029166114278,-0.024805798608103058,6.106700567619853,6.106700567619853,10623.375,11108.5,11064.138752013458,11480.9,12191.6,0,1141.0,2.8494381105207056,1084244789.5908136
2019-08-25,10136.3,10132.1,10307.0,9935.2,422530.0,19345.5,0.1,10218.666666666666,44.351327982859566,-86.21747767837654,12265.440241155706,9402.559758844294,10532.691112978506,28.8410681877106,601.0362748980268,71233700.0,-11.989893376862444,0.0005231467772184306,5.9295430768429,5.9295430768429,10643.224999999999,11108.5,10975.096426892651,11480.9,12191.6,0,1142.0,2.8497898927716645,1088274408.57364
2019-08-26,10371.8,10136.0,10568.2,10136.0,568770.0,19345.5,0.1,10213.033333333331,47.54858664913599,-62.833403599371906,12191.255154950373,9365.83484504963,10517.368149837695,42.43902439024384,588.9765409767393,71802470.0,-8.97298625616543,0.02323332971597125,5.678633804901168,5.678633804901168,10647.65,11108.5,10891.396641279092,11480.9,12191.6,0,1143.0,2.8501480724076864,1092375626.2033184
2019-08-27,10184.8,10372.2,10387.6,10060.2,419810.0,19345.5,0.1,10230.966666666665,45.321864081133285,-56.06988553849206,12001.464430518145,9372.715569481856,10485.694992710296,44.41424899008439,570.2925023355436,71382660.0,-6.500564587942609,-0.018029657340095206,5.59944723838999,5.59944723838999,10647.65,11108.5,10812.718842802347,11480.9,12191.6,0,1144.0,2.850500142215453,1096437921.767501
2019-08-28,9729.4,10184.7,10271.3,9629.6,580290.0,19345.5,0.1,10095.333333333332,40.36436414780919,-77.07923114677644,11746.215092695142,9381.744907304857,10413.666898166459,10.965846492838727,575.3930378830047,70802370.0,-3.1842697076442374,-0.0447136909904956,5.913962195849741,5.913962195849741,10610.8,11108.5,10738.761712234207,11480.9,12191.6,0,1145.0,2.8508377460881924,1100386163.4064205
2019-08-29,9491.0,9729.1,9729.1,9343.0,509130.0,19345.5,0.1,9801.733333333332,38.019797104067834,-100.37061283228593,11480.354523267208,9387.72547673279,10325.793860245843,9.258100838233451,561.8935351770758,70293240.0,-7.88477589921773,-0.024503052603449316,5.920277475261572,5.920277475261572,10443.925,11108.5,10669.242009500154,9491.0,12191.6,0,1146.0,2.8511672552957505,1104276060.3490634
2019-08-30,9585.4,9494.1,9675.7,9370.2,413920.0,19345.5,0.1,9601.933333333332,39.51790062445141,-102.40407435742773,11374.167788234772,9321.002211765226,10255.280159270049,15.163267859376928,543.5797112358562,70707160.0,-7.258407833120484,0.00994626488252015,5.670913172489997,5.670913172489997,10386.525000000001,11108.5,10563.142648740142,9491.0,12191.6,0,1147.0,2.851499209031715,1108201615.3710465
2019-08-31,9594.4,9585.5,9677.5,9457.3,311490.0,19345.5,0.1,9556.933333333332,39.667625667439424,-96.22351483746891,11177.057392905303,9325.8326070947,10192.33919172052,15.726260477918153,520.481160433295,71018650.0,-6.103874497215732,0.0009389279529283812,5.424843246407228,5.424843246407228,10386.525000000001,10687.25,10465.53123684093,9491.0,12191.6,0,1148.0,2.851830887225186,1112138575.419553
2019-09-01,9729.3,9594.7,9799.5,9533.6,322660.0,19345.5,0.1,9636.366666666665,41.98585095568456,-76.96460447242828,10957.116132424655,9379.283867575346,10148.240221080472,24.164894282497134,502.2967918309168,71341310.0,-5.6571024077108945,0.014060285166346942,5.16272282518698,5.16272282518698,10372.7,10687.25,10375.728737893656,9491.0,12191.6,0,1149.0,2.8521662392155287,1116122717.7793698
2019-09-02,10348.8,9728.8,10431.5,9720.3,542790.0,19345.5,0.1,9890.833333333332,51.249791227819316,-19.416563284652966,10862.738354593494,9419.251645406504,10167.341152406141,62.91755285875135,517.2184495572799,71884100.0,-5.149990376419491,0.0636736455860134,4.9978591677999376,4.9978591677999376,10372.7,10687.25,9343.0,9491.0,12191.6,0,1150.0,2.852519739414625,1120285983.770531
2019-09-03,10612.3,10348.1,10756.8,10283.5,578790.0,19345.5,0.1,10230.133333333331,54.57258819987189,36.438765862592504,10917.800575694937,9420.479424305066,10209.718185510319,87.24910640637887,514.0814174460455,72462890.0,-1.3048006993657448,0.0254618893011751,4.844203588722949,4.844203588722949,10417.025,10687.25,9364.77,9491.0,10612.3,0,1151.0,2.852880279607474,1124528949.161746
2019-09-04,10568.2,10611.6,10783.6,10388.6,504450.0,19345.5,0.1,10509.766666666665,53.91030796792587,68.59174253714275,10949.215115523459,9415.544884476543,10243.859310699812,85.04789670970432,505.5756019141851,71958440.0,4.207464379036638,-0.004155555346154749,4.783932948980763,4.783932948980763,10413.65,10687.25,9420.4512,9491.0,10612.3,0,1152.0,2.8532389731367176,1128771028.4938877
2019-09-05,10566.9,10567.8,10630.7,10469.9,402090.0,19345.5,0.1,10582.466666666665,53.88954634903758,86.77809326059952,10976.490174350896,9411.399825649103,10274.625090633164,84.95765653200051,480.9487732060291,71556350.0,4.571004453240966,-0.00012301054105723352,4.551465171488602,4.551465171488602,10299.5,10687.25,9502.240128,9491.0,10612.3,0,1153.0,2.8535970461223874,1133023359.3914526
2019-09-06,10309.3,10566.7,10896.2,10227.4,643020.0,19345.5,0.1,10481.466666666665,49.79712047366534,78.70282279556363,10982.621342069133,9414.38865793087,10277.927462953816,62.2134947205768,494.3667179770271,70913330.0,-0.7642919710839802,-0.024378010580208054,4.795347094148266,4.795347094148266,10272.7,10687.25,9579.12172032,9491.0,10612.3,0,1154.0,2.8539470646707357,1137217346.5935066
2019-09-07,10461.1,10306.9,10556.4,10302.3,393570.0,19345.5,0.1,10445.766666666665,52.10532415221837,80.53816787711422,10997.001064294625,9414.848935705373,10295.372466482024,71.98686582539273,477.2048095500967,71306900.0,3.2583160596189953,0.014724569078405025,4.561707751097845,4.561707751097845,10263.75,10817.45,9684.4879826944,9491.0,10612.3,0,1155.0,2.854300932260276,1141462451.304243
2019-09-08,10402.8,10461.6,10578.0,10266.3,339730.0,19345.5,0.1,10391.066666666664,51.132962280910185,74.89742901691687,10909.661063938353,9451.398936061649,10305.603660150402,68.2333247489054,465.3830374393755,70967170.0,2.629164488028176,-0.005573027693072552,4.473632458947356,4.473632458947356,10159.525,10817.45,9781.424944078848,9491.0,10612.3,0,1156.0,2.8546525306434365,1145702257.496559
2019-09-09,10309.0,10402.1,10478.0,10095.7,473760.0,19345.5,0.1,10390.966666666665,49.53139443744237,62.43028897332967,10842.098776964078,9474.601223035923,10305.927121088458,62.19417975791911,459.44853476513435,70493410.0,-0.6054879577315343,-0.009016803168377718,4.456771120042045,4.456771120042045,10178.6,10817.45,9870.60694855254,9491.0,10612.3,0,1157.0,2.855000813278862,1149926821.593443
2019-09-10,10105.4,10308.7,10379.8,9970.7,383220.0,19345.5,0.1,10272.4,46.15232156674987,39.18857025531889,10840.65267712391,9472.43732287609,10286.829300032414,49.08575843420032,455.85221085333893,70110190.0,-0.7795931191579574,-0.019749733242797607,4.5109764170971856,4.5109764170971856,10225.275,10817.45,9952.654392668337,9491.0,10612.3,0,1158.0,2.85534249132011,1154105056.163863
2019-09-11,10162.5,10104.9,10257.5,9908.9,413060.0,19345.5,0.1,10192.299999999997,47.23942174659387,26.959869941393706,10843.120202135317,9475.719797864684,10274.988414315041,52.76203966005663,448.19133864952903,70523250.0,4.451456410467248,0.005650444316899872,4.410246874780113,4.410246874780113,10272.425,10817.45,10896.2,9491.0,10612.3,0,1159.0,2.855685306050465,1158309096.9525387
2019-09-12,10415.1,10162.4,10447.9,10051.0,413220.0,19345.5,0.1,10227.666666666666,51.86868843761737,34.68987116228749,10846.305157807683,9475.174842192317,10288.332374856465,68.47313237221492,444.5276716031341,70936470.0,9.736592561373937,0.024856088560885725,4.268107570768731,4.268107570768731,10272.425,10817.45,10876.454000000002,9491.0,10612.3,0,1160.0,2.8560349731400314,1162593038.8838918
2019-09-13,10342.1,10415.2,10441.4,10174.1,365520.0,19345.5,0.1,10306.566666666666,50.48995028161115,33.666283831233486,10861.190173124058,9481.399826875942,10293.453101060612,61.49141705469458,431.86855220291017,70570950.0,7.89429757756589,-0.007009054161745909,4.1758303652344315,4.1758303652344315,10272.425,10817.45,10857.102920000001,9491.0,10612.3,0,1161.0,2.8563819418698477,1166867218.6478198
2019-09-14,10337.3,10342.2,10421.4,10253.7,326440.0,19345.5,0.1,10364.833333333334,50.39509361800362,31.485407321824724,10874.755370487688,9487.93462951231,10297.628996197696,58.98282694848074,412.9993699027022,70244510.0,7.743058450762942,-0.0004641223735992739,3.9952344413212564,3.9952344413212564,10272.425,10817.45,10838.1388616,9491.0,10612.3,0,1162.0,2.856728199665043,1171150298.9804945
2019-09-15,10311.5,10337.3,10360.4,10272.0,255790.0,19345.5,0.1,10330.299999999997,49.852946830350014,27.28155697389294,10868.920344849876,9487.73965515012,10298.950044178868,50.276384046262436,389.81370062393773,69988720.0,5.983986514959974,-0.00249581612219818,3.7803782245448065,3.7803782245448065,10181.525000000001,10817.45,10819.554084368001,9491.0,10612.3,0,1163.0,2.8570731330854127,1175436409.941551
2019-09-16,10255.5,10311.3,10360.5,10108.5,372530.0,19345.5,0.1,10301.433333333332,48.630059521109615,20.040644963131285,10873.274942870272,9490.455057129728,10294.811944733261,35.105844221614504,379.96986486508507,69616190.0,-0.9015538033395106,-0.005430829656209113,3.70503500429121,3.70503500429121,10181.525000000001,10817.45,10801.341002680641,9491.0,10612.3,0,1164.0,2.8574158543383743,1179716968.1746342
2019-09-17,10195.7,10254.6,10273.6,10153.5,321640.0,19345.5,0.1,10254.233333333332,47.295872578550956,10.987558306232224,10864.700066715088,9545.659933284913,10285.372711901522,29.04892130051664,361.4077316604362,69294550.0,-3.925633463057005,-0.005831017502803348,3.544707392924823,3.544707392924823,10156.525000000001,10817.45,10783.49218262703,9491.0,10612.3,0,1165.0,2.8577562446881624,1183990655.7537491
2019-09-18,10164.7,10195.7,10257.5,10119.3,318820.0,19345.5,0.1,10205.299999999997,46.58239732665531,3.086119300874344,10812.227985463725,9665.502014536274,10273.880072672806,25.90904486984714,345.4643222561194,68975730.0,-3.818057947427187,-0.003040497464617431,3.398667174202085,3.398667174202085,10149.0,10817.45,10766.000338974489,9491.0,10612.3,0,1166.0,2.858095152516161,1188265465.406394
2019-09-19,10250.5,10164.6,10297.6,9707.6,542250.0,19345.5,0.1,10203.633333333331,48.880920939706584,3.7675864653118225,10760.94032118139,9783.299678818608,10271.65339908492,45.67558472152107,362.9311563806823,69517980.0,-2.9942556473516326,0.008440977107046832,3.5406190564429276,3.5406190564429276,10098.675,10817.45,10748.858332195,9491.0,10612.3,0,1167.0,2.8584360328037217,1192574740.4227993
2019-09-20,10172.7,10251.5,10279.5,10088.6,362070.0,19345.5,0.1,10195.966666666667,46.90983537409978,-0.6562275886100295,10682.763941920675,9919.306058079324,10262.229265838738,53.43520220588242,350.643216639205,69155910.0,-1.3250172174638293,-0.007589873664699209,3.446904132031859,3.446904132031859,10098.675,10817.45,10707.207998907199,9491.0,10612.3,0,1168.0,2.8587740522484113,1196871787.4638302
2019-09-21,9993.0,10172.8,10177.9,9939.8,326170.0,19345.5,0.1,10138.733333333332,42.6335135011237,-14.549553629357348,10628.2622557553,10000.177744244698,10236.588383377906,32.7895220588235,342.60441545069034,68829740.0,-4.47467283555267,-0.017664926715621254,3.4284440653526502,3.4284440653526502,10097.05,10817.45,10667.223678950912,9491.0,10612.3,0,1169.0,2.8591061389873262,1201126407.2092466
2019-09-22,10031.6,9993.0,10075.0,9870.9,337060.0,19345.5,0.1,10065.766666666665,43.81826037467184,-19.685317832633814,10635.037943441323,9961.682056558679,10217.065680199057,42.05607476635516,332.7112429184982,69166800.0,-3.5682700811319927,0.003862703892725028,3.316631872467983,3.316631872467983,10092.05,10817.45,10628.838731792875,9491.0,10612.3,0,1170.0,2.8594388316987387,1205402013.0649621
2019-09-23,9702.2,10031.3,10048.8,9656.3,431100.0,19345.5,0.1,9908.933333333332,36.828364233300036,-42.50282015599741,10648.378579448654,9857.331420551345,10168.030853513432,5.798383021728327,336.98186842431977,68735700.0,-5.886118925210973,-0.032836237489533016,3.473252132756692,3.473252132756692,10064.0,10817.45,10591.98918252116,9491.0,10612.3,0,1171.0,2.859760912003555,1209588556.0996346
2019-09-24,8513.9,9702.7,9793.8,8069.4,933160.0,19345.5,0.1,9415.9,22.737342582582315,-129.9228811333329,10986.28700956224,9313.992990437762,10010.494581750248,18.688248896363255,436.0831635368683,67802540.0,-15.749005482217429,-0.12247737626517707,5.122014159631524,5.122014159631524,9348.875,10180.65,10535.84783156989,9491.0,10612.3,1,1172.0,2.8600431047225188,1213396569.4085188
2019-09-25,8432.4,8512.3,8729.8,8245.1,696110.0,19345.5,0.1,8882.833333333332,22.11243916670655,-182.3223594240165,11142.946391593654,8943.883608406348,9860.199859678796,15.261719571158293,439.55579471280623,67106430.0,-17.02435424354244,-0.00957258130821359,5.212700947687566,5.212700947687566,9333.15,10180.65,10338.532005044299,9491.0,10612.3,0,1173.0,2.860321891865238,1217182812.0668864
2019-09-26,8063.8,8432.5,8463.1,7773.6,731030.0,19345.5,0.1,8336.699999999999,19.501887750979307,-227.9312494550084,11319.73019210128,8542.549807898718,9689.114158757007,10.877876902316512,457.40895223332006,66375400.0,-22.575875411661915,-0.04371234761159326,5.672374714567822,5.672374714567822,9185.25,10032.75,10157.001444640755,9491.0,10612.3,0,1174.0,2.8605867214552374,1220842404.996628
2019-09-27,8184.9,8063.8,8257.4,7882.1,561400.0,19345.5,0.1,8227.033333333333,22.72951043834648,-235.12202554506788,11376.198552636772,8258.461447363225,9545.855667446816,15.533650577838182,451.54402707379717,66936800.0,-20.85843300683614,0.015017733574741454,5.5167934498136475,5.5167934498136475,9185.25,10005.1,9918.66130017668,9491.0,10612.3,0,1175.0,2.860855541335503,1224552556.733315
2019-09-28,8208.5,8184.5,8297.2,8031.1,457790.0,19345.5,0.1,8152.399999999999,23.374308927478012,-223.54245130037583,11390.182505064764,8025.047494935235,9418.48846102331,16.811627817078346,438.2980251399545,67394590.0,-20.59338511990558,0.00288335837945497,5.339562954741481,5.339562954741481,9180.725,10005.1,9704.155170159012,9491.0,10612.3,0,1176.0,2.861124729654391,1228277543.3372846
2019-09-29,8049.1,8208.0,8226.8,7922.1,418480.0,19345.5,0.1,8147.5,22.036732679322057,-211.97413953835303,11399.547573726952,7789.692426273045,9288.070512354423,10.649812516912135,428.7553090585291,66976110.0,-21.940551811084706,-0.019418895047816243,5.326748444652559,5.326748444652559,9155.325,9999.45,9511.099653143112,8049.1,10612.3,0,1177.0,2.8613875243689595,1231949786.6175807
2019-09-30,8284.3,8048.9,8318.5,7749.0,600260.0,19345.5,0.1,8180.633333333331,28.535127245912193,-175.35373481615352,11378.61378685859,7628.516213141412,9192.473320701622,21.003688299458496,438.8085012686342,67576370.0,-19.220905855394673,0.029220658210234562,5.296868791190978,5.296868791190978,9117.3,9967.0,9337.3496878288,8049.1,10612.3,0,1178.0,2.8616584844668784,1235714820.941675
2019-10-01,8302.7,8285.0,8486.2,8187.9,533950.0,19345.5,0.1,8212.033333333333,29.03347758555057,-138.3868685777037,11329.636144283806,7491.513855716196,9107.733004444324,21.725653299850926,428.7721797494461,68110320.0,-18.566650646841314,0.002221068768634815,5.164249939771954,5.164249939771954,9110.75,9738.7,9146.747725289344,8049.1,10612.3,0,1179.0,2.861929612407662,1239492937.1995132
2019-10-02,8364.1,8302.7,8374.0,8167.7,405860.0,19345.5,0.1,8317.033333333333,30.768406531592987,-100.08113997557979,11220.598542507545,7395.451457492454,9036.910813544866,24.13481911637763,412.8813097673428,68516180.0,-17.714246362411092,0.007395184698953283,4.936350710385371,4.936350710385371,8967.45,9628.8,8979.017998254623,8049.1,8364.1,0,1180.0,2.8622024548759493,1243299801.5972974
2019-10-03,8226.9,8363.6,8391.7,8090.1,460970.0,19345.5,0.1,8297.9,29.058873981952814,-75.39037084436961,11108.33448380689,7296.195516193109,8959.766926540593,18.885595732068747,404.9326447839612,68055210.0,-19.74147602555973,-0.016403438505039447,4.922056239700996,4.922056239700996,8701.45,9597.3,8831.415838464069,8049.1,8364.1,0,1181.0,2.8624698303976963,1247062876.5018525
2019-10-04,8148.1,8227.6,8233.6,8041.4,416920.0,19345.5,0.1,8246.366666666667,28.09341528793489,-56.62874398934008,10976.887479590494,7208.722520409507,8882.465314489109,16.43130635266995,389.7374558708212,67638290.0,-19.90228749496201,-0.009578334488081652,4.783169768054162,4.783169768054162,8615.55,9345.3,8701.52593784838,8049.1,8364.1,0,1182.0,2.862733821523809,1250802843.195243
2019-10-05,8127.3,8148.0,8185.1,8030.6,360920.0,19345.5,0.1,8167.433333333332,27.830570825896615,-38.73641126451378,10825.185609744703,7142.004390255299,8810.54480834729,16.263972484952713,372.9347804514768,67277370.0,-18.670069048333833,-0.0025527423571140018,4.588667582733217,4.588667582733217,8608.025000000001,9345.3,8587.222825306575,8049.1,8364.1,0,1183.0,2.8629965537712647,1254541079.0124068
2019-10-06,7881.9,8127.3,8145.5,7834.9,448800.0,19345.5,0.1,8052.433333333332,24.873710718788246,-36.57204008318956,10668.886760615966,7060.943239384036,8722.102445647548,5.778763370727876,368.48229613351424,66828570.0,-21.42928346425297,-0.030194529548558613,4.675044039299081,4.675044039299081,8608.025000000001,9345.3,8486.636086269786,8049.1,8364.1,0,1184.0,2.863249596629722,1258191344.819398
2019-10-07,8198.6,7882.6,8293.5,7797.0,604740.0,19345.5,0.1,8069.2666666666655,34.539671575691614,-8.423846500840455,10482.333251873408,7047.786748126596,8672.245069871591,21.98748043818469,377.6264178382632,67433310.0,-15.497516027292782,0.04018066709803492,4.60598660549683,4.60598660549683,8608.025000000001,9345.3,8398.11975591741,8049.1,8364.1,0,1185.0,2.8635139740312847,1261968278.3944528
2019-10-08,8182.9,8198.5,8323.1,8118.1,469040.0,19345.5,0.1,8087.799999999999,34.304039380886394,13.341136949059546,10273.992305939773,7057.94769406023,8625.64077750287,44.23939641109298,365.2959594212444,66964270.0,-3.8877600159738783,-0.0019149610909180437,4.464138134661848,4.464138134661848,8606.400000000001,9345.3,7749.0,8049.1,8364.1,0,1186.0,2.863777285164104,1265745466.5724924
2019-10-09,8566.7,8180.1,8655.9,8122.7,636430.0,19345.5,0.1,8316.066666666666,44.30657980853149,55.42904109931192,10016.076954748165,7147.483045251836,8620.027370121643,90.16429595324745,377.2891051768698,67600700.0,1.5926663820502003,0.046902687311344504,4.404135842002986,4.404135842002986,8655.825,9345.3,7760.482,8049.1,8364.1,0,1187.0,2.8640538459264695,1269670481.033316
2019-10-10,8562.3,8566.8,8638.5,8438.7,511460.0,19345.5,0.1,8437.3,44.22345002342597,83.14828965080181,9736.227399407715,7266.2926005922845,8614.529525348153,89.67912669533571,364.61131194995045,67089240.0,6.181948957067377,-0.0005136166785344454,4.258333764875681,4.258333764875681,8640.6,9345.3,7796.29872,8049.1,8364.1,0,1188.0,2.8643297507173746,1273600768.1894464
2019-10-11,8267.8,8562.2,8751.1,8249.7,667860.0,19345.5,0.1,8465.6,38.955148730938404,81.70543838235864,9445.157461750317,7384.8425382496835,8581.507665791185,51.77128031134608,374.3819325249539,66421380.0,1.0128407188847712,-0.034394963969961334,4.528192899259222,4.528192899259222,8664.4,9322.6,7830.6827711999995,8049.1,8364.1,0,1189.0,2.86459466868784,1277429090.5730927
2019-10-12,8304.4,8267.6,8394.8,8260.9,424020.0,19345.5,0.1,8378.166666666666,39.91317563458866,83.00378982687317,9043.594234619148,7613.68576538085,8555.116459525358,55.42361041812189,357.20465163031434,66845400.0,1.1683011512456554,0.004426812453131479,4.3013902464996185,4.3013902464996185,8648.675,9322.6,7885.907804928,8049.1,8364.1,0,1190.0,2.864860418341855,1281277456.0784914
2019-10-13,8281.5,8304.3,8450.2,8190.6,419870.0,19345.5,0.1,8284.566666666666,39.4955226293989,81.96587887369702,8595.372218509807,7919.837781490193,8529.05774909437,53.138409340385174,350.2328907995776,66425530.0,2.8872793231541367,-0.0027575742979625284,4.229099689664646,4.229099689664646,8648.675,9322.6,7937.819336632319,8049.1,8364.1,0,1191.0,2.8651248494746,1285123528.001559
2019-10-14,8353.3,8281.3,8374.3,8222.2,505020.0,19345.5,0.1,8313.066666666666,41.56033544558537,85.37476886339067,8569.766897929743,7929.383102070257,8512.318915847287,58.306257205743535,336.0805414567505,66930550.0,0.8329007882379924,0.008669926945601647,4.0233266069308,4.0233266069308,8648.675,9322.6,7986.616176434381,8049.1,8364.1,0,1192.0,2.8653913741066424,1289002946.47499
2019-10-15,8167.2,8353.4,8400.2,8139.5,469730.0,19345.5,0.1,8267.333333333332,37.9457163278167,74.7389660226869,8546.946088431036,7925.683911568961,8479.450447671356,38.80096425951155,330.6962170669826,66460820.0,-1.6319992291664265,-0.022278620425460582,4.049077003954631,4.049077003954631,8644.15,9322.6,8032.4852058483175,8049.1,8364.1,0,1193.0,2.8656506649435927,1292817970.2240272
2019-10-16,8000.4,8167.1,8185.9,7929.8,538920.0,19345.5,0.1,8173.633333333332,35.006905846605676,56.9191038565213,8551.940184875573,7914.349815124427,8433.826595512179,21.31852007127131,325.36791584791246,65921900.0,-4.348345906911691,-0.020423156038789303,4.06689560331874,4.06689560331874,8651.95,9322.6,8751.1,8049.1,8364.1,0,1194.0,2.865903297805863,1296574016.7186534
2019-10-17,8073.3,8000.4,8118.2,7944.4,444950.0,19345.5,0.1,8080.299999999999,37.29273033633471,50.69792297004386,8553.372294423945,7901.757705576056,8399.490729272924,28.959228592390744,314.54163614449016,66366850.0,-1.8670459103672032,0.009112044397780128,3.89607268582228,3.89607268582228,8626.225,9322.6,8734.674,8049.1,8364.1,0,1195.0,2.866158164033333,1300364440.924105
2019-10-18,7948.5,8073.3,8116.4,7842.0,505790.0,19345.5,0.1,8007.399999999999,35.02188809295306,39.340392429625524,8562.382700958204,7866.747299041795,8356.53923124693,15.878838696153437,311.6743764198837,65861060.0,-2.44965083884587,-0.01545836275129131,3.9211722516183394,3.9211722516183394,8597.724999999999,9322.6,8718.57652,8049.1,8364.1,0,1196.0,2.8664078917026825,1304111362.4293876
2019-10-19,7957.3,7948.3,8060.2,7892.4,428830.0,19345.5,0.1,7993.033333333333,35.320962398603456,33.79525312605563,8568.658988351657,7851.2910116483445,8318.51644731865,16.801173881144546,301.3976352470349,66289890.0,-2.091715575898515,0.0011071271309053277,3.7876872211307213,3.7876872211307213,8533.974999999999,9322.6,8683.513459200001,8049.1,8364.1,0,1197.0,2.866657473818712,1307867398.6876643
2019-10-20,8223.4,7957.4,8288.5,7889.6,513909.99999999994,19345.5,0.1,8043.066666666666,43.75174608637172,48.52715209254342,8564.069077111215,7849.790922888783,8309.457738050207,44.69133214547736,308.36208987224666,66803800.0,4.332711655819028,0.03344099129101563,3.749812606370196,3.749812606370196,8198.075,9322.6,8649.852920832001,8049.1,8364.1,0,1198.0,2.866916408118619,1311733802.8768826
2019-10-21,8208.2,8224.1,8315.3,8155.7,489400.0,19345.5,0.1,8129.633333333334,43.40371765515822,57.13352330050253,8556.641118221394,7847.768881778605,8299.814143950187,40.28159718402822,297.73622630994333,66314400.0,0.11709316224721737,-0.0018483838801467423,3.627302286858791,3.627302286858791,8198.075,9322.6,8617.538803998721,8049.1,8364.1,0,1199.0,2.8671743057291823,1315600425.3285384
2019-10-22,8031.4,8207.4,8289.1,8017.7,570390.0,19345.5,0.1,8154.333333333333,39.47076899124198,51.006218851070685,8539.280249215159,7831.85975078484,8274.250892145408,20.833791662083332,295.85506728780456,65744010.0,-1.8514218675530678,-0.02153943617358267,3.6837297020171396,3.6837297020171396,8185.575,9322.6,8586.517251838772,8049.1,8364.1,0,1200.0,2.8674252183506397,1319403417.1197507
2019-10-23,7477.0,8031.0,8055.0,7329.2,892080.0,19345.5,0.1,7905.533333333333,30.22271318189425,11.751532014639565,8616.647401555885,7679.5025984441145,8198.322235750607,10.394542513538232,326.56541962438996,64851930.0,-12.720183968155773,-0.06902906093582684,4.367599566997325,4.367599566997325,7952.425,9112.7,8556.736561765221,8049.1,8364.1,0,1201.0,2.8676543025199224,1322982546.2185917
2019-10-24,7422.7,7476.8,7501.5,7366.3,586490.0,19345.5,0.1,7643.7,29.493814622487974,-14.320531211994876,8677.076458592994,7546.533541407008,8124.453451393407,6.57570855897039,312.8964610797907,64265440.0,-13.309507959309993,-0.007262270964290551,4.215399532242859,4.215399532242859,7931.2,9112.7,8483.084368059308,7422.7,8364.1,0,1202.0,2.8678807546401752,1326542854.5828114
2019-10-25,8658.3,7422.8,8697.7,7404.9,1180000.0,19345.5,0.1,7852.666666666667,55.68469656688642,51.58780323229769,8751.865839268426,7524.844160731572,8175.29597983213,97.1209353306539,382.8895710026628,65445440.0,4.723142794939404,0.1664623385021622,4.4222257371847,4.4222257371847,8026.8,9112.7,7329.2,7422.7,8364.1,1,1203.0,2.868152688977355,1330604377.4071465
2019-10-26,9230.6,8658.4,10540.0,8061.8,1780000.0,19345.5,0.1,8437.199999999999,62.61228875718787,129.24480973141226,8969.76095991919,7441.819040080808,8275.801124610021,59.21888625887631,532.5546016453297,67225440.0,11.153123645296478,0.06609842578797243,5.769447291024741,5.769447291024741,8934.6,9112.7,7356.57,7422.7,8364.1,1,1204.0,2.868443218205921,1334879953.5838313
2019-10-27,9529.6,9230.6,9773.2,9081.0,1160000.0,19345.5,0.1,9139.5,65.63487460994526,192.45880507580478,9229.638418258304,7315.041581741696,8395.210541313829,68.53120717578174,543.9578443849491,68385440.0,15.070941254603639,0.032392260524776395,5.708086849237629,5.708086849237629,8934.6,9112.7,7404.9,7422.7,9529.6,0,1205.0,2.8687427413352844,1339267066.9017549
2019-10-28,9207.2,9530.1,9866.9,9202.5,1040000.0,19345.5,0.1,9322.466666666667,60.00207189491491,203.21146990043346,9362.362536505125,7284.747463494871,8472.542870712512,58.490095926248934,552.5608555003099,67345440.0,10.222307351585618,-0.03383143049026183,6.001399507997109,6.001399507997109,8934.6,8953.6,7530.304,7422.7,9529.6,0,1206.0,2.869031486941127,1343550792.1713493
2019-10-29,9411.3,9206.5,9531.3,9125.3,918480.0,19345.5,0.1,9382.699999999999,62.21295348772468,213.6555565967408,9504.556946045323,7227.013053954677,8561.948311597034,64.84676716083217,542.0922229645735,68263920.0,15.232882750514246,0.022167434181944445,5.76001426970316,5.76001426970316,8934.6,8953.6,7650.69184,7422.7,9529.6,0,1207.0,2.8693262568536806,1347914119.211914
2019-10-30,9157.9,9411.3,9411.3,9018.4,789730.0,19345.5,0.1,9258.8,57.93150164336363,193.67519078957105,9583.428526294098,7207.7014737059,8618.70561525446,56.95465304596984,531.435635609961,67474190.0,14.468026598670066,-0.026925079425796583,5.803029467563099,5.803029467563099,8934.6,8934.6,7766.2641664,7422.7,9529.6,0,1208.0,2.869612381796103,1352196483.3522036
2019-10-31,9152.6,9157.9,9378.9,8959.6,798930.0,19345.5,0.1,9240.599999999999,57.84184008413345,171.06450882130494,9670.47419434097,7209.135805659031,8669.55269951594,56.78958515011836,523.4259473521066,66675260.0,13.368758747971713,-0.0005787352995773043,5.718877120731887,5.718877120731887,8934.6,8934.6,7877.213599744,7422.7,9529.6,0,1209.0,2.8698978280241465,1356484858.675407
2019-11-01,9230.1,9153.1,9270.4,9057.2,689650.0,19345.5,0.1,9180.199999999999,58.844897301318376,152.88469689781988,9761.716824584624,7210.463175415376,8722.938156704897,59.20331381587145,501.26695111267037,67364910.0,16.123796942819403,0.008467539278456337,5.430785702350683,5.430785702350683,8943.875,8934.6,7983.72505575424,7422.7,9529.6,0,1210.0,2.870185279054998,1360808903.0130053
2019-11-02,9300.6,9230.3,9356.7,9201.2,570740.0,19345.5,0.1,9227.766666666665,59.78231516334759,137.63990546357985,9856.572203925653,7217.517796074348,8777.95357035205,61.39902827955651,476.5693117474797,67935650.0,16.881354228192983,0.007638053758897589,5.124070616384746,5.124070616384746,8953.525000000001,8934.6,8085.97605352407,7422.7,9529.6,0,1211.0,2.870474487654405,1365166129.033445
2019-11-03,9198.3,9300.5,9359.1,9095.0,536560.0,19345.5,0.1,9243.0,57.727542384444234,113.69248367507639,9926.407089582694,7232.182910417307,8817.986563651855,58.2129064407624,461.3929323369454,67399090.0,11.855193715494803,-0.010999290368363446,5.016067450908814,5.016067450908814,9117.75,8934.6,8184.137011383107,7422.7,9529.6,0,1212.0,2.8707598969368697,1369494894.818311
2019-11-04,9396.4,9198.7,9500.4,9134.1,681010.0,19345.5,0.1,9298.433333333332,60.55488127290704,104.4574832427865,10018.85852074866,7262.651479251342,8873.073557589774,64.38270835928739,454.6005800271636,68080100.0,14.475768134304706,0.021536588282617508,4.838029245531944,4.838029245531944,9173.925,8934.6,8278.371530927783,7422.7,9529.6,0,1213.0,2.8710511394222515,1373902435.0206835
2019-11-05,9310.8,9396.1,9452.7,9193.9,653420.0,19345.5,0.1,9301.833333333332,58.72706459583679,86.5849065134203,10080.967324667541,7331.582675332458,8914.761790200271,61.71670611685559,440.6148243109377,67426680.0,15.929974848718775,-0.009109871865821018,4.7322982376480835,4.7322982376480835,9173.925,8934.6,8368.836669690672,7422.7,9529.6,0,1214.0,2.871339150686422,1378287841.6724687
2019-11-06,9338.9,9311.2,9424.6,9262.7,578030.0,19345.5,0.1,9348.699999999999,59.16283358097983,71.29409816369264,10138.37674219284,7400.733257807156,8955.155905419293,62.15458297885747,420.7066225744421,68004710.0,24.901698542196062,0.0030180006014521865,4.50488411455784,4.50488411455784,9090.025000000001,8934.6,8455.683202903045,7422.7,9529.6,0,1215.0,2.871627550979955,1382691510.6485767
2019-11-07,9223.5,9339.2,9367.0,9130.0,603540.0,19345.5,0.1,9291.066666666666,56.52344255200278,49.10273322884868,10161.387701453432,7505.222298546566,8980.71248585555,58.00771905202386,407.584720961982,67401170.0,24.26071375644981,-0.01235691569670938,4.4189810913642535,4.4189810913642535,9082.3,8934.6,8539.055874786924,7422.7,9529.6,0,1216.0,2.8719117491364226,1387061743.6443582
2019-11-08,8778.2,9223.6,9254.8,8722.4,791790.0,19345.5,0.1,9113.533333333333,47.683413757282025,2.584178776890667,10140.91829819787,7607.781701802131,8961.425582440737,28.908078444031986,416.5000980361261,66609380.0,1.3847984015338053,-0.04827885293001566,4.744709599190335,4.744709599190335,9023.0,8934.6,8619.093639795447,7422.7,9529.6,0,1217.0,2.872180742865005,1391273649.0885828
2019-11-09,8804.5,8778.1,8877.5,8746.9,512020.0,19345.5,0.1,8935.4,48.198705783553,-26.653086885525227,10135.089661713317,7671.720338286685,8946.480288874953,7.173438182612526,396.07866246211705,67121400.0,-4.616167963079327,0.0029960584174431037,4.4985934744973255,4.4985934744973255,9023.0,8934.6,8695.92989420363,7422.7,9529.6,0,1218.0,2.8724501357912615,1395502748.7370243
2019-11-10,9036.8,8804.7,9092.9,8763.5,581570.0,19345.5,0.1,8873.166666666666,52.6362084800419,-30.31892322772549,10135.24592615107,7754.424073848932,8955.082166124957,27.470511140235878,391.31590085768005,67702970.0,-5.171255876427144,0.026384235334204087,4.33024854879692,4.33024854879692,9023.0,8934.6,10540.0,7422.7,9529.6,0,1219.0,2.8727267717461955,1399827029.9973242
2019-11-11,8736.9,9036.9,9066.4,8649.4,601160.0,19345.5,0.1,8859.4,47.03443099892718,-51.65957159919495,10099.875852131529,7860.344147868474,8934.302912208295,9.921759836716186,393.1504793678458,67101810.0,-5.107958988617614,-0.033186526203966005,4.499885306777528,4.499885306777528,9004.75,8934.6,10504.47,7422.7,9529.6,0,1220.0,2.8729928938878744,1404044531.964559
2019-11-12,8812.6,8737.4,8841.2,8615.7,575160.0,19345.5,0.1,8862.099999999999,48.52363176527842,-58.87208053797198,9935.5863911257,8158.193608874299,8922.712158664648,22.25613202215439,381.1754451272854,67676970.0,-6.361501599141446,0.008664400416623863,4.325346040070869,4.325346040070869,8996.325,8934.6,10430.2672,7422.7,9529.6,0,1221.0,2.873261089885617,1408298364.8592906
2019-11-13,8783.1,8813.2,8829.7,8721.1,454330.0,19345.5,0.1,8777.533333333333,47.95774545606026,-63.43069060468068,9622.44600423994,8607.37399576006,8909.415762601348,18.921668362156645,361.70577047533646,67222640.0,-4.092641326068196,-0.0033474797449106752,4.118201665418092,4.118201665418092,8984.400000000001,8934.6,10321.393168,7422.7,9529.6,0,1222.0,2.8735278033065805,1412547925.1117234
2019-11-14,8661.2,8782.9,8799.8,8615.8,515429.99999999994,19345.5,0.1,8752.3,45.591674290416044,-71.83909916265277,9622.070508539773,8608.039491460228,8885.776166163123,5.142986323047367,349.0125011556696,66707210.0,-5.368966195398025,-0.01387892657489953,4.029609074443144,4.029609074443144,8977.375,8934.6,10219.051577920001,7422.7,9529.6,0,1223.0,2.8737898854579624,1416756810.8354104
2019-11-15,8476.3,8660.8,8761.8,8437.1,653710.0,19345.5,0.1,8640.199999999999,42.191422328144036,-86.07648114307801,9652.062978138028,8502.617021861972,8846.77843605235,3.6866359447003605,347.27589393026454,66053500.0,-8.166758756676536,-0.02134808109730768,4.097022214058783,4.097022214058783,8918.325,8934.6,10122.850483244802,7422.7,9529.6,0,1224.0,2.874045087659874,1420898587.6525342
2019-11-16,8497.3,8476.2,8532.8,8450.7,471160.0,19345.5,0.1,8544.933333333332,42.71398840336535,-89.8847609570802,9613.969445362509,8437.480554637492,8813.494775475936,5.66161948650418,328.33475864953124,66524660.0,-8.637077177816495,0.0024774960772979693,3.8639892512860707,3.8639892512860707,8890.275000000001,8934.6,9987.990444585217,7422.7,9529.6,0,1225.0,2.8743005475078367,1425055319.9571748
2019-11-17,8509.8,8497.4,8631.7,8413.0,531220.0,19345.5,0.1,8494.466666666665,43.04402614874408,-87.29422984812985,9613.604504937455,8368.105495062544,8784.571463525846,8.901967997057136,320.50370446027904,67055880.0,-7.48507876455432,0.0014710555117507518,3.766289506924711,3.766289506924711,8843.775000000001,8934.6,9863.9192090184,7422.7,8509.8,0,1226.0,2.8745559671190586,1429223605.3913157
2019-11-18,8208.4,8510.3,8516.3,8110.4,692600.0,19345.5,0.1,8405.166666666666,37.44259632802217,-100.66225140435529,9609.267018679968,8252.15298132003,8729.697990809098,7.300901437830583,326.60343985597336,66363280.0,-12.64313992592908,-0.03541798867188417,3.9788928397248355,3.9788928397248355,8777.4,8934.6,9718.827288116561,7422.7,8509.8,0,1227.0,2.874800229294954,1433273849.2059739
2019-11-19,8145.7,8207.7,8245.6,8032.8,654270.0,19345.5,0.1,8287.966666666665,36.38192539426176,-107.8693048368802,9630.512699785824,8129.6873002141765,8674.079134541566,8.111797672079295,318.4746227234038,65709010.0,-12.51342526957941,-0.007638516641489179,3.909726883182585,3.909726883182585,8761.025000000001,8934.6,9525.816013542573,7422.7,8509.8,0,1228.0,2.87504175524695,1437303427.860612
2019-11-20,8099.3,8145.7,8223.0,8074.2,607270.0,19345.5,0.1,8151.133333333332,35.57869551418722,-109.55089327156143,9639.286765471905,8015.583234528094,8619.338264585225,4.984260230849948,306.3550068145892,65101740.0,-13.273511869706278,-0.005696256920829312,3.7824874595902016,3.7824874595902016,8861.7,8934.6,9316.793771646613,7422.7,8509.8,0,1229.0,2.8752811271118666,1441318925.3317962
2019-11-21,7627.9,8099.4,8129.6,7519.7,891500.0,19345.5,0.1,7957.633333333332,28.656631683975675,-134.5538941240763,9690.077281089709,7804.572718910288,8524.915572719965,6.235951818338992,328.0367920421186,64210240.0,-17.299289857429397,-0.05820256071512364,4.300486268070093,4.300486268070093,8434.0,8934.6,9137.034643616087,7422.7,8509.8,0,1230.0,2.8755022909714767,1445131398.5373254
2019-11-22,7272.5,7627.9,7700.9,6818.5,1410000.0,19345.5,0.1,7666.566666666666,24.747428950853205,-165.15408130404882,9751.111874020007,7540.728125979993,8405.637899127587,19.96130847696096,367.6341640391101,62800240.0,-17.152719236289908,-0.04659211578547173,5.055127728279272,5.055127728279272,8075.925,8679.25,8878.261100637514,7422.7,8509.8,1,1231.0,2.8757088935308586,1448782139.4429367
2019-11-23,7324.1,7271.6,7342.5,7093.7,783180.0,19345.5,0.1,7408.166666666667,26.319005332665952,-171.30815532985036,9766.598616382687,7337.821383617311,8302.634289686865,22.23003869152306,359.1460094648879,63583420.0,-16.81412913850871,0.007095221725679002,4.903619686581121,4.903619686581121,7982.525,8679.25,8507.504102522762,7422.7,8509.8,0,1232.0,2.8759171558361407,1452461534.5753574
2019-11-24,6924.7,7325.0,7344.1,6894.9,904500.0,19345.5,0.1,7173.766666666666,22.416641639658266,-190.20859294466763,9770.591136495204,7086.6588635047965,8171.40245257383,4.72440944881889,365.57843736025313,62678920.0,-23.372211402266284,-0.05453229748364996,5.279339716670082,5.279339716670082,7942.275,8679.25,8203.483364068665,6924.7,8509.8,0,1233.0,2.876108403993422,1455948523.2142112
2019-11-25,7115.6,6924.7,7352.8,6534.8,1290000.0,19345.5,0.1,7121.466666666666,27.917973092633773,-178.0023213375884,9712.365794797,6925.364205203003,8070.849838042989,25.18210197710718,397.8942632630922,63968920.0,-18.556925225194284,0.027567981284387866,5.5918582166379815,5.5918582166379815,7800.425,8537.4,7954.186358536305,6924.7,8509.8,0,1234.0,2.876307273624867,1459534196.5546336
2019-11-26,7162.8,7115.5,7329.5,7045.1,844270.0,19345.5,0.1,7067.7,29.253718254155487,-155.703734948979,9607.80580292694,6812.314197073063,7984.368901086515,27.36502679855331,389.78753017287136,64813190.0,-18.72092231577514,0.0066333127213447085,5.441831827956544,5.441831827956544,7771.575,8537.4,7670.309086829045,6924.7,8509.8,0,1235.0,2.8765076729497543,1463146722.7090654
2019-11-27,7510.6,7162.8,7636.9,6875.4,996490.0,19345.5,0.1,7263.0,38.32335008795257,-108.7099398699267,9472.298450859116,6776.5315491408855,7939.24805336399,43.081677704194284,416.33842087480906,65809680.0,-14.48805091596361,0.04855643044619429,5.543344351647126,5.543344351647126,7703.900000000001,8537.4,6534.8,6924.7,8509.8,0,1236.0,2.876721654870933,1466930127.6898742
2019-11-28,7426.7,7510.6,7639.5,7380.6,737580.0,19345.5,0.1,7366.7,37.08814735203985,-76.00347232837169,9402.350517833242,6711.329482166758,7890.43395304361,40.04939380332286,405.09281938375125,65072100.0,-14.2532212626426,-0.011170878491731706,5.454546694813999,5.454546694813999,7698.25,8537.4,6556.842000000001,6924.7,8509.8,0,1237.0,2.8769318818294307,1470678198.3344295
2019-11-29,7742.7,7426.6,7825.3,7412.3,766710.0,19345.5,0.1,7560.0,44.36187550123395,-28.272640921150128,9310.295848410946,6697.204151589053,7876.364052753742,57.604082216605434,405.6576179991976,65838810.0,-8.654719630027246,0.04254918065897373,5.239226858837326,5.239226858837326,7674.900000000001,8537.4,6600.14832,6924.7,8509.8,0,1238.0,2.8771539783907625,1474578093.6221523
2019-11-30,7546.6,7742.7,7787.7,7472.7,650600.0,19345.5,0.1,7572.0,41.17997997192778,-6.243544940450477,9159.3675777739,6699.1124222261005,7844.957952491481,48.25218179216939,399.1820738563978,65188210.0,-11.188259800171807,-0.025327082283957747,5.289561840516229,5.289561840516229,7586.9,8537.4,6673.6574208,6924.7,8509.8,0,1239.0,2.8773680588605366,1478391709.9834716
2019-12-01,7396.4,7546.5,7546.5,7244.4,777000.0,19345.5,0.1,7561.899999999999,38.87972376738734,1.4648606586886217,9054.509096731123,6669.920903268876,7802.238147492292,43.48221044663133,392.25478286665515,64411210.0,-13.083738748266702,-0.019903002676702197,5.303320302669611,5.303320302669611,7579.875,8537.4,6742.755975552001,6924.7,8509.8,0,1240.0,2.877575770332525,1482138182.8049278
2019-12-02,7298.2,7395.9,7433.8,7173.6,687780.0,19345.5,0.1,7413.733333333333,37.40847431460098,3.1084274102655627,8918.576001474668,6654.413998525333,7754.234514397788,44.622398877718005,382.8222983761798,63723430.0,-11.088640904439353,-0.013276729219620309,5.245434468446738,5.245434468446738,7565.475,8537.4,6807.70861701888,6924.7,8509.8,0,1241.0,2.8777791080846984,1485841072.7926006
2019-12-03,7291.8,7298.1,7389.4,7227.1,548770.0,19345.5,0.1,7328.799999999999,37.309383275313856,6.715888986284426,8765.337784478494,6658.522215521507,7710.193132074189,44.84065868972871,367.070705635024,63174660.0,-10.482831432534953,-0.0008769285577264752,5.0340204837629114,5.0340204837629114,7537.424999999999,8537.4,6868.7640999977475,6924.7,8509.8,0,1242.0,2.877981760295772,1489544714.0492537
2019-12-04,7204.4,7291.9,7702.2,7113.6,971750.0,19345.5,0.1,7264.799999999999,35.91043643201101,6.180635055720302,8618.753172524051,6659.426827475947,7662.022357590932,41.98645598194127,382.8942266610937,62202910.0,-11.04910300890201,-0.011986066540497609,5.314727481276632,5.314727481276632,7582.1,8537.4,6926.156253997882,6924.7,8509.8,0,1243.0,2.8781804313132078,1493209009.8444402
2019-12-05,7399.2,7204.6,7476.3,7184.0,780780.0,19345.5,0.1,7298.466666666666,41.20226696469922,21.07212401071189,8490.477405712356,6679.992594287645,7636.991656867986,66.98179000387445,376.4232104710156,62983690.0,-2.9982039617719143,0.027039031702848382,5.08735012529754,5.08735012529754,7582.1,8537.4,6980.104878758009,6924.7,8509.8,0,1244.0,2.8783865436484835,1496972795.9586718
2019-12-06,7530.8,7399.2,7552.1,7329.8,706100.0,19345.5,0.1,7378.133333333332,44.53419457623332,40.77085609630569,8339.619606021937,6734.200393978062,7626.878165737702,77.1793878341728,365.4144097230859,63689790.0,3.5517359917497444,0.017785706562871706,4.852265492684521,4.852265492684521,7635.025000000001,8537.4,7030.816586032529,6924.7,8509.8,0,1245.0,2.8785974218434203,1500804103.3326392
2019-12-07,7510.9,7530.4,7595.7,7489.6,557140.0,19345.5,0.1,7480.299999999999,44.12698210283048,52.68873386133134,8154.195854427383,6819.7341455726155,7615.832626143635,75.6373498643936,346.89195188572256,63132650.0,2.55048401851421,-0.0026424815424657133,4.61851378510861,4.61851378510861,7578.725,8537.4,7078.485590870577,6924.7,8509.8,0,1246.0,2.87880708789736,1504630186.5647233
2019-12-08,7524.4,7510.8,7576.4,7416.7,499040.0,19345.5,0.1,7522.033333333333,44.497751111910894,61.1163897218247,8033.027903432487,6872.502096567516,7607.124756987098,76.68345602479654,333.5210981795995,63631690.0,8.660302973414009,0.0017973877964025942,4.432527486305879,4.432527486305879,7566.45,8537.4,7123.294455418342,6924.7,7524.4,0,1247.0,2.8790168512972594,1508467034.5382757
2019-12-09,7355.8,7524.8,7626.0,7321.6,648660.0,19345.5,0.1,7463.7,40.85172186499376,55.154157267198684,7899.391668309383,6927.148331690616,7583.18906584547,50.573744604695264,331.4410197381995,62983030.0,3.3756816009893726,-0.02240710222742004,4.505845995516456,4.505845995516456,7537.599999999999,8537.4,7165.414788093241,6924.7,7524.4,0,1248.0,2.879219511765356,1512226035.7718098
2019-12-10,7235.7,7356.2,7400.3,7192.1,609500.0,19345.5,0.1,7371.966666666666,38.43577254030333,43.454620886715645,7745.636289556827,6994.543710443175,7550.094869098283,37.93030845352142,322.63808975689955,62373530.0,1.0177584184955553,-0.016327251964436296,4.458975493136801,4.458975493136801,7528.099999999999,8537.4,7825.3,6924.7,7524.4,0,1249.0,2.879416902375984,1515929173.4861202
2019-12-11,7208.0,7235.8,7284.4,7168.8,518400.0,19345.5,0.1,7266.5,37.87935416351767,34.570072850972565,7711.356355791507,6986.833644208496,7517.514405374637,13.264015736967776,307.84965477426385,61855130.0,-4.028972385694889,-0.003828240529596294,4.2709441561357355,4.2709441561357355,7495.575,8537.4,7812.636,6924.7,7524.4,0,1250.0,2.8796127443258523,1519622022.8050156
2019-12-12,7208.0,7208.0,7272.4,7124.6,611800.0,19345.5,0.1,7217.233333333333,37.879354163517675,29.60460476229332,7711.929951920311,6979.81004807969,7488.036842958006,13.264015736967776,296.41753657610207,62466930.0,-2.9447803196574496,0.0,4.112340962487542,4.112340962487542,7495.575,8537.4,7786.88256,6924.7,7524.4,0,1251.0,2.879808167665507,1523318477.955352
2019-12-13,7255.2,7208.4,7288.0,7200.3,503490.0,19345.5,0.1,7223.733333333333,39.60711344412588,30.300556951038203,7710.530744997141,6974.31925500286,7465.861905533433,21.005785491766737,281.50914110638047,62970420.0,-6.296253244992058,0.0065482796892342154,3.8801017353950336,3.8801017353950336,7450.424999999999,8537.4,7747.1456064,6924.7,7524.4,0,1252.0,2.8800050921777305,1527042390.1027524
2019-12-14,7080.8,7255.2,7267.4,7043.3,524560.0,19345.5,0.1,7181.333333333333,35.660505933805695,20.29743932553788,7687.941208579017,7012.518791420984,7429.189343101678,5.691303687964793,277.40848817021043,62445860.0,-6.172316009858746,-0.024037931414709446,3.9177563011271386,3.9177563011271386,7362.425,8537.4,7709.792870016,6924.7,7524.4,0,1253.0,2.880194444914115,1530680835.2196136
2019-12-15,7128.5,7080.8,7175.8,7033.8,492580.0,19345.5,0.1,7154.833333333333,37.49502370155305,18.240373135120734,7686.83599103899,7014.91400896101,7400.55226280628,14.16816277678035,267.73645330090966,62938440.0,-3.6220323400573204,0.006736526946107713,3.7558596240570905,3.7558596240570905,7354.4,8537.4,7656.47344041472,6924.7,7524.4,0,1254.0,2.8803853583360373,1534347243.0603018
2019-12-16,6903.5,7128.5,7153.1,6864.6,689560.0,19345.5,0.1,7037.5999999999985,32.75127842921604,3.8269224293590014,7718.898004535446,6956.921995464556,7353.213952062825,4.64422158548229,269.2195637794161,62248880.0,-5.408182839604284,-0.03156344251946408,3.899754671969524,3.899754671969524,7288.75,8537.4,7594.206096373248,6924.7,7524.4,0,1255.0,2.8805664356464953,1537899046.293392
2019-12-17,6613.3,6903.5,6943.5,6575.0,894550.0,19345.5,0.1,6881.766666666666,27.856108746114458,-21.745327815812175,7778.995563226242,6807.094436773758,7282.7459566282705,3.397799858055375,276.3110235094578,61354330.0,-9.304972709070462,-0.04203664807706231,4.178111132255573,4.178111132255573,7140.275,8200.85,7506.653364808459,6613.3,7524.4,0,1256.0,2.880734494829086,1541295457.6221476
2019-12-18,7276.0,6613.5,7387.7,6462.2,1140000.0,19345.5,0.1,6930.933333333333,47.24677573727834,7.890256036148401,7767.595282496678,6803.424717503322,7282.103484568435,69.9261041416051,322.6816646873537,62494330.0,0.99383709955028,0.10020715830220905,4.434877194713492,4.434877194713492,7037.5,8164.549999999999,6575.0,6613.3,7524.4,0,1257.0,2.8809302009304436,1545046962.339879
2019-12-19,7165.5,7276.4,7354.0,7039.3,778720.0,19345.5,0.1,7018.266666666666,45.07144805382502,21.21369331735181,7692.712566611607,6820.587433388392,7270.998390800013,60.431345592026126,322.11154578111416,61715610.0,-3.1584495621148205,-0.015186915887850483,4.495311503469599,4.495311503469599,7034.35,7996.75,6575.0,6613.3,7524.4,0,1258.0,2.881120997737657,1548745476.9102242
2019-12-20,7196.4,7165.5,7218.4,7107.7,627040.0,19345.5,0.1,7212.633333333332,45.82264053015107,32.59002391423883,7654.8754610806045,6823.404538919394,7263.893782152393,63.08644096923868,307.01072108246314,62342650.0,-4.440431295479903,0.004312329914172075,4.266170878251114,4.266170878251114,7034.35,7981.299999999999,6462.2,6613.3,7524.4,0,1259.0,2.881312644494164,1552463385.73899
2019-12-21,7156.2,7196.4,7197.6,7129.6,468740.0,19345.5,0.1,7172.7,44.96116510451688,37.537864560518585,7637.8472755070125,6816.412724492988,7253.637231471213,59.63223921636019,289.93852671943006,61873910.0,-4.722470010251765,-0.005586126396531554,4.051571039370477,4.051571039370477,7034.35,7981.299999999999,6480.71,6613.3,7524.4,0,1260.0,2.881502234570815,1556163948.162503
2019-12-22,7495.8,7156.3,7501.1,7142.0,677940.0,19345.5,0.1,7282.799999999999,52.99990266775549,62.34947059519098,7663.301857299553,6810.718142700445,7276.700352283478,88.8125107406771,294.87863195375655,62551850.0,-0.38009675190047654,0.04745535339984919,3.933918086845387,3.933918086845387,7062.7,7981.299999999999,6498.8498,6613.3,7524.4,0,1261.0,2.881705010602556,1560040656.4539247
2019-12-23,7322.8,7496.2,7684.0,7276.2,952160.0,19345.5,0.1,7324.933333333332,49.06819008165166,65.45559303423019,7665.861689207875,6811.2583107921255,7281.090794923148,70.43706007529876,302.94444395705966,61599690.0,-0.4486255743766823,-0.023079591237759822,4.137002839857154,4.137002839857154,7108.425,7981.299999999999,6538.939808,6613.3,7524.4,0,1262.0,2.881900517915885,1563834239.5660613
2019-12-24,7268.3,7322.4,7433.2,7185.7,785540.0,19345.5,0.1,7362.299999999999,47.86357875911526,62.207517415306086,7668.942796993199,6814.567203006801,7279.872623978086,65.97642822065806,298.9841265315554,60814150.0,0.45054383128101444,-0.007442508330146924,4.113535854760472,4.113535854760472,7108.425,7981.299999999999,6607.64341952,6613.3,7524.4,0,1263.0,2.882093419458261,1567603572.8057303
2019-12-25,7224.8,7268.3,7542.4,7150.9,625410.0,19345.5,0.1,7271.966666666667,46.87443283463091,55.70723383257507,7654.087216595403,6811.982783404595,7274.62761217065,62.41610738255035,305.59240320787285,60188740.0,0.2330743618202023,-0.0059848933037986995,4.229769726606588,4.229769726606588,7099.025,7981.299999999999,6672.2248143488,6613.3,7524.4,0,1264.0,2.8822841483193544,1571353976.4710493
2019-12-26,7210.9,7225.0,7414.3,7177.3,795090.0,19345.5,0.1,7234.666666666667,46.543435980605736,49.27131970516922,7615.319803153391,6818.760196846611,7268.5583157734445,61.27844164347682,300.6929458358819,59393650.0,0.040233074361815155,-0.0019239286900676333,4.169978030979238,4.169978030979238,7077.65,7957.450000000001,6732.931325487872,6613.3,7524.4,0,1265.0,2.882473901399581,1575100625.3326192
2019-12-27,7261.7,7210.8,7293.8,7128.5,718070.0,19345.5,0.1,7232.466666666666,47.98893299463236,47.229835903550935,7580.257998290961,6828.902001709039,7267.90514284264,65.43624161073825,291.0220211333189,60111720.0,0.08959091410298821,0.007044890374294566,4.00762935859811,4.00762935859811,7221.924999999999,7943.4,6789.9954459586,6613.3,7524.4,0,1266.0,2.882665299687225,1578877158.7275925
2019-12-28,7321.5,7261.9,7375.9,7256.5,610960.0,19345.5,0.1,7264.7,49.71276933907374,48.51642647486709,7545.147653179071,6843.722346820928,7273.009414952865,70.33065968243575,278.7633053380818,60722680.0,3.399333408654387,0.008234986297974256,3.807461658650301,3.807461658650301,7239.025,7914.6,6843.635719201084,6613.3,7524.4,0,1267.0,2.8828586870899437,1582688185.1457078
2019-12-29,7397.5,7321.6,7518.9,7303.0,611690.0,19345.5,0.1,7326.899999999999,51.89493716123256,52.74481178793194,7551.514820243766,6841.525179756233,7284.86566114783,76.55099034211818,274.2730692425045,61334370.0,3.7735849056603774,0.010380386532814256,3.7076454105103682,3.7076454105103682,7244.225,7858.5,6894.057576049018,6613.3,7397.5,0,1268.0,2.8830546834584836,1586541925.0012908
2019-12-30,7261.8,7397.5,7420.9,7244.1,606110.0,19345.5,0.1,7326.933333333332,47.898242714471685,44.96498258246052,7553.577430068866,6842.072569931133,7282.668931514704,65.44442625634312,267.31070715375415,60728260.0,5.190120953139714,-0.018344035147009108,3.6810530055048902,3.6810530055048902,7239.675,7777.549999999999,6941.454121486077,6613.3,7397.5,0,1269.0,2.8832448471462917,1590329271.8672166
2019-12-31,7196.4,7261.5,7331.0,7167.4,586600.0,19345.5,0.1,7285.233333333333,46.05723176223561,34.45036613264941,7552.9670064880775,6841.522993511922,7274.452842799018,60.091668030774244,259.9027994999146,60141660.0,8.817080731253677,-0.009006031562422634,3.6115668876092846,3.6115668876092846,7239.675,7777.549999999999,6986.006874196913,6613.3,7397.5,0,1270.0,2.8834319543029694,1594085752.7537196
2020-01-01,7199.8,7196.4,7259.4,7180.0,420280.0,19345.5,0.1,7219.333333333332,46.1730620988143,27.08496750624512,7552.52537813793,6841.144621862069,7267.34304824673,24.895300139599822,247.00974239277778,60561940.0,-1.0472787245739392,0.0004724584514479435,3.430786166182085,3.430786166182085,7204.275,7764.299999999999,7027.886461745098,6613.3,7397.5,0,1271.0,2.883618792134001,1597847387.4206629
2020-01-02,6967.0,7199.7,7209.6,6901.4,632780.0,19345.5,0.1,7121.066666666666,39.86156764290232,6.944079654399431,7550.621392567749,6814.228607432251,7238.738948413708,8.382315359059588,251.380475079008,59929160.0,-2.7702184076477563,-0.03233423150643078,3.6081595389551886,3.6081595389551886,7147.5,7651.700000000001,7684.0,6613.3,7397.5,0,1272.0,2.8837956143374273,1601486988.6200233
2020-01-03,7343.1,6967.1,7402.9,6884.1,936290.0,19345.5,0.1,7169.966666666666,51.4158543303975,18.69432981723652,7566.994349281178,6824.08565071882,7248.678096183832,57.38217277159647,270.48186971622164,60865450.0,2.038519259629825,0.05398306301133915,3.6834834023262877,3.6834834023262877,7137.3,7645.950000000001,7668.348,6613.3,7397.5,0,1273.0,2.8839874037938347,1605330423.8245602
2020-01-04,7376.8,7345.1,7433.1,7291.4,523909.99999999994,19345.5,0.1,7228.966666666667,52.30019358547996,27.92358367346398,7586.153320858122,6829.756679141876,7260.880182261562,61.595199399925,261.2831647364916,61389360.0,3.082641625443676,0.004589342375835859,3.5419580947903095,3.5419580947903095,7137.3,7631.0,7636.97808,6613.3,7397.5,0,1274.0,2.884180120008035,1609195025.1826458
2020-01-05,7372.5,7376.8,7501.0,7345.6,628140.0,19345.5,0.1,7364.133333333334,52.169706969428354,32.60019842613745,7588.771481220473,6874.038518779525,7271.510641093794,61.05763220402549,253.72008154102787,60761220.0,-1.644921155847277,-0.0005829085782453891,3.441438881533101,3.441438881533101,7137.3,7612.0,7606.8629568,6613.3,7397.5,0,1275.0,2.8843722542697967,1613061071.2996686
2020-01-06,7759.1,7372.6,7783.1,7366.7,786750.0,19345.5,0.1,7502.799999999999,61.47592061965494,59.05017365467501,7595.06711018613,6982.32288981387,7317.947722894385,97.33036707452725,265.34007571666876,61547970.0,5.958103457693781,0.05243811461512382,3.4197274905165385,3.4197274905165385,7228.125,7546.950000000001,6884.1,6613.3,7397.5,0,1276.0,2.8845789011941543,1617127432.0176673
2020-01-07,8155.7,7759.1,8182.0,7754.1,1010000.0,19345.5,0.1,7762.433333333333,68.2917381696517,98.2643073491979,7818.9232008778135,6846.436799122187,7397.733654047302,97.97364974189072,276.95149887976385,62557970.0,12.209182339749317,0.051114175613151014,3.3958029216347323,3.3958029216347323,7427.575000000001,7546.950000000001,6902.08,6613.3,7397.5,0,1277.0,2.8847996765143273,1621390517.466615
2020-01-08,8059.6,8154.2,8436.4,7900.8,1190000.0,19345.5,0.1,7991.466666666666,65.27798427987855,111.75617140457089,7950.561246105768,6804.208753894232,7460.7685441380345,75.72634155768863,295.42639181692357,61367970.0,11.55464511128336,-0.011783170052846459,3.6655217605951105,3.6655217605951105,7554.775,7489.25,6953.2768,6613.3,7397.5,0,1278.0,2.8850165572314395,1625613060.2828267
2020-01-09,7842.4,8060.0,8065.9,7779.2,786500.0,19345.5,0.1,8019.233333333333,58.94632589907637,100.43551535636608,8010.563128325453,6808.806871674547,7497.114397077269,61.73420086323518,294.80307811571475,60581470.0,8.757575337336533,-0.026949228249541046,3.7590926006798275,3.7590926006798275,7554.775,7449.299999999999,7042.264192,7842.4,7397.5,0,1279.0,2.8852250359335074,1629734810.9061656
2020-01-10,8187.1,7842.5,8187.4,7697.7,1050000.0,19345.5,0.1,8029.7,64.78419676307612,109.7865323458118,8138.319997267645,6784.140002732356,7562.827311641339,83.93996005926694,308.7242868217351,61631470.0,12.743572441714758,0.0439533816178721,3.7708625376718876,3.7708625376718876,7554.775,7449.299999999999,7125.912340479999,7842.4,7397.5,0,1280.0,2.8854456355498304,1634028229.677697
2020-01-11,8024.1,8187.8,8262.9,8008.4,776750.0,19345.5,0.1,8017.866666666666,60.409586936973405,98.95350412101398,8207.912565492086,6767.377434507913,7606.758043865973,73.43941248470016,304.8511234773255,60854720.0,9.596394181520186,-0.01990936961805767,3.799193971627042,3.799193971627042,7554.775,7449.299999999999,7204.5416000512,7842.4,7397.5,0,1281.0,2.885659936760966,1638248672.2829196
2020-01-12,8187.6,8023.3,8189.9,7973.1,595220.0,19345.5,0.1,8132.933333333333,63.10111160517327,96.64832481047648,8307.968779974783,6753.801220025217,7662.076325402547,83.97217032790057,298.5617575146593,61449940.0,10.680635349780337,0.020376116947695033,3.6465112794305936,3.6465112794305936,7656.599999999999,7449.299999999999,7278.453104048128,7842.4,7397.5,0,1282.0,2.8858796883506295,1642552792.3482504
2020-01-13,8111.4,8188.3,8196.7,8068.4,610660.0,19345.5,0.1,8107.7,61.01904028459177,84.29170219681586,8379.489243040065,6766.590756959933,7704.86905631659,79.06332538813373,286.4002034064694,60839280.0,11.699578616871841,-0.009306756558698615,3.5308356560700913,3.5308356560700913,7775.625,7449.299999999999,7347.929917805241,7842.4,7397.5,0,1283.0,2.8860962814628572,1646825635.8101373
2020-01-14,8829.2,8111.2,8898.7,8111.2,1480000.0,19345.5,0.1,8376.066666666666,70.79482402431876,116.76189145679078,8610.31420828702,6696.2057917129805,7811.948193810248,96.5501836592872,322.1930460202931,62319280.0,22.689122338947268,0.08849273861478912,3.6491759844639726,3.6491759844639726,8012.050000000001,7680.450000000001,7413.238122736926,7842.4,7397.5,0,1284.0,2.8863371454035973,1651436091.422766
2020-01-15,8818.3,8827.9,8904.0,8615.5,1170000.0,19345.5,0.1,8586.3,70.50566894669176,128.8564613909851,8793.08390480185,6674.176095198148,7907.7912229711765,95.75721570374768,319.78639987598643,61149280.0,22.479791105308465,-0.001234539935668133,3.6263951087623063,3.6263951087623063,8097.450000000001,7683.1,7532.075072917972,7842.4,7397.5,0,1285.0,2.8865771977835957,1656048331.394011
2020-01-16,8726.9,8818.1,8850.0,8605.8,748320.0,19345.5,0.1,8791.466666666665,67.99766788733143,122.1149586540285,8926.598863767671,6687.181136232331,7985.801582688207,91.23223921976334,314.38737131341605,60400960.0,25.260513851011908,-0.0103648095437896,3.602509153461322,3.602509153461322,8097.450000000001,7683.1,7669.2675656261745,7842.4,7397.5,0,1286.0,2.8868137658330353,1660626115.2157395
2020-01-17,8913.1,8726.7,9005.1,8675.9,794110.0,19345.5,0.1,8819.433333333332,70.31435969697046,121.3582299791326,9080.637264833485,6692.302735166517,8074.115717670283,94.6314990955243,315.4454162196007,61195070.0,21.38061581620841,0.021336327905671082,3.5391212509631966,3.5391212509631966,8148.0,7733.65,7792.740809063557,7842.4,7397.5,0,1287.0,2.8870560310177225,1665293722.533481
2020-01-18,8916.3,8913.0,8982.3,8814.6,627740.0,19345.5,0.1,8852.099999999999,70.35407945194858,112.43707827657067,9214.312374628264,6710.507625371739,8154.3237445588275,94.64899065983722,304.89217220391487,61822810.0,20.869482702526827,0.00035902211351812596,3.4194920785966696,3.4194920785966696,8148.0,7733.65,7938.223911975931,7842.4,8916.3,0,1288.0,2.887297948171114,1669969544.028037
2020-01-19,8706.2,8916.3,9183.7,8552.8,975010.0,19345.5,0.1,8845.199999999999,64.27339920926343,84.99771136779435,9283.177348080912,6786.082651919087,8206.883387934176,73.72041827187672,328.17844561792106,60847800.0,18.09020006781961,-0.02356358579231277,3.7694797456745888,3.7694797456745888,8306.150000000001,7822.950000000001,8066.249042538819,7842.4,8916.3,0,1289.0,2.88753247682422,1674557453.6093447
2020-01-20,8641.9,8705.7,8740.1,8539.2,599060.0,19345.5,0.1,8754.799999999997,62.49321337122219,56.50079128711019,9319.837496843858,6893.972503156143,8248.313541464255,63.53970390309551,319.0871280737838,60248740.0,11.377608227758364,-0.0073855413383566715,3.692326086552538,3.692326086552538,8306.150000000001,7822.950000000001,8222.692176583385,7842.4,8916.3,0,1290.0,2.887764404336453,1679122182.3981082
2020-01-21,8732.6,8642.0,8770.3,8524.0,540200.0,19345.5,0.1,8693.566666666666,64.00756356235436,38.59783416549874,9350.353224988097,7016.736775011905,8294.4360613248,69.64333781965006,313.88804749708487,60788940.0,7.073580440673401,0.010495377174001064,3.594439771626833,3.594439771626833,8329.975,7822.950000000001,8357.23327186171,7842.4,8916.3,0,1291.0,2.8879989242334427,1683734764.3487773
2020-01-22,8678.5,8733.0,8805.4,8610.8,509060.0,19345.5,0.1,8684.333333333332,62.38947440671796,18.94470039061673,9310.82478274791,7227.415217252092,8331.013579293867,66.00269179004034,305.3674726758645,60279880.0,7.679041143481061,-0.006195176694226312,3.518666505454451,3.518666505454451,8340.675000000001,7822.950000000001,8472.938613801072,7842.4,8916.3,0,1292.0,2.8882311929365527,1688328850.986093
2020-01-23,8405.1,8678.5,8687.3,8309.6,722670.0,19345.5,0.1,8605.4,54.844005324067325,-14.81355293576081,9274.094948929673,7370.345051070326,8338.069428884928,47.60430686406461,310.53408177044554,59557210.0,7.1750994593491875,-0.031503139943538594,3.6945911621568515,3.6945911621568515,8390.275000000001,7822.950000000001,9183.7,7842.4,8916.3,0,1293.0,2.8884537180743113,1692800798.7061877
2020-01-24,8439.9,8404.9,8522.0,8242.6,617020.0,19345.5,0.1,8507.833333333332,55.580407234814935,-35.94059144098304,9223.17805702437,7527.57194297563,8347.767578514935,38.55939203700637,308.31021878684226,60174230.0,3.0877844413772797,0.004140343362958099,3.653007959654051,3.653007959654051,8373.525000000001,7822.950000000001,9166.218,7842.4,8916.3,0,1294.0,2.8886770091035214,1697295003.1782055
2020-01-25,8341.6,8439.9,8447.6,8277.2,444000.0,19345.5,0.1,8395.533333333333,52.95345168093764,-56.45533011058393,9136.890286651742,7710.769713348257,8347.180190084942,30.439451511647107,298.45948887349635,59730230.0,3.956830049475953,-0.011647057429590268,3.5779645256724892,3.5779645256724892,8373.525000000001,7822.950000000001,9129.273280000001,7842.4,8916.3,0,1295.0,2.8888964633767786,1701747708.280996
2020-01-26,8607.8,8341.6,8607.8,8304.9,468340.0,19345.5,0.1,8463.099999999999,58.65269760605937,-52.12066302677965,9114.067325636352,7818.462674363651,8372.001124362567,48.3636689679906,298.77666823967513,60198570.0,5.1321510576969915,0.03191234295578771,3.4709991895684746,3.4709991895684746,8373.525000000001,7822.950000000001,9093.8063488,7842.4,8916.3,0,1296.0,2.889124605863166,1706332792.9801402
2020-01-27,8866.6,8608.1,8983.1,8585.6,706450.0,19345.5,0.1,8605.333333333332,63.306611605237975,-32.791557419246885,9155.535908619098,7848.084091380905,8419.10577918518,70.43356643356643,305.828334793984,60905020.0,9.310353329881412,0.03006575431585312,3.4492176797643292,3.4492176797643292,8373.525000000001,7822.950000000001,9059.758094848,7842.4,8916.3,0,1297.0,2.889360906762954,1711043883.8050768
2020-01-28,9377.3,8866.6,9389.5,8866.6,954200.0,19345.5,0.1,8950.566666666664,70.38940504172396,11.07291621671152,9291.698343845772,7843.6916561542275,8510.362371643734,98.93626296974446,321.3334537372709,61859220.0,6.207810447152613,0.05759817742990547,3.4267161521682246,3.4267161521682246,8476.425,7925.85,8242.6,7842.4,8916.3,0,1298.0,2.889613009803102,1715988934.494382
2020-01-29,9298.9,9377.3,9428.7,9250.9,749880.0,19345.5,0.1,9180.933333333332,68.2126159545428,30.396011842353403,9350.93431742319,7930.105682576811,8585.46119339195,89.05657195851943,311.08106418460875,61109340.0,5.450030051143649,-0.008360615528990145,3.345353366361707,3.345353366361707,8597.85,7945.450000000001,8265.538,7842.4,8916.3,0,1299.0,2.889862218638195,1720907494.820947
2020-01-30,9507.3,9299.1,9569.0,9209.2,765210.0,19345.5,0.1,9394.499999999998,70.79779724660995,51.557725897466696,9478.801193558229,7934.258806441769,8673.255365449859,95.34831121833528,314.56098817142237,61874550.0,8.942465251120096,0.022411252943896454,3.3086258787607665,3.3086258787607665,8681.55,8015.6,8312.064480000001,7842.4,8916.3,0,1300.0,2.890117397903705,1725924029.9996128
2020-01-31,9349.1,9508.3,9525.0,9222.3,633370.0,19345.5,0.1,9385.099999999999,66.38418390254114,49.24945230343758,9526.625903616816,8018.934096383186,8737.6215211213,83.42129071170086,313.71377473060653,61241180.0,4.891676296686899,-0.016639845171604883,3.3555505313945355,3.3555505313945355,8686.825,8015.6,8387.4806112,7842.4,8916.3,0,1301.0,2.8903672516734913,1730879846.048431
2020-02-01,9381.6,9349.3,9458.8,9301.5,458420.0,19345.5,0.1,9412.666666666664,66.84151505170087,44.40942768227626,9580.59263750845,8084.367362491549,8798.952804824034,85.8715319662244,302.54136224984893,61699600.0,5.218532350863039,0.003476270443144358,3.224837578343235,3.224837578343235,8769.575,8015.6,8458.371774528001,7842.4,8916.3,0,1302.0,2.890617654589307,1735857503.105427
2020-02-02,9334.9,9381.5,9465.4,9183.1,683370.0,19345.5,0.1,9355.199999999999,65.46334279071384,33.08069561072773,9594.509402782667,8192.800597217334,8849.995394840793,82.35072376357053,301.0955506605739,61016230.0,7.221290574533078,-0.0049778289417584665,3.2254823368281818,3.2254823368281818,8778.225,8015.6,8525.009468056322,7842.4,8916.3,0,1303.0,2.890866154932445,1740822295.0342388
2020-02-03,9296.6,9334.6,9582.8,9243.1,701390.0,19345.5,0.1,9337.699999999999,64.29253832979143,18.739509050699155,9638.58879586274,8195.461204137258,8892.529166760718,78.64497836143866,303.8530113276757,60314840.0,7.575880304099801,-0.004102882730398716,3.2684315914170305,3.2684315914170305,8792.05,8022.5,8587.648899972943,7842.4,8916.3,0,1304.0,2.8911130095135125,1745777684.1558053
2020-02-04,9193.9,9296.5,9347.5,9193.9,651680.0,19345.5,0.1,9275.133333333333,61.135111797632455,-0.8906056062032803,9665.617431998693,8205.992568001308,8921.231150878744,70.98194299358305,293.1206533756989,59663160.0,5.282504637794005,-0.011047049458942082,3.188207978939285,3.188207978939285,8862.225,8022.5,8667.260987975107,9193.9,8916.3,0,1305.0,2.8913561942577855,1750694600.995772
2020-02-05,9611.8,9194.1,9726.8,9179.9,771460.0,19345.5,0.1,9367.433333333332,68.0179243066738,10.41883077068411,9759.448033099805,8200.651966900194,8986.999612699816,92.25171809729146,311.24774956314894,60434620.0,10.754162585700286,0.045454051055591194,3.2381837903738004,3.2381837903738004,9073.325,8094.5,8740.504108937099,9193.9,8916.3,0,1306.0,2.8916117960021706,1755803036.5385342
2020-02-06,9772.0,9611.8,9854.9,9536.1,778670.0,19345.5,0.1,9525.9,70.1968644429538,24.05816040535683,9874.243907135771,8171.74609286423,9061.761554347453,94.85827699559638,311.787196022924,61213290.0,16.26274523801025,0.016667013462619007,3.1906180518105196,3.1906180518105196,9215.7,8158.549999999999,8839.133698043388,9193.9,8916.3,0,1307.0,2.891871720505784,1760988317.9632719
2020-02-07,9818.6,9771.9,9872.5,9738.7,608960.0,19345.5,0.1,9734.133333333331,70.81964818112544,31.13830577538755,9985.063623472768,8151.1563765272285,9133.841406314363,96.62132514260644,299.0738248784293,61822250.0,16.33550160546927,0.004768726975030724,3.0459925537085666,3.0459925537085666,9248.325,8167.35,8961.02565427818,9193.9,8916.3,0,1308.0,2.8921325571596626,1766201899.7955036
2020-02-08,9895.5,9817.3,9931.2,9673.2,551310.0,19345.5,0.1,9828.699999999999,71.86450080420674,35.59883331735557,10095.758182822261,8159.391817177741,9206.380319998709,97.80483305663157,296.13998024425575,62373560.0,18.62832070585978,0.007832073819078023,2.9926732377773306,2.9926732377773306,9288.375,8407.650000000001,9088.632062679235,9193.9,8916.3,0,1309.0,2.892395185374057,1771456653.717127
2020-02-09,10151.5,9895.4,10157.1,9882.7,617350.0,19345.5,0.1,9955.199999999999,75.06535578488109,49.53221357840965,10240.88841336644,8165.221586633557,9296.39171809407,99.6436525612472,294.5871245125232,62990910.0,17.9337345198541,0.025870345106361547,2.9019073487910476,2.9019073487910476,9434.175,8520.6,9223.442932650558,9193.9,8916.3,0,1310.0,2.8926647322405574,1776827182.7753704
2020-02-10,9854.1,10151.5,10181.7,9774.8,781220.0,19345.5,0.1,9967.033333333333,65.71248477431416,33.242994496255164,10310.332601024102,8207.9273989759,9349.506792561302,75.08934681773248,302.60947276162875,62209690.0,11.13730178422394,-0.029296163128601616,3.0708991461587436,3.0708991461587436,9446.475,8532.900000000001,9391.501204773458,9193.9,8916.3,0,1311.0,2.892925212724194,1782082014.7870972
2020-02-11,10229.5,9854.0,10314.1,9725.1,791280.0,19345.5,0.1,10078.366666666667,70.67871045688591,41.725500143467855,10432.977517282525,8240.382482717472,9433.315669460226,92.54099806030679,323.06593899294097,63000970.0,9.087903767609022,0.03809581798439221,3.1581791777989245,3.1581791777989245,9512.675,8599.1,9549.540963818767,9193.9,8916.3,0,1312.0,2.893196033083378,1787503030.4458985
2020-02-12,10317.7,10229.3,10435.6,10229.3,803250.0,19345.5,0.1,10133.766666666666,71.71528662649595,46.86624207682905,10520.5193767285,8344.100623271503,9517.542748559252,90.61081468503627,314.7255147791596,63804220.0,10.956134596565198,0.00862212229336734,3.050345665983306,3.050345665983306,9573.425,8659.85,9702.452771055014,9193.9,8916.3,0,1313.0,2.893468860877557,1792969758.5392113
2020-02-13,10235.1,10321.9,10482.6,10116.9,940300.0,19345.5,0.1,10260.766666666665,69.24634317432461,38.636070442432754,10563.170884832889,8480.96911516711,9585.881534410752,81.0009979273816,318.3665494377911,62863920.0,7.655170237606904,-0.008005660176202078,3.1105367748023087,3.1105367748023087,9596.925,8683.35,9725.1,9193.9,8916.3,0,1314.0,2.8937388931632304,1798412036.2408316
2020-02-14,10333.0,10235.5,10372.4,10125.2,732510.0,19345.5,0.1,10295.266666666665,70.54085742222529,33.88773731747307,10568.769305638793,8674.51069436121,9657.03567399068,88.51615874721729,313.2832244779488,63596430.0,10.524007658491188,0.009565123936258635,3.0318709423976467,3.0318709423976467,9685.975,8683.35,9876.6,9193.9,10333.0,0,1315.0,2.89401120230209,1803904200.619904
2020-02-15,9907.7,10336.0,10369.8,9831.7,808810.0,19345.5,0.1,10158.599999999999,58.934921808229994,-1.8959701330689995,10517.867986051331,8855.402013948666,9680.908466943949,55.868580640208855,329.34156558666666,62787620.0,5.607785452374865,-0.041159392238459214,3.3240970718397476,3.3240970718397476,9720.25,8683.35,10482.6,9193.9,10333.0,0,1316.0,2.894270906798312,1809226884.0232127
2020-02-16,9932.3,9907.4,10056.4,9654.9,808910.0,19345.5,0.1,10057.666666666666,59.351511226720746,-26.54031963042314,10486.358135681594,8993.481864318406,9704.850517711191,57.756966300759906,334.49573947333334,63596530.0,6.3996400604184265,0.002482917326927403,3.367757110370542,3.367757110370542,9715.675,8683.35,10469.582,9193.9,10333.0,0,1317.0,2.8945308645041714,1814568862.9579737
2020-02-17,9701.4,9931.7,9951.5,9468.9,961880.0,19345.5,0.1,9847.133333333333,53.831435325650624,-59.15576019285646,10484.216743875599,9028.033256124401,9704.521896976792,40.03224073078987,345.0746152252381,62634650.0,4.3542800593765385,-0.023247384795062498,3.55695688483351,3.55695688483351,9669.175,8683.35,10436.99472,9193.9,10333.0,0,1318.0,2.8947835746114072,1819818812.8957672
2020-02-18,10158.4,9701.5,10230.1,9601.6,945910.0,19345.5,0.1,9930.699999999999,61.46966925945221,-51.02257203681097,10515.538608674748,9082.661391325253,9747.748382979004,75.11322637598829,365.31928556629254,63580560.0,10.490651410174138,0.04710660317067639,3.5962285947225205,3.5962285947225205,9669.175,8683.35,10378.9090368,9193.9,10333.0,0,1319.0,2.8950491031650696,1825274727.9374824
2020-02-19,9609.4,10158.6,10230.9,9424.3,905950.0,19345.5,0.1,9823.066666666664,50.63248098948744,-81.85956703283756,10513.675088093789,9094.734911906211,9734.572346504812,17.49031465557972,396.83933659727165,62674610.0,-0.024969308558226724,-0.054043943928177685,4.129699425534078,4.129699425534078,9666.675000000001,8683.35,10324.308494592,9193.9,10333.0,0,1320.0,2.8952981472865607,1830500552.997673
2020-02-20,9602.4,9611.9,9681.4,9448.9,870800.0,19345.5,0.1,9790.066666666666,50.51020385796967,-100.73004331633553,10502.017528930672,9131.722471069326,9721.984503980544,16.82887650004726,385.10081255460943,61803810.0,-1.7355710192386447,-0.0007284533893895384,4.010464181398499,4.010464181398499,9673.6,8683.35,10252.30781502464,9193.9,10333.0,0,1321.0,2.8955465289314293,1835731241.8295507
2020-02-21,9684.5,9602.2,9747.1,9574.5,716610.0,19345.5,0.1,9632.099999999999,51.97511789884135,-105.19517796158402,10490.894367638573,9173.135632361425,9718.414551220492,24.58660115279226,369.92218308642305,62520420.0,-1.3657751614283131,0.008549945846871632,3.8197344528517014,3.8197344528517014,9743.775000000001,8683.35,10230.9,9193.9,10333.0,0,1322.0,2.8957969119214373,1841006777.8716295
2020-02-22,9655.7,9684.5,9706.5,9569.8,589880.0,19345.5,0.1,9647.533333333333,51.40034468289693,-107.23487163743943,10472.463220557518,9223.646779442483,9712.44173681854,21.865255598601646,353.26345572310714,61930540.0,-2.423323733009947,-0.00297382415199543,3.658600160766253,3.658600160766253,9786.474999999999,8683.35,10166.372,9193.9,10333.0,0,1323.0,2.8960459837798385,1846277544.321007
2020-02-23,9942.7,9655.6,9965.6,9653.4,775880.0,19345.5,0.1,9760.966666666665,56.556223508960386,-87.24939359189409,10451.921182726579,9308.798817273422,9734.371095216775,48.98421997543238,350.3303517428853,62706420.0,-2.0568388908043076,0.029723375829820764,3.5234931330814088,3.5234931330814088,9864.15,8683.35,10107.006239999999,9193.9,10333.0,0,1324.0,2.89630303830992,1851683881.4611154
2020-02-24,9662.7,9943.2,9981.0,9507.0,980000.0,19345.5,0.1,9753.699999999999,50.88449070592854,-90.4923927613217,10393.406127412436,9414.193872587563,9727.545276624702,22.526693754134104,359.1638980469649,61726420.0,-1.9423387219532948,-0.028161364619268436,3.717013857896498,3.717013857896498,9829.425,8887.0,10052.3897408,9193.9,10333.0,0,1325.0,2.8965514106515653,1856974269.8742974
2020-02-25,9317.2,9662.6,9672.3,9269.8,937970.0,19345.5,0.1,9640.866666666667,44.90086070973267,-112.09835457567385,10428.155689292345,9349.984310707654,9688.464774089016,3.9083113456465544,362.2593339007531,60788450.0,-8.918324453785614,-0.03575605162118245,3.888070814201188,3.888070814201188,9790.8,8914.1,10002.142561535999,9193.9,10333.0,0,1326.0,2.896788852870181,1862113441.2732644
2020-02-26,8800.3,9317.1,9368.1,8672.0,1320000.0,19345.5,0.1,9260.066666666666,37.748877248829515,-154.76409815879478,10558.478257001627,9122.49174299837,9603.877652747206,7.086048823594347,386.10509576498504,59468450.0,-14.706766042819632,-0.05547804061305983,4.3874083356815685,4.3874083356815685,9514.375,8924.65,9981.0,9193.9,10333.0,0,1327.0,2.8970094317155555,1867009606.0064158
2020-02-27,8818.6,8800.1,8968.3,8538.5,1130000.0,19345.5,0.1,8978.699999999999,38.124644375826186,-173.8851438179082,10635.628962351864,8945.341037648137,9529.08930486652,15.273460930257944,389.2261603532003,60598450.0,-13.839630291838867,0.002079474563367212,4.41369560194589,4.41369560194589,9447.625,9090.15,9823.92,9193.9,10333.0,0,1328.0,2.8972301813139736,1871921049.2890813
2020-02-28,8697.5,8820.1,8898.7,8451.9,1080000.0,19345.5,0.1,8772.133333333331,36.552243175308014,-185.74633506544347,10698.383475458508,8762.786524541494,9449.890323450662,12.80567287136975,393.33857747082897,59518450.0,-15.827929933223652,-0.0137323384664233,4.522432623981937,4.522432623981937,9341.85,9090.15,9643.9612,9193.9,10333.0,0,1329.0,2.897446528025433,1876777743.7543306
2020-02-29,8543.7,8697.1,8793.7,8539.8,683440.0,19345.5,0.1,8686.6,34.60043981921545,-194.09889110627125,10725.87571187496,8574.514288125043,9363.586483122028,5.1602023608769585,383.3786790800556,58835010.0,-13.767070056622627,-0.017683242311008818,4.487267566511647,4.487267566511647,9341.85,9090.15,9453.231408,9193.9,10333.0,0,1330.0,2.8976573230424116,1881561541.669183
2020-03-01,8540.0,8543.8,8737.2,8437.2,784050.0,19345.5,0.1,8593.733333333332,34.55263922189802,-189.7930258094587,10758.377364102631,8410.602635897372,9285.149675205645,5.731170206834997,377.4230591457659,58050960.0,-14.017901191063494,-0.0004330676404836753,4.419473760489061,4.419473760489061,9334.5,9090.15,9293.01838272,9193.9,10333.0,0,1331.0,2.8978675757267496,1886348964.028441
2020-03-02,8904.8,8537.5,8961.8,8503.1,1020000.0,19345.5,0.1,8662.833333333332,42.92478949877892,-153.82944201273952,10688.576050780437,8347.933949219565,9248.925896614632,26.069019345486918,383.2285549210682,59070960.0,-8.211186014389678,0.04271662763466044,4.303617767058983,4.303617767058983,9334.5,9227.85,9138.9710738304,9193.9,10333.0,0,1332.0,2.8980894290840555,1891327488.9662106
2020-03-03,8761.4,8906.1,8911.7,8669.3,1010000.0,19345.5,0.1,8735.4,40.71968925450428,-131.9902123991262,10594.63846716231,8286.241532837688,9202.494858841808,18.074371411049736,373.1693724267063,58060960.0,-13.752165695385102,-0.016103674422783154,4.259243641731987,4.259243641731987,9334.5,9227.85,9012.652280540928,9193.9,10333.0,0,1333.0,2.898306192431878,1896240135.4228
2020-03-04,8757.9,8761.3,8840.3,8679.7,759690.0,19345.5,0.1,8808.033333333331,40.6647804268478,-110.91977929620859,10496.72519881289,8236.434801187106,9160.152491333065,20.77341624562761,357.98584582479856,57301270.0,-8.861115158074385,-0.00039947953523411517,4.087576311956046,4.087576311956046,9257.325,9275.5,8961.8,9193.9,10333.0,0,1334.0,2.898522418592598,1901156991.7506742
2020-03-05,9060.3,8757.9,9147.3,8751.5,950760.0,19345.5,0.1,8859.866666666665,47.27955718024309,-71.6611278970238,10348.410677054886,8257.479322945113,9150.642730253725,40.36144578313245,360.6868568373129,58252030.0,-5.645463634091481,0.034528825403350005,3.9809593152248044,3.9809593152248044,9181.275000000001,9296.9,8437.2,9193.9,10333.0,0,1335.0,2.898747967488269,1906231498.7784116
2020-03-06,9134.8,9060.6,9165.2,9004.9,1040000.0,19345.5,0.1,8984.333333333332,48.79410086130634,-37.44117239028475,10274.01954720102,8254.580452798979,9149.13389880099,45.187200414561396,346.3735099203621,59292030.0,-5.676080334555224,0.008222685783031425,3.79180179008147,3.79180179008147,9130.550000000001,9362.6,8451.402,9193.9,9134.8,0,1336.0,2.8989754368175604,1911349322.955565
2020-03-07,8887.8,9134.2,9180.8,8848.7,750650.0,19345.5,0.1,9027.633333333331,44.254804438113666,-28.60528337855925,10185.58895033653,8238.56104966347,9124.244956058039,29.187718616401007,345.353973497479,58541380.0,-7.952815435442292,-0.02703945351841308,3.885708201101274,3.885708201101274,9134.45,9362.6,8479.95392,9193.9,9134.8,0,1337.0,2.8991946107168522,1916350859.811579
2020-03-08,8034.1,8887.8,8888.0,8015.3,1110000.0,19345.5,0.1,8685.566666666666,32.87217347332698,-74.79580678853193,10200.888971813865,8056.531028186133,9020.421626909654,0.956402299435325,383.02154681908763,57431380.0,-19.195993040119887,-0.09605301649452047,4.767448087764499,4.767448087764499,8923.5,9248.95,9180.8,9193.9,9134.8,0,1338.0,2.8993843970311186,1920904198.0491202
2020-03-09,7933.0,8035.8,8158.8,7648.7,1540000.0,19345.5,0.1,8284.966666666665,31.828117598462555,-104.8547873398114,10100.923215190636,7933.95678480936,8916.857662442068,14.049219213283271,392.0985791891529,55891380.0,-17.900793773996924,-0.012583861291246112,4.942626738801876,4.942626738801876,8740.2,9065.65,9180.8,9193.9,9134.8,0,1339.0,2.8995701537532446,1925404746.6635592
2020-03-10,7891.2,7933.0,8145.5,7740.2,1200000.0,19345.5,0.1,7952.7666666666655,31.38428684119421,-119.20371518189665,10083.924786694148,7779.135213305854,8819.175980304728,14.103757124578337,393.0415378184991,54691380.0,-15.305027261409016,-0.005269128954998092,4.980757525072221,4.980757525072221,8712.65,9065.65,9119.516,9193.9,9134.8,0,1340.0,2.8997540011958876,1929885498.0093684
2020-03-11,7935.1,7892.1,7976.5,7606.0,1100000.0,19345.5,0.1,7919.7666666666655,32.44967244120528,-117.21282866368699,10035.083737361514,7661.246262638488,8734.978267894754,20.897891795783625,391.43142797432057,55791380.0,-9.831483017624388,0.005563158961881642,4.932911090903965,4.932911090903965,8690.65,9044.3,9060.683359999999,9193.9,9134.8,0,1341.0,2.899939045346982,1934395334.2224252
2020-03-12,4826.0,7935.2,7963.1,4546.6,3220000.0,19345.5,0.1,6884.0999999999985,14.856306324602741,-306.0347708911765,10671.249892909485,6539.230107090518,8362.69462333335,6.029088084243229,607.5077545475833,52571380.0,-45.274760166012754,-0.3918161081775907,12.588225332523484,12.588225332523484,7126.225,7514.6,8973.402358399999,4826.0,9134.8,1,1342.0,2.8999812325250827,1936654367.3612626
2020-03-13,5584.3,4815.2,5934.3,3869.5,4170000.0,19345.5,0.1,6115.133333333331,25.469876861944385,-357.0501910968834,10790.63554022863,6012.70445977137,8098.085611587316,32.285881046071594,711.6000577941844,56741380.0,-35.794193733831555,0.15712805636137595,12.742869433844605,12.742869433844605,6787.674999999999,7176.05,8619.258169727998,4826.0,9134.8,1,1343.0,2.9000649461962693,1939573418.363143
2020-03-14,5182.7,5589.4,5634.9,5072.2,1690000.0,19345.5,0.1,5197.666666666665,23.779261836803954,-392.2251590819215,10824.117186545878,5503.222813454122,7820.42983905519,24.724643684220435,700.9643393803142,55051380.0,-39.338928099067154,-0.07191590709668183,13.525080351560273,13.525080351560273,6787.674999999999,7176.05,8144.282352755198,4826.0,9134.8,0,1344.0,2.900126983847044,1942152599.980487
2020-03-15,5366.3,5182.9,5863.3,5120.6,1610000.0,19345.5,0.1,5377.7666666666655,26.191326441348266,-377.38765120730966,10778.872314046286,5118.827685953715,7586.703187716601,28.181424510006977,703.9454579960059,56661380.0,-37.16276346604215,0.03542555038879347,13.117892365242453,13.117892365242453,6787.674999999999,7176.05,7716.804117479678,4826.0,9134.8,0,1345.0,2.900198697945096,1944888553.5752904
2020-03-16,5030.0,5366.4,5369.3,4477.7,2550000.0,19345.5,0.1,5192.999999999999,24.65241333004404,-364.2997596711708,10760.161194892118,4708.818805107881,7343.207646029306,21.849641330747655,717.3493538534341,54111380.0,-43.51361063695984,-0.06266887799787568,14.261418565674633,14.261418565674633,6652.0,7176.05,7332.07370573171,4826.0,9134.8,0,1346.0,2.9002515958244675,1947328638.7346103
2020-03-17,5261.1,5030.2,5432.8,4946.5,1890000.0,19345.5,0.1,5219.133333333332,27.792188497273372,-315.9541273686275,10723.879355393356,4391.180644606646,7144.9116797408005,26.200741814621665,700.8458285781887,56001380.0,-39.9513776337115,0.045944333996023934,13.321279363216604,13.321279363216604,6469.7,7176.05,6985.816335158539,4826.0,9134.8,0,1347.0,2.900317064122008,1949971626.0449777
2020-03-18,5361.4,5260.7,5373.1,5020.9,1800000.0,19345.5,0.1,5217.499999999999,29.17168867885124,-255.67121120244565,10633.174857376685,4136.165142623315,6975.053424527391,28.08916837685689,675.9425551083181,57801380.0,-38.78212813574031,0.01906445420159275,12.607575541991237,12.607575541991237,6466.375,7176.05,6674.1847016426855,4826.0,9134.8,0,1348.0,2.900387642650166,1952699339.5425863
2020-03-19,6172.0,5359.2,6379.5,5256.0,2180000.0,19345.5,0.1,5598.166666666665,39.269650208678954,-145.15395383539533,10489.248059162537,4027.5419408374614,6898.572146000973,43.35096868939808,707.9109440291525,59981380.0,-31.878635365274878,0.1511918528742493,11.469717174808043,11.469717174808043,6424.125,7176.05,6393.716231478417,4826.0,9134.8,0,1349.0,2.900498182184384,1956069000.5556548
2020-03-20,6205.3,6171.6,6858.1,5748.2,2220000.0,19345.5,0.1,5912.899999999999,39.650298833996345,-58.21891671989647,10346.959420723324,3935.9905792766776,6832.546227334214,43.9779338391731,736.6244480270701,62201380.0,-32.069667644611805,0.00539533376539203,11.870891786490098,11.870891786490098,6420.775,7176.05,3869.5,4826.0,9134.8,0,1350.0,2.9006099307559734,1959463499.2925622
2020-03-21,6186.2,6205.6,6438.3,5887.0,1640000.0,19345.5,0.1,6187.833333333332,39.49738013654677,6.166610410158569,10187.811273136798,3859.758726863199,6770.989443778573,46.163196174155615,723.386987453708,60561380.0,-30.39672359864083,-0.0030780139558119757,11.693559656230125,11.693559656230125,6067.35,7176.05,3929.272,4826.0,9134.8,0,1351.0,2.900720468568796,1962844139.5264003
2020-03-22,5822.1,6186.9,6394.4,5771.2,1480000.0,19345.5,0.1,6071.2,36.599618374477174,31.01219684414889,9951.40238233054,3787.8976176694596,6680.619020561567,45.522579441866974,716.2307740641575,59081380.0,-27.532642112993365,-0.05885681031974388,12.301931846999492,12.301931846999492,6143.35,7176.05,3987.84856,4826.0,9134.8,0,1352.0,2.900813349016999,1965946623.5691605
2020-03-23,6468.9,5822.0,6564.7,5710.8,1880000.0,19345.5,0.1,6159.066666666666,44.40295138059221,94.21506105308276,9714.926803016438,3795.1231969835603,6660.455304317607,60.79045837231057,726.064290202432,60961380.0,-18.455817471322327,0.11109393517802846,11.223921999140996,11.223921999140996,6096.525,7176.05,4045.2535887999998,4826.0,9134.8,0,1353.0,2.90093600127009,1969532720.9650953
2020-03-24,6744.6,6468.8,6814.2,6380.8,1730000.0,19345.5,0.1,6345.2,47.37613964977542,154.24885506315798,9468.290524657632,3840.4294753423687,6668.469084858787,70.00486973459948,705.1596980451153,62691380.0,-14.530109489051087,0.042619301581412694,10.455174480993911,10.455174480993911,6096.525,7176.05,4101.5105170239995,4826.0,9134.8,0,1354.0,2.9010702307528664,1973311707.947761
2020-03-25,6678.9,6744.8,6930.2,6474.6,1520000.0,19345.5,0.1,6630.799999999998,46.73474717901944,187.01035181515704,9124.480090279194,3946.099909720804,6669.462505348426,68.62907953879224,687.3340053276071,61171380.0,-15.830928406699357,-0.009741126234320885,10.29112586395375,10.29112586395375,6231.75,7176.05,4156.64230668352,4826.0,9134.8,0,1355.0,2.9012013178261706,1977046869.2885737
2020-03-26,6725.1,6677.9,6772.9,6541.7,1180000.0,19345.5,0.1,6716.2,47.27530179361799,207.6756513635503,8717.315347837768,4112.294652162233,6674.761314362862,93.29891854804458,654.7530049470637,62351380.0,39.3514297554911,0.006917306742128204,9.73595939015128,9.73595939015128,6250.349999999999,7176.05,4267.584614416179,4826.0,9134.8,0,1356.0,2.9013340263319707,1980815034.527163
2020-03-27,6373.4,6725.5,6813.7,6322.3,1160000.0,19345.5,0.1,6592.466666666664,43.64420944893154,193.80959644591871,8292.964699258418,4285.205300741584,6646.060236804495,77.2966360856269,643.0849331651306,61191380.0,14.130687821213034,-0.052296620124607895,10.090139221845963,10.090139221845963,6309.125,7176.05,4374.089229839532,4826.0,9134.8,0,1357.0,2.9014510655037458,1984335955.8465028
2020-03-28,6233.7,6373.4,6374.3,6046.5,1260000.0,19345.5,0.1,6444.066666666666,42.25586043996913,172.11445249923543,8036.10541248417,4362.024587515831,6606.787833299305,71.60040774719674,620.5645807961927,59931380.0,20.279005151754877,-0.021919226786330626,9.954995922103931,9.954995922103931,6422.825,7176.05,4476.333660645951,4826.0,9134.8,0,1358.0,2.901561450877223,1987754714.3675826
2020-03-29,5890.4,6233.2,6258.8,5889.3,916170.0,19345.5,0.1,6165.833333333332,38.97477373826232,133.26392251331447,7755.471713220426,4438.398286779573,6538.5604206041335,57.602446483180415,602.6313964536075,59015210.0,9.7665057861096,-0.0550716268027015,10.230738090004204,10.230738090004204,6422.825,7176.05,4574.488314220112,4826.0,9134.8,0,1359.0,2.9016553589101055,1990910902.8142636
2020-03-30,6391.0,5890.4,6576.5,5872.5,1430000.0,19345.5,0.1,6171.699999999998,45.607219980006434,139.24932895217432,7471.633762303664,4572.216237696336,6524.507047213264,72.8184705348591,609.8720109926355,60445210.0,27.057654075546722,0.08498573950835264,9.542669550815765,9.542669550815765,6422.825,7176.05,4668.716781651308,4826.0,9134.8,0,1360.0,2.901772201757447,1994445564.273791
2020-03-31,6412.5,6391.1,6513.1,6346.3,1050000.0,19345.5,0.1,6231.299999999998,45.879277181580136,142.1308467067472,7119.223497139909,4772.366502860091,6513.839709383429,72.88535065207145,578.2240102074472,61495210.0,21.88515709642469,0.0033641057737443525,9.017138560739918,9.017138560739918,6422.825,7176.05,4759.176110385256,4826.0,9134.8,0,1361.0,2.9018896688694844,1997996365.657322
2020-04-01,6638.5,6412.4,6661.3,6157.4,1400000.0,19345.5,0.1,6480.666666666665,48.77941203332256,155.64262054510095,7126.953241309049,4945.886758690951,6525.712118013579,82.57675307609605,572.9151523354868,62895210.0,23.82027082478458,0.035243664717348855,8.630189837094026,8.630189837094026,6463.25,7176.05,4846.017065969846,4826.0,9134.8,0,1362.0,2.902016669468402,2001709131.607362
2020-04-02,6800.5,6638.8,7182.7,6567.9,1740000.0,19345.5,0.1,6617.166666666665,50.814049022038404,170.66985194291357,7215.421609877313,4979.038390122688,6551.882392488476,74.03356206264013,575.9069271686664,64635210.0,10.183084899546339,0.02440310311064242,8.468596826243163,8.468596826243163,6453.175,7176.05,4929.384383331052,4826.0,9134.8,0,1363.0,2.9021501950316275,2005535438.2272234
2020-04-03,6735.9,6799.9,7026.3,6623.6,1350000.0,19345.5,0.1,6724.966666666666,49.96176888136884,171.00911674188598,7242.84834356964,5106.931656430359,6569.407878918145,69.64467694816221,563.5350037994759,63285210.0,8.550754999758261,-0.009499301521947001,8.366142665411838,8.366142665411838,6270.875,7176.05,5064.583320331189,4826.0,9134.8,0,1364.0,2.902280656835855,2009318425.5010223
2020-04-04,6857.4,6735.9,6958.6,6679.1,1050000.0,19345.5,0.1,6797.933333333332,51.605837678092946,173.61116667635804,7289.013013118914,5209.876986881087,6596.83569997356,77.8993138120796,543.2467892423705,64335210.0,10.849956354466391,0.018037678706631644,7.922051932837089,7.922051932837089,6267.55,7176.05,5191.670321111317,4826.0,9134.8,0,1365.0,2.902415863013523,2013186307.3351169
2020-04-05,6772.7,6857.5,6889.4,6686.0,842330.0,19345.5,0.1,6788.666666666665,50.36353880250501,163.94018549309249,7235.29105389886,5437.86894610114,6613.5846809284585,72.14484679665738,518.9720185822011,63492880.0,16.327441988286004,-0.012351620147577735,7.662704956401452,7.662704956401452,6225.3,7120.95,5311.132101844638,4826.0,9134.8,0,1366.0,2.9025471853061244,2016997283.734279
2020-04-06,7332.3,6772.8,7335.0,6770.1,1530000.0,19345.5,0.1,6987.466666666664,57.62203048072164,187.8277429408128,7295.559827686963,5584.720172313037,6682.033758935272,99.81538461538463,522.2525886834725,65022880.0,13.34693688262302,0.08262583607719232,7.122629852617493,7.122629852617493,6260.025,7119.65,5423.42617573396,4826.0,9134.8,0,1367.0,2.902700746086003,2021182574.5809898
2020-04-07,7185.2,7332.3,7440.3,7101.7,1320000.0,19345.5,0.1,7096.733333333333,55.33149194364719,185.96887659202636,7290.7821054023,5771.8778945977,6729.95435332239,83.72879193774713,509.134546634653,63702880.0,6.532633514218773,-0.02006191781569222,7.085878564753285,7.085878564753285,6155.65,7050.2,5576.352081675243,4826.0,9134.8,0,1368.0,2.9028481809769477,2025274829.019036
2020-04-08,7361.2,7185.6,7396.1,7153.1,983940.0,19345.5,0.1,7292.899999999999,57.5079075968441,188.2657219364373,7412.0930911910555,5769.486908808946,6790.072986339304,94.95471361143,490.12493616074926,64686820.0,10.215754091242573,0.024494794856093183,6.658220618387617,6.658220618387617,6378.925,7050.2,5762.746873507719,4826.0,7361.2,0,1369.0,2.903002138151771,2029483286.2704172
2020-04-09,7289.0,7361.1,7361.1,7140.3,963550.0,19345.5,0.1,7278.466666666666,56.29611571835728,176.77824261024142,7499.711008074995,5790.238991925005,6837.5898447831805,90.34953437938512,470.8945835778386,63723270.0,8.385005427428583,-0.009808183448350771,6.460345501136489,6.460345501136489,6378.925,7050.2,5930.502186156948,4826.0,7361.2,0,1370.0,2.903152931119278,2033647585.9554353
2020-04-10,6863.1,7289.0,7294.4,6756.1,1370000.0,19345.5,0.1,7171.0999999999985,49.64990618099949,134.27798720991646,7511.533942719812,5846.106057280187,6840.019383375258,63.184079601990064,475.7092561794215,62353270.0,7.683497034549859,-0.05843051173000402,6.931404994527568,6.931404994527568,6481.55,7050.2,6081.481967541253,4826.0,7361.2,0,1371.0,2.903286257381819,2037529135.198515
2020-04-11,6867.8,6862.7,6931.4,6765.1,845580.0,19345.5,0.1,7006.633333333331,49.72045047279023,101.74129754545804,7467.872590153077,5994.337409846924,6842.665156387138,63.48386273759408,453.6085950237485,63198850.0,10.172128912203032,0.0006848217277906077,6.60486029039501,6.60486029039501,6612.675,6925.25,6217.363770787128,4826.0,7361.2,0,1372.0,2.9034194330645833,2041415263.7779698
2020-04-12,6917.6,6867.9,7158.8,6785.1,1100000.0,19345.5,0.1,6882.833333333332,50.5116405269316,79.8014925353607,7484.3060019458835,6022.773998054118,6849.801808159792,66.66028830207935,447.90083823633785,64298850.0,17.438544071709913,0.007251230379451856,6.474801061586935,6.474801061586935,6645.150000000001,6925.25,6339.657393708415,4826.0,7361.2,0,1373.0,2.9035543156906582,2045337034.6617393
2020-04-13,6841.3,6918.1,6920.3,6618.5,1250000.0,19345.5,0.1,6875.566666666666,49.233352476219835,57.42443921220601,7490.119367590191,6026.630632409809,6848.992112144574,53.30890950190976,437.46506407659945,63048850.0,7.045845720544519,-0.011029836937666238,6.394472747527509,6.394472747527509,6688.775,6925.25,6449.721654337573,4826.0,7361.2,0,1374.0,2.9036857036148347,2049207465.7857819
2020-04-14,6850.9,6841.8,6970.8,6768.6,999530.0,19345.5,0.1,6869.933333333332,49.40683689138274,41.2974246380644,7498.823959485473,6035.126040514528,6849.173815749852,54.057214124249725,420.66041664255664,64048380.0,6.836647173489273,0.0014032420738747664,6.140221235787366,6.140221235787366,6802.475,6925.25,6548.779488903816,4826.0,7361.2,0,1375.0,2.903817146574562,2053085825.6829154
2020-04-15,6629.1,6851.3,6929.5,6615.9,1000000.0,19345.5,0.1,6773.7666666666655,45.53512110202154,15.071685429268747,7496.315272359424,6028.034727640576,6828.214404726057,7.01513067400283,413.01324402523124,63048380.0,-0.14159825261730263,-0.03237530835364688,6.230306437151819,6.230306437151819,6801.825000000001,6925.25,7440.3,6629.1,7361.2,0,1376.0,2.9039389089137697,2056808375.7481644
2020-04-16,7085.6,6629.1,7159.7,6520.5,1540000.0,19345.5,0.1,6855.2,53.59526253455193,27.144227797324202,7522.0647781934595,6073.505221806542,6852.7273185616705,61.43726897151557,429.16944088057187,64588380.0,4.1923387986177545,0.06886304324870651,6.056924478951279,6.056924478951279,6766.925,6770.9,7423.812,6629.1,7361.2,0,1377.0,2.904079226476416,2060850035.5668578
2020-04-17,7035.8,7085.5,7142.8,7005.8,810100.0,19345.5,0.1,6916.833333333332,52.67937949813994,30.21577810013003,7520.414287919457,6155.365712080542,6870.162812031987,56.02304848880192,408.30019510338815,63778280.0,4.452263246188343,-0.007028339166760822,5.803180805358141,5.803180805358141,6758.175,6618.8,7387.67952,6629.1,7361.2,0,1378.0,2.9042171939442785,2064859641.6957362
2020-04-18,7230.8,7035.9,7259.4,7031.5,796450.0,19345.5,0.1,7117.399999999999,55.860164226688894,43.03836144451152,7451.902573624138,6357.917426375863,6904.509210886084,77.22330941509024,395.41446688171754,64574730.0,5.445212471199005,0.02771539839108561,5.468474676131514,5.468474676131514,6781.924999999999,6525.15,7352.9923392,6629.1,7361.2,0,1379.0,2.904362563580159,2069001984.2378023
2020-04-19,7122.9,7230.9,7238.0,7079.1,5930000.0,19345.5,0.1,7129.833333333332,53.70886253678361,41.87205888135556,7442.032052116021,6440.977947883979,6925.308333658838,65.49249836921065,378.52057639016624,58644730.0,5.170759076882186,-0.014922276926481293,5.314135764789149,5.314135764789149,6773.174999999999,6525.15,7319.692645632,6629.1,7361.2,1,1380.0,2.904503318239834,2073074083.6118932
2020-04-20,6833.5,7122.9,7207.5,6771.2,1260000.0,19345.5,0.1,7062.399999999999,48.33237089268001,20.320592273752673,7404.277399137685,6520.832600862315,6916.564682834187,34.02913676886279,382.64767807658296,57384730.0,-6.802776754906375,-0.040629518875738735,5.599585542936753,5.599585542936753,6773.174999999999,6525.15,7287.72493980672,6629.1,7361.2,0,1381.0,2.904631971089753,2076948300.6263468
2020-04-21,6842.5,6833.4,6919.3,6774.3,892570.0,19345.5,0.1,6932.966666666666,48.50501296462225,6.118739403990336,7392.972598274931,6552.537401725069,6909.510903516646,36.77478300593877,365.6728439282556,58277300.0,-4.769526248399485,0.0013170410477794103,5.344140941589413,5.344140941589413,6773.174999999999,6525.15,7257.035942214451,6629.1,7361.2,0,1382.0,2.904760657174545,2080829998.1455665
2020-04-22,7112.9,6842.5,7137.4,6821.8,914180.0,19345.5,0.1,6929.633333333331,53.52910935939511,13.935958111452464,7405.029124544508,6571.720875455492,6928.881293657918,70.47347133000231,362.09621221909447,59191480.0,-3.3730913438026437,0.039517720131530876,5.090697355777453,5.090697355777453,6773.174999999999,6525.15,7227.574504525873,6629.1,7361.2,0,1383.0,2.904899978502753,2084899983.7427914
2020-04-23,7488.5,7112.8,7655.4,7036.5,1340000.0,19345.5,0.1,7147.966666666664,59.44762600602262,41.826368147355424,7479.009271392608,6573.000728607392,6982.178313309545,85.2938584897348,380.43933991773054,60531480.0,2.737000960351214,0.05280546612492798,5.080314347569346,5.080314347569346,6925.95,6525.15,6520.5,6629.1,7361.2,0,1384.0,2.9050535187984106,2089220594.6634688
2020-04-24,7503.8,7491.3,7583.5,7423.5,951950.0,19345.5,0.1,7368.399999999999,59.67293525528894,57.74736921767035,7549.2492543406715,6567.400745659328,7031.856569184826,86.64199488941762,364.69367278074975,61483430.0,9.33543151054188,0.0020431328036323304,4.860119843022865,4.860119843022865,6925.95,6525.15,6543.198,6629.1,7361.2,0,1385.0,2.9052072765724706,2093553586.1739671
2020-04-25,7540.4,7503.9,7684.6,7451.0,861930.0,19345.5,0.1,7510.899999999999,60.24199990147475,66.55926975380454,7611.759438015364,6581.660561984638,7080.289276881509,87.61274804570049,355.3298390106962,62345360.0,9.793529223332063,0.004877528718782331,4.71234734245791,4.71234734245791,7074.45,6525.15,6565.44204,6629.1,7361.2,0,1386.0,2.9053620507965063,2097912710.311859
2020-04-26,7678.9,7540.4,7679.4,7520.5,921590.0,19345.5,0.1,7574.366666666666,62.404020222432344,76.8047073178943,7680.399530333816,6547.680469666186,7137.299821940413,99.51035134438617,341.2991362242179,63266950.0,11.005261940557407,0.018367725850087613,4.444635771063797,4.444635771063797,7074.45,6525.15,6610.2083584,6629.1,7361.2,0,1387.0,2.905521612269007,2102362946.2316246
2020-04-27,7766.0,7679.4,7768.5,7637.7,980500.0,19345.5,0.1,7661.7666666666655,63.73945485594155,83.95629396778692,7776.631458367777,6509.528541632223,7197.176029374659,99.79967948717949,326.26348363677374,64247450.0,13.51643693450075,0.011342770448892425,4.201178002018719,4.201178002018719,7207.175,6525.15,6653.184024064,6629.1,7361.2,0,1388.0,2.9056839982842355,2106871013.9663575
2020-04-28,7746.9,7766.0,7770.1,7655.3,808090.0,19345.5,0.1,7730.5999999999985,63.20922813481689,81.82502753888821,7843.029570181184,6481.700429818816,7249.53069324374,98.14340588988472,311.1589490912899,63439360.0,13.078573618064782,-0.0024594385784187933,4.016560806145554,4.016560806145554,7207.975,6378.75,6720.10298262016,6629.1,7361.2,0,1389.0,2.9058453211804673,2111370095.6051815
2020-04-29,8770.9,7746.7,8918.5,7729.7,1830000.0,19345.5,0.1,8094.5999999999985,75.14625881338878,140.36888248584873,8214.014942496802,6258.905057503196,7394.423008172907,93.84487072560466,373.84759558476924,65269360.0,32.3090615619013,0.13218190502007254,4.262362991081522,4.262362991081522,7782.95,6394.0,6804.102744010547,6629.1,7361.2,0,1390.0,2.9060413630482365,2116479597.392518
2020-04-30,8629.0,8770.6,9437.5,8425.5,2040000.0,19345.5,0.1,8382.266666666665,71.67572235293085,159.14881910140218,8458.061503069634,6191.448496930367,7512.001769299297,69.67708059858231,419.4299101858572,63229360.0,21.782206164615552,-0.016178499355824383,4.860701242158502,4.860701242158502,8054.325,6653.5,7015.542469609492,6629.1,7361.2,0,1391.0,2.906232401544347,2121514365.7238696
2020-05-01,8821.6,8628.6,9040.3,8621.0,1110000.0,19345.5,0.1,8740.499999999998,73.46688899318733,173.0053029479618,8707.963456460238,6136.926543539761,7636.725410318411,76.90057382890149,419.42063088686734,64339360.0,25.38161971630803,0.022320083439564264,4.754473461581429,4.754473461581429,8108.0,6653.5,7306.177373256353,6629.1,7361.2,0,1392.0,2.9064292842928183,2126662544.3015828
2020-05-02,8966.3,8821.6,8986.2,8771.3,890340.0,19345.5,0.1,8805.633333333331,74.75837977063925,179.59830202439736,8951.873322479087,6097.886677520912,7763.351561716658,82.32757004088059,404.81201439494833,65229700.0,24.001493610665474,0.016402920105196284,4.514816751558038,4.514816751558038,8204.75,6653.5,7561.936088465591,6629.1,7361.2,0,1393.0,2.906630365669722,2131896204.5937002
2020-05-03,8885.5,8966.2,9169.9,8742.2,1150000.0,19345.5,0.1,8891.133333333331,72.63239089057485,166.49284960780187,9134.181052192896,6119.998947807102,7870.222841553166,79.29715335858681,406.44687050959476,64079700.0,24.745539036066777,-0.009011520917212135,4.574271234140957,4.574271234140957,8211.625,6653.5,7787.0037578497195,6629.1,7361.2,0,1394.0,2.906828492784036,2137090838.1315372
2020-05-04,8874.7,8885.5,8945.5,8553.2,1120000.0,19345.5,0.1,8908.833333333334,72.33628001588511,145.81556447415062,9284.293410739087,6172.266589260914,7965.887332833817,78.86752778612198,405.43637975890937,62959700.0,29.870490963635042,-0.0012154633954194471,4.5684516632552015,4.5684516632552015,8229.0,6957.6,7985.063306907753,6629.1,7361.2,0,1395.0,2.90702588045727,2142284917.4533312
2020-05-05,9001.0,8874.2,9078.7,8800.4,1050000.0,19345.5,0.1,8920.4,73.68727614059942,129.89339728103192,9411.241499097918,6282.508500902082,8064.469491611549,83.3123064571625,396.3552097761302,64009700.0,31.54548776032152,0.014231466979165441,4.403457502234532,4.403457502234532,8258.3,6957.6,8159.355710078823,6629.1,7361.2,0,1396.0,2.9072268595397284,2147554483.5925474
2020-05-06,9151.4,9000.6,9373.7,8923.6,1620000.0,19345.5,0.1,9009.033333333331,75.23808045496226,119.02826457636183,9571.589194065164,6328.740805934835,8167.986682886639,88.0841316118284,400.19412336354947,65629700.0,28.659196670837495,0.016709254527274675,4.373037167685267,4.373037167685267,8262.7,6957.6,8312.733024869363,6629.1,7361.2,0,1397.0,2.9074321142622277,2152912092.6082234
2020-05-07,9979.8,9152.7,10033.0,9064.8,1910000.0,19345.5,0.1,9377.399999999998,81.65236499915876,154.8994379046373,9885.944333745041,6308.78566625496,8340.54033213553,97.96129526729256,440.76597169472456,67539700.0,33.26834479535287,0.09052166881570023,4.416581210993453,4.416581210993453,8579.05,7489.75,8447.705061885039,6629.1,9979.8,0,1398.0,2.907661401923168,2158707353.644437
2020-05-08,9806.2,9980.1,10018.2,9731.4,1420000.0,19345.5,0.1,9645.8,77.1426138519226,153.88524994426416,10114.659718689125,6337.610281310873,8480.126967170241,91.21611154144077,429.76840228795857,66119700.0,30.683120552253527,-0.01739513817912164,4.382619182639131,4.382619182639131,8753.0,7526.95,8669.646353221133,6629.1,9979.8,0,1399.0,2.90788532104696,2164422903.2014008
2020-05-09,9554.6,9806.0,9910.5,9533.6,1490000.0,19345.5,0.1,9780.199999999999,71.02034773535216,124.4766841349225,10249.5434204047,6445.896579595299,8582.457732201647,80.95920398009952,425.9920878388187,64629700.0,26.71211076335474,-0.02565723725806124,4.458502583455285,4.458502583455285,8784.925,7644.5,8860.515863770173,6629.1,9979.8,0,1400.0,2.9081014980926523,2170015862.311607
2020-05-10,8738.8,9553.9,9569.4,8259.3,2470000.0,19345.5,0.1,9366.533333333333,55.60955386523287,42.523084527322226,10218.55446163754,6667.415538362458,8597.347471991967,45.96918966309019,489.1426529931888,62159700.0,13.802758207555765,-0.08538295690034126,5.597366377456732,5.597366377456732,8711.45,7871.9,10033.0,6629.1,9979.8,0,1401.0,2.9082921198889555,2175168043.9238195
2020-05-11,8579.8,8737.6,9129.6,8235.6,2290000.0,19345.5,0.1,8957.733333333332,53.18714737222907,-26.25005830095722,10146.60539955796,6913.09460044204,8595.676284183208,38.88211296631195,518.0610349222468,59869700.0,10.479011073911915,-0.018194717810225636,6.038148149400299,6.038148149400299,8705.525,7871.9,9997.526,8579.8,9979.8,0,0.0,2.9084771810507344,2180232966.221084
2020-05-12,8813.8,8569.8,8964.5,8542.8,1350000.0,19345.5,0.1,8710.799999999997,56.21038415399157,-58.01657330550108,10097.98079451757,7131.80920548243,8616.449971403854,47.067251335041,511.1781038563721,61219700.0,13.771960397062047,0.02727336301545491,5.799747031432211,5.799747031432211,8768.2,7871.9,9927.04896,8579.8,9979.8,0,1.0,2.9086694349389868,2185438073.0462546
2020-05-13,9298.7,8813.9,9384.6,8799.1,1500000.0,19345.5,0.1,8897.433333333332,61.726420813951094,-48.77871436146893,10121.928896692112,7288.881103307889,8681.426164603487,59.14654500945814,516.486810723774,62719700.0,6.017626469347514,0.055015997640064596,5.554398041917407,5.554398041917407,8768.2,7871.9,9859.3910016,8579.8,9979.8,0,2.0,2.908876374843765,2190918701.107344
2020-05-14,9778.4,9298.7,9887.5,9265.8,1770000.0,19345.5,0.1,9296.966666666665,66.25505233645808,-14.545047338789573,10196.195142876772,7442.074857123228,8785.899863212679,85.83509513742071,524.0020385292188,64489700.0,13.32019932784795,0.0515878563670189,5.3587707450014195,5.3587707450014195,8768.2,7952.75,8235.6,8579.8,9979.8,0,3.0,2.909097068423896,2196660122.0522676
2020-05-15,9318.0,9778.6,9819.6,9223.2,1560000.0,19345.5,0.1,9465.033333333333,59.035186503176355,-26.400912105409645,10167.95017178456,7648.079828215439,8836.576066716232,60.220318237454094,529.1733214914174,62929700.0,5.6270971252380475,-0.047083367422073086,5.67904401686432,5.67904401686432,8768.2,7952.75,8268.638,8579.8,9979.8,0,4.0,2.909303780167636,2202164301.176642
2020-05-16,9379.5,9318.1,9579.0,9233.0,1100000.0,19345.5,0.1,9491.966666666665,59.66743879387865,-33.15668670751336,10133.584836173985,7852.505163826015,8888.283107981353,63.641927228218535,516.089512813459,64029700.0,4.608366884891212,0.006600128783000647,5.5023136927710325,5.5023136927710325,8765.275000000001,7952.75,8301.01524,8579.8,9979.8,0,5.0,2.9095119406442533,2207708210.3998003
2020-05-17,9677.7,9376.6,9866.0,9327.8,1180000.0,19345.5,0.1,9458.4,62.67552542187507,-21.180462910078404,10116.690191039306,8060.569808960696,8963.465669125986,80.23255813953492,517.6688333267834,65209700.0,8.915649091216034,0.03179273948504724,5.349089487448293,5.349089487448293,8750.224999999999,7952.75,8332.7449352,8579.8,9979.8,0,6.0,2.9097284989130956,2213417996.8717303
2020-05-18,9730.7,9678.4,9930.2,9524.4,1180000.0,19345.5,0.1,9595.966666666665,63.200847040350595,-13.691015464914074,10048.026969513596,8327.613030486404,9036.535605399702,83.18126182263272,509.6782023748704,66389700.0,9.645396464105827,0.005476507847939072,5.237836973443538,5.237836973443538,8808.825,7952.75,8363.840036496,8579.8,9979.8,0,7.0,2.9099461829722943,2219162770.6093183
2020-05-19,9773.3,9730.8,9883.9,9498.7,1160000.0,19345.5,0.1,9727.233333333332,63.64377063746872,-10.038900834901256,10111.839812106491,8364.04018789351,9106.703642980683,85.5513519528207,500.78690220523674,67549700.0,8.580157760248854,0.004377896759739652,5.124030800295057,5.124030800295057,8905.575,7952.75,8426.49443503616,8579.8,9979.8,0,8.0,2.91016468438511,2224937111.133161
2020-05-20,9512.3,9773.0,9829.3,9368.4,1150000.0,19345.5,0.1,9672.099999999999,58.961314229627746,-28.33556400505347,10116.845552447141,8447.364447552858,9145.331867458712,71.0303772115277,497.93783776200553,66399700.0,3.9436588937211754,-0.026705411682850233,5.234673399304118,5.234673399304118,8989.25,7952.75,8486.642657634713,8579.8,9979.8,0,9.0,2.9103751702553677,2230579857.3060308
2020-05-21,9059.0,9511.6,9567.1,8833.6,1410000.0,19345.5,0.1,9448.199999999999,51.82914296136542,-71.63770883475183,10108.696056251621,8479.25394374838,9137.109784843597,46.19095702905865,514.7637064932908,64989700.0,-9.226637808372907,-0.04765408996772591,5.682345805202459,5.682345805202459,9070.7,8095.2,8544.384951329324,8579.8,9979.8,0,10.0,2.910571538368996,2235978200.3778625
2020-05-22,9169.7,9058.2,9253.5,8952.1,914590.0,19345.5,0.1,9246.999999999998,53.31434206066367,-92.18639592418413,10107.246088219756,8501.043911780245,9140.213614858492,55.122152720406,499.52344174377,65904290.0,-6.490791540046093,0.012219891820289375,5.447543995373567,5.447543995373567,9108.625,8095.2,8599.81755327615,8579.8,9979.8,0,11.0,2.9107709249888596,2241444745.39094
2020-05-23,9177.0,9169.8,9303.2,9098.9,812560.0,19345.5,0.1,9135.233333333332,53.41634057089599,-103.78509537246612,10101.2173344362,8536.222665563802,9143.717080110064,55.55293284550923,478.4360530477865,66716850.0,-3.9520231092876763,0.0007961001995702155,5.213425444565615,5.213425444565615,9113.025000000001,8276.75,8653.032851145104,8579.8,9979.8,0,12.0,2.9109701407228745,2246921254.7066464
2020-05-24,8728.2,9177.9,9292.0,8724.1,1110000.0,19345.5,0.1,9024.966666666665,46.66600124194772,-138.0367822076439,10112.893270677958,8509.896729322043,9104.144024861485,29.068806798064454,484.8263349729446,65606850.0,-0.12129811873482109,-0.04890487087283413,5.554711566794351,5.554711566794351,9104.25,8276.75,8704.119537099301,8579.8,9979.8,0,13.0,2.911154891331706,2252144113.541543
2020-05-25,8898.2,8728.0,8959.5,8666.1,941890.0,19345.5,0.1,8934.466666666665,49.28060736101542,-144.88640853451489,10116.915724285911,8495.594275714091,9084.530308208012,25.616260631396937,471.1530253320199,66548740.0,3.711042215436274,0.019477097225086393,5.294925100941987,5.294925100941987,9216.225,8276.75,9930.2,8579.8,9979.8,0,14.0,2.911344672057444,2257471820.5616693
2020-05-26,8842.5,8897.7,8994.6,8713.9,784920.0,19345.5,0.1,8822.966666666665,48.442651789914294,-148.2753067614707,10124.137272804484,8457.482727195518,9061.479802664391,13.954592199984146,457.5492378083042,65763820.0,0.3256257232975644,-0.0062596929716123295,5.174432997549383,5.174432997549383,9216.225,8276.75,9904.918000000001,8579.8,9979.8,0,15.0,2.911532305837373,2262772078.392691
2020-05-27,9199.1,8842.3,9210.9,8818.6,810890.0,19345.5,0.1,8979.933333333332,53.85271035961147,-122.66746380675642,10023.189363036987,8480.360636963012,9074.586488124925,42.16438572897712,452.8885779648539,66574710.0,-1.0711174680331697,0.04032796154933571,4.923183550182668,4.923183550182668,9204.65,8276.75,9880.141640000002,8579.8,9979.8,0,16.0,2.911730641528993,2268283292.59877
2020-05-28,9572.2,9199.8,9610.8,9119.2,948860.0,19345.5,0.1,9204.599999999999,58.7319679632452,-78.89485526615636,9984.111006857036,8496.038993142965,9121.978251160646,71.67945573926114,455.6536795387928,67523570.0,-2.108729444489885,0.040558315487384755,4.760177174931497,4.760177174931497,9191.0,8276.75,9855.860807200002,8579.8,9979.8,0,17.0,2.911939729289972,2274007897.427515
2020-05-29,9424.8,9573.4,9596.5,9358.1,814330.0,19345.5,0.1,9398.699999999999,56.203665058464594,-59.06883271996887,9968.745233622414,8498.424766377588,9150.818417716775,60.01898583972776,440.1355595717361,66709240.0,1.1461687057308358,-0.015398758905998733,4.669972408663697,4.669972408663697,9136.375,8276.75,9832.065591056002,8579.8,9979.8,0,18.0,2.912144066715677,2279658012.7980995
2020-05-30,9692.5,9424.8,9729.9,9352.7,720620.0,19345.5,0.1,9563.166666666666,59.604771259160366,-28.666037146560313,10005.509800342234,8557.030199657767,9202.407139838988,81.19610790285574,435.64016245946914,67429860.0,3.337064875526414,0.028403785756726974,4.494610910079641,4.494610910079641,9166.15,8276.75,9808.746279234882,8579.8,9979.8,0,19.0,2.912355853522074,2285461347.530207
2020-05-31,9454.8,9692.9,9695.6,9406.2,645270.0,19345.5,0.1,9524.033333333331,55.484554874345875,-25.41580152427474,9976.539407538834,8673.500592461167,9226.444555092417,62.392215805711466,425.19443656950705,66784590.0,-2.303233206237034,-0.02452411658498843,4.497127771814392,4.497127771814392,9166.15,8276.75,9785.893353650185,9454.8,9979.8,0,20.0,2.912560282560415,2291141137.01
2020-06-01,10189.3,9454.5,10301.8,9429.7,796680.0,19345.5,0.1,9778.866666666667,63.80949228127259,22.746813347361552,10102.797356766003,8684.792643233997,9318.145073655043,93.12221067432903,457.11626252882786,67581270.0,4.7129189061424,0.07768540846977201,4.486238137348276,4.486238137348276,9376.325,8411.15,8666.1,9454.8,10189.3,0,21.0,2.9127852631620916,2297221447.163438
2020-06-02,9527.6,10190.7,10207.3,9347.3,1060000.0,19345.5,0.1,9723.9,54.01009785377779,7.3808067675493305,10115.122056119004,8695.357943880996,9338.093161878372,52.66858225836037,485.8936723481973,66521270.0,-2.513992203247613,-0.0649406730589932,5.099853817836573,5.099853817836573,9376.325,8411.15,8698.814,9454.8,10189.3,0,22.0,2.9129910339979164,2302955277.0944448
2020-06-03,9667.2,9527.0,9667.2,9421.7,558120.0,19345.5,0.1,9794.699999999999,55.56066462073102,4.122074137409982,10099.454113839422,8699.905886160579,9369.436670270909,61.2031546127041,468.7226957518975,67079390.0,1.6284179430842327,0.014652168436962043,4.848587964993975,4.848587964993975,9388.275,8411.15,8730.87372,9454.8,10189.3,0,23.0,2.913200477574472,2308772621.6010323
2020-06-04,9794.4,9667.2,9864.4,9490.9,593660.0,19345.5,0.1,9663.066666666666,56.98380060188483,7.822040339216585,10142.694474394613,8704.305525605387,9409.909368340344,68.97964174359602,461.92107462676194,67673050.0,8.11789380726349,0.013157894736842035,4.71617531065468,4.71617531065468,9414.45,8411.15,8762.2922456,9454.8,10189.3,0,24.0,2.9134131775259022,2314666153.5560656
2020-06-05,9631.2,9794.0,9846.1,9628.7,527050.0,19345.5,0.1,9697.599999999999,54.569206108015464,-2.8608517705335146,10160.548816280527,8711.621183719475,9430.984666593646,59.00226202848939,444.45528358199317,67146000.0,5.032880028790473,-0.016662582700318396,4.614744617306184,4.614744617306184,9489.6,8411.15,8793.082400688,9454.8,10189.3,0,25.0,2.9136207744871583,2320477480.9384394
2020-06-06,9669.6,9630.8,9733.1,9549.5,370850.0,19345.5,0.1,9698.4,55.051820923683195,-9.126464485146556,10159.611940447263,8711.748059552734,9453.70993644187,61.34988078498506,425.82276332613657,67516850.0,5.367767244197454,0.0039870421131322775,4.40372676559668,4.40372676559668,9623.425,8411.15,8823.256752674239,9454.8,10189.3,0,26.0,2.9138290851289037,2326316746.957119
2020-06-07,9742.6,9669.6,9791.8,9417.4,549200.0,19345.5,0.1,9681.133333333331,56.008562822443,-10.066066053129418,10161.194757973075,8711.355242026924,9481.223275828359,65.81280185853156,422.1497088028411,68066050.0,11.622098485369257,0.007549433275419792,4.333029261212007,4.333029261212007,9654.25,8536.5,8852.827617620755,9454.8,10189.3,0,27.0,2.9140390988054423,2332202993.1902876
2020-06-08,9777.9,9743.4,9788.2,9662.3,431040.0,19345.5,0.1,9730.033333333333,56.49084352322304,-10.001154874808776,10161.855123664249,8711.15487633575,9509.478201939944,67.00673845960074,400.98901531692394,68497090.0,9.886269133083083,0.003623262784061776,4.100972758127246,4.100972758127246,9654.25,8536.5,8881.80706526834,9454.8,10189.3,0,28.0,2.9142497225643367,2338115569.386515
2020-06-09,9768.8,9777.7,9857.2,9616.6,479550.0,19345.5,0.1,9763.099999999999,56.31943146676242,-12.120746937501025,10188.525438568002,8710.134561431998,9534.175516040903,64.06418554476804,389.53265708000083,68017540.0,10.475544246536604,-0.0009306701848045273,3.9875179866513886,3.9875179866513886,9654.25,8536.5,8910.206923962973,9454.8,10189.3,0,29.0,2.9144596852066393,2344030188.9839196
2020-06-10,9878.8,9768.8,9970.9,9710.7,533550.0,19345.5,0.1,9808.499999999998,57.979259088005584,-7.870121397681032,10229.310237012463,8751.329762987536,9566.99689546558,64.2313546423135,380.294610145715,68551090.0,7.388766292354674,0.01126033903857171,3.849603293372829,3.849603293372829,9630.625,8536.5,8938.038785483714,9454.8,10189.3,0,30.0,2.914672375025023,2350012027.699511
2020-06-11,9283.2,9878.9,9945.2,9139.1,919300.0,19345.5,0.1,9643.599999999999,47.46269670459601,-44.861397681971,10226.746701947888,8765.24329805211,9539.968619706953,12.393566698202502,410.7092808495926,67631790.0,-3.019159649819268,-0.06029072356966414,4.424220967442181,4.424220967442181,9519.475,8538.05,8965.31400977404,9454.8,10189.3,0,31.0,2.9148672990086086,2355665961.911733
2020-06-12,9466.6,9283.7,9547.5,9249.4,529280.0,19345.5,0.1,9542.866666666667,50.44348559625531,-55.946946899387996,10226.701653720549,8794.248346279452,9532.981132115816,28.167197041369253,402.6657607889074,68161070.0,0.4435107376283963,0.019756118579800086,4.253541512146994,4.253541512146994,9519.475,8561.8,8992.04372957856,9454.8,10189.3,0,32.0,2.9150672966363858,2361431394.330862
2020-06-13,9471.3,9466.5,9484.9,9369.9,364970.0,19345.5,0.1,9407.033333333333,50.52096172314285,-61.49086757597365,10168.415586494832,8926.84441350517,9527.106738580977,28.571428571428505,382.1182064468426,68526040.0,-2.282176940933719,0.0004964823695940979,4.034485302406667,4.034485302406667,9519.475,8669.15,9018.238854986988,9454.8,10189.3,0,33.0,2.915267041283995,2367205765.039482
2020-06-14,9345.3,9470.7,9474.7,9264.4,311270.0,19345.5,0.1,9427.733333333332,48.33911991616274,-71.47159989502927,10124.251525328498,9015.7184746715,9509.791811097073,17.734583297497128,369.84547741492537,68214770.0,-1.1581418961797183,-0.013303348009249039,3.9575559630501473,3.9575559630501473,9519.475,8862.65,9043.910077887249,9454.8,10189.3,0,34.0,2.9154626583845897,2372913731.2689776
2020-06-15,9425.4,9345.5,9489.7,8925.6,750900.0,19345.5,0.1,9413.999999999998,49.82268207732216,-70.3943145695147,10048.738425632488,9149.521574367514,9501.754495754494,38.99508465319495,383.72080045671646,68965670.0,-7.497080270479814,0.008571153414015598,4.071135447373231,4.071135447373231,9466.1,8876.4,10301.8,9454.8,10189.3,0,35.0,2.9156602683640975,2378674033.7995777
2020-06-16,9523.5,9425.6,9577.1,9379.3,545470.0,19345.5,0.1,9431.4,51.65384530902402,-61.13339025975503,10027.944912716726,9202.755087283274,9503.825496158828,57.19889027073568,370.4407432812368,69511140.0,-0.04303287291658302,0.010408046342860855,3.889754221465184,3.889754221465184,9466.1,8911.15,10274.276,9454.8,10189.3,0,36.0,2.915860376430952,2384496862.8210697
2020-06-17,9464.6,9523.6,9543.6,9258.2,446450.0,19345.5,0.1,9471.166666666664,50.463084910258715,-57.10863039032755,10027.452349806219,9192.48765019378,9500.089734619893,51.5641442648044,364.36640447543414,69064690.0,-2.0957464415756406,-0.006184701002782567,3.849781337567717,3.849781337567717,9466.1,8969.75,10247.30248,9454.8,10189.3,0,37.0,2.916058364143539,2390292143.465753
2020-06-18,9388.1,9464.6,9480.4,9289.3,391670.0,19345.5,0.1,9458.733333333332,48.88676680245943,-57.56981027633664,10029.164354201963,9187.105645798034,9489.424045608475,44.245671099206,351.99023272718887,68673020.0,-4.148288818100132,-0.00808275045960738,3.749323427820207,3.749323427820207,9466.1,8978.55,10220.8684304,9454.8,10189.3,0,38.0,2.916253701153254,2396049187.643684
2020-06-19,9314.0,9390.3,9424.0,9249.6,478490.0,19345.5,0.1,9388.9,47.34408191995845,-60.53413884631473,10027.060069772433,9151.359930227565,9472.716993645763,37.15679709174399,339.30521610381817,68194530.0,-3.2934629122020174,-0.007892970888678241,3.642959159371035,3.642959159371035,9459.675000000001,9015.75,10194.963061792,9454.8,10189.3,0,39.0,2.916446443747844,2401768754.4190674
2020-06-20,9358.8,9314.0,9394.5,9199.8,383440.0,19345.5,0.1,9353.633333333333,48.40417729387082,-57.18610774024849,10030.083723254722,9138.736276745278,9461.867756155689,41.44264804362376,328.9762720964026,68577970.0,-3.2141970712335675,0.004809963495812752,3.5151544225371056,3.5151544225371056,9379.599999999999,9268.7,10169.57580055616,9454.8,10189.3,0,40.0,2.9166401384512373,2407520482.674033
2020-06-21,9296.4,9358.8,9411.2,9288.5,335990.0,19345.5,0.1,9323.066666666666,46.98528041874169,-56.768036057058154,9905.912419900416,9173.617580099586,9446.108922236099,35.47306993207687,314.2422526609453,68241980.0,-4.5798862726582295,-0.006667521477112359,3.380257440094503,3.380257440094503,9405.775000000001,9268.7,10144.696284545036,9454.8,10189.3,0,41.0,2.9168315853664266,2413241247.462666
2020-06-22,9683.7,9296.5,9751.9,9285.8,523320.00000000006,19345.5,0.1,9446.299999999997,55.67096170828239,-29.380132929872104,9918.964830873734,9176.175169126265,9468.7366439279,72.5246340763418,325.08923461373496,68765300.0,-0.9633970484459742,0.04166128824060933,3.3570766815755855,3.3570766815755855,9476.225,9268.7,10120.314358854135,9454.8,9683.7,0,42.0,2.9170340114936018,2419193019.377514
2020-06-23,9624.6,9683.9,9715.6,9581.8,375490.0,19345.5,0.1,9534.9,54.21139918176067,-14.945022946611388,9914.547612492252,9176.332387507746,9483.580773077623,66.87075480723242,311.42571785561114,68389810.0,-1.476128081238217,-0.006103039127606236,3.2357263455687626,3.2357263455687626,9476.225,9268.7,10096.420071677052,9454.8,9683.7,0,43.0,2.9172343420179643,2425117546.5680547
2020-06-24,9302.0,9624.6,9667.4,9223.0,515780.0,19345.5,0.1,9536.766666666665,46.97211447401531,-26.167076772461854,9885.88470987995,9155.755290120049,9466.28736611785,36.91643781875241,320.9238808659246,67874030.0,-5.8387658420050945,-0.03351827608420099,3.4500524711451797,3.4500524711451797,9544.775,9268.7,10073.003670243512,9454.8,9683.7,0,44.0,2.917424797286277,2430859533.018701
2020-06-25,9247.5,9300.8,9327.3,9022.6,524450.0,19345.5,0.1,9391.366666666667,45.857982075980146,-35.71310947635,9881.50866465673,9121.761335343266,9445.450474106627,38.95679535277743,319.76503223264416,67349580.0,-0.38456566701138317,-0.0058589550634272625,3.45785382246709,3.45785382246709,9500.475,9268.7,10050.055596838642,9454.8,9683.7,0,45.0,2.917613236449003,2436574562.5609717
2020-06-26,9160.0,9247.5,9296.5,9060.1,489840.0,19345.5,0.1,9236.499999999998,44.05142019901494,-45.732811307972646,9875.413720505561,9076.89627949444,9418.264714667901,28.367421033522916,313.8103870731696,66859740.0,-3.2387552025014297,-0.009462016761286884,3.425877588135039,3.425877588135039,9500.475,9268.7,10027.566484901869,9454.8,9683.7,0,46.0,2.9177986521781114,2442242210.321607
2020-06-27,9008.3,9160.5,9190.5,8865.3,441930.0,19345.5,0.1,9138.599999999999,41.0332998336131,-59.51701013490504,9867.919443613975,9010.960556386026,9379.2204561281,16.12903225806451,314.6239308536575,66417810.0,-4.888452482763718,-0.016561135371179092,3.492600500134959,3.492600500134959,9422.449999999999,9268.7,10005.527155203832,9008.3,9683.7,0,47.0,2.9179790483992925,2447822022.4382772
2020-06-28,9124.0,9008.4,9185.5,8950.2,329010.0,19345.5,0.1,9097.433333333332,44.1748157751366,-57.73763765826307,9826.635730904773,8986.854269095229,9354.913746020662,29.178885630498606,308.9579357926819,66746820.0,-2.368035269065726,0.012843710800040098,3.3862114839180393,3.3862114839180393,9363.349999999999,9268.7,9959.91806899568,9008.3,9683.7,0,48.0,2.918162618353485,2453478119.1492457
2020-06-29,9185.4,9122.8,9229.1,9033.6,401120.0,19345.5,0.1,9105.9,45.82433134324446,-49.630301240471965,9773.158907028266,8981.991092971735,9338.76957973298,36.10421836228291,300.8537975217761,67147940.0,-2.5463110318925457,0.006729504603244063,3.2753478076270612,3.2753478076270612,9363.349999999999,9268.7,9916.133346235853,9008.3,9683.7,0,49.0,2.9183476763206833,2459176990.2329564
2020-06-30,9135.4,9186.0,9199.8,9075.3,381730.0,19345.5,0.1,9148.266666666665,44.666891832946625,-44.97788984274416,9675.732657522834,9005.077342477167,9319.401048329839,30.46469659372888,288.25709769879205,66766210.0,-4.075182443429416,-0.005443421081281152,3.1553856174747907,3.1553856174747907,9363.349999999999,9268.7,9874.100012386418,9008.3,9683.7,0,50.0,2.9185308417603384,2464850559.772361
2020-07-01,9229.9,9135.9,9289.0,9101.1,366780.0,19345.5,0.1,9183.566666666666,47.37247922033148,-33.41067947709034,9675.680849261747,8999.799150738252,9310.877138965092,41.12339273629598,281.0887335774497,67132990.0,-2.4797667096338007,0.01034437463055804,3.045414723642182,3.045414723642182,9354.275,9268.7,9833.74801189096,9008.3,9683.7,0,51.0,2.918716490087179,2470587215.5093465
2020-07-02,9085.1,9229.9,9259.7,8962.1,483100.0,19345.5,0.1,9150.133333333331,43.8355648656629,-33.31119661628603,9668.226166464114,8969.103833535884,9289.37455430175,24.791337694563612,282.26810975048903,66649890.0,-3.2274901204716606,-0.01568814396689011,3.106934538425433,3.106934538425433,9342.224999999999,9422.3,9795.010091415323,9008.3,9683.7,0,52.0,2.9188973722135385,2476240158.2211213
2020-07-03,9067.1,9085.0,9120.4,9050.9,333880.0,19345.5,0.1,9127.366666666667,43.4017600212384,-32.23667551734327,9657.00309147415,8939.90690852585,9268.205549130154,22.761109857884165,267.0703876254541,66316010.0,-2.6508481855271593,-0.001981266028992512,2.9454884982569296,2.9454884982569296,9257.199999999999,9483.95,9757.82168775871,9008.3,9683.7,0,53.0,2.919077331394554,2481886952.7066574
2020-07-04,9134.4,9067.1,9182.3,9049.6,261250.0,19345.5,0.1,9095.533333333331,45.570605137093914,-25.09022688397296,9652.678232717373,8923.141767282626,9255.462163498712,30.3519061583578,257.47250279506443,66577260.0,-2.3977433004231274,0.007422439368706568,2.8187128086690363,2.8187128086690363,9249.5,9483.95,9722.120820248361,9008.3,9683.7,0,54.0,2.919258970657681,2487580591.036064
2020-07-05,9081.0,9134.3,9149.6,8932.1,314100.0,19345.5,0.1,9094.166666666666,44.12573620449482,-22.15824667160652,9640.35390086098,8901.026099139017,9238.846719355979,24.32889690954214,254.6173240239884,66263160.0,-2.317025945527297,-0.005846032580136606,2.8038467572292523,2.8038467572292523,9247.625,9483.95,9687.847987438427,9008.3,9683.7,0,55.0,2.919438610773356,2493246118.290887
2020-07-06,9339.0,9080.4,9363.0,9063.2,510270.0,19345.5,0.1,9184.799999999997,52.038051860813134,-2.0981892261670225,9614.25625428468,8908.67374571532,9248.385127036361,55.70974950017642,257.8446580222749,66773430.0,-3.5595898262028016,0.02841096795507103,2.7609450478881565,2.7609450478881565,9276.4,9483.95,9654.94606794089,9008.3,9683.7,0,56.0,2.919625648123301,2499075833.1723065
2020-07-07,9256.0,9338.8,9371.2,9209.3,420550.0,19345.5,0.1,9225.333333333332,49.60441810772967,5.888792679843789,9591.29921660198,8910.77078339802,9249.110353032898,48.70963720234391,250.99146816354113,66352880.0,-3.8297695488643724,-0.008887461184280965,2.711662361317428,2.711662361317428,9230.125,9483.95,9623.360225223254,9008.3,9683.7,0,57.0,2.91980983366664,2504860304.6272683
2020-07-08,9429.9,9256.3,9458.3,9233.1,509940.0,19345.5,0.1,9341.633333333331,54.4146464312056,22.271250027769156,9597.223008566976,8909.026991433024,9266.328414648813,95.21079258010124,249.14922043757383,66862820.0,1.3749731240593381,0.01878781331028523,2.6421194332662474,2.6421194332662474,9251.9,9483.95,9593.037816214324,9008.3,9683.7,0,58.0,2.9199988032010333,2510756368.4848576
2020-07-09,9235.7,9430.1,9434.5,9176.0,444270.0,19345.5,0.1,9307.199999999999,48.81152620678473,19.514990515285717,9592.228517867126,8906.191482132876,9263.411422777499,62.46205733558203,249.8171332634614,66418550.0,-0.127602054609346,-0.020594067805597027,2.7049074056483144,2.7049074056483144,9251.9,9483.95,9563.928303565752,9008.3,9683.7,0,59.0,2.920181628973357,2516539217.6592226
2020-07-10,9285.1,9239.0,9309.8,9131.9,418470.0,19345.5,0.1,9316.9,50.21585119072799,20.4089460265277,9585.323486606047,8905.726513393953,9265.477001560594,70.79258010118062,244.68019517321412,66837020.0,1.3657205240174712,0.005348809510919539,2.6351918145546533,2.6351918145546533,9251.9,9483.95,9535.983171423122,9008.3,9683.7,0,60.0,2.9203655592296824,2522357932.872665
2020-07-11,9233.3,9285.8,9295.5,9184.2,353920.0,19345.5,0.1,9251.366666666665,48.70690595596193,17.039059278485368,9581.391286057025,8903.348713942973,9262.412525221489,57.240592930444606,235.15303837512735,66483100.0,2.4976965687199586,-0.005578830599562878,2.5467930033154706,2.5467930033154706,9251.9,9483.95,9509.155844566198,9008.3,9683.7,0,61.0,2.9205475664539504,2528149927.2921853
2020-07-12,9300.8,9234.2,9337.8,9170.4,366880.0,19345.5,0.1,9273.066666666664,50.782355458524336,18.74794566918805,9497.446967573283,8949.003032426717,9266.068475200394,70.06841505131122,230.3135356340468,66849980.0,1.9377466023673746,0.007310495705760589,2.476276617431262,2.476276617431262,9251.9,9483.95,9483.40161078355,9008.3,9683.7,0,62.0,2.920731217966098,2533989092.1723256
2020-07-13,9243.6,9300.5,9329.6,9207.6,456870.0,19345.5,0.1,9259.233333333332,48.973951856034425,15.549732984104025,9408.157174465723,9000.192825534275,9263.928620419405,59.198023565184464,222.57685451732917,66393110.0,0.6336142138611354,-0.006150008601410462,2.407902273111441,2.407902273111441,9251.9,9483.95,9458.677546352208,9008.3,9683.7,0,63.0,2.9209127888222683,2539798097.3346086
2020-07-14,9253.4,9243.1,9274.8,9135.7,453830.0,19345.5,0.1,9265.933333333332,49.30702912621136,13.683843747299669,9402.134076298496,9001.355923701502,9262.925894665175,61.06043329532496,216.61422205180557,66846940.0,1.2916785252971956,0.001060192998398879,2.3409149291266513,2.3409149291266513,9284.675,9483.95,9434.94244449812,9008.3,9683.7,0,64.0,2.92109428138048,2545618479.281703
2020-07-15,9198.7,9253.6,9270.2,9168.7,429840.0,19345.5,0.1,9231.9,47.44540023318281,8.603414469413039,9398.59152212271,9000.018477877291,9256.809142792303,50.66514633219326,208.39177761953374,66417100.0,-0.33803183133077186,-0.005911340696392542,2.2654481352749163,2.2654481352749163,9301.849999999999,9483.95,9412.156746718194,9008.3,9683.7,0,65.0,2.921273762725013,2551409801.715031
2020-07-16,9135.3,9198.7,9224.2,9052.0,429040.0,19345.5,0.1,9195.8,45.310067306205625,1.199675670442172,9398.617671140219,8997.52232885978,9245.23684347875,38.61649562903826,205.80665064670998,65988060.0,0.5525530814190147,-0.006892278256710349,2.252872381276039,2.252872381276039,9281.875,9507.849999999999,9390.282476849467,9008.3,9683.7,0,66.0,2.9214509621146916,2557166122.5996385
2020-07-17,9155.8,9135.4,9181.9,9091.5,310920.0,19345.5,0.1,9163.266666666665,46.15393572542528,-1.9205846136398463,9387.53460953268,9023.355390467319,9236.719048861725,42.51235271759775,197.56331845765925,66298980.0,0.9782620683570149,0.002244042341247754,2.1577941682612036,2.1577941682612036,9275.925,9560.2,9369.283177775487,9008.3,9683.7,0,67.0,2.9216284137576793,2562940421.3367057
2020-07-18,9170.2,9155.8,9198.8,9126.7,276400.0,19345.5,0.1,9153.766666666665,46.77519762085624,-2.5773846977395323,9386.799871190895,9028.710128809103,9230.383901351086,45.24895477004957,188.60165285354063,66575380.0,0.3919250306533663,0.00157277354245422,2.0566798199989162,2.0566798199989162,9242.675,9583.55,9349.123850664468,9008.3,9683.7,0,68.0,2.9218059322546646,2568728854.894133
2020-07-19,9208.0,9170.1,9224.8,9106.4,265250.0,19345.5,0.1,9177.999999999998,48.45636062009874,-0.1564973935154157,9387.636282791938,9030.133717208058,9228.252101222412,38.39527442776281,183.5872490782877,66840630.0,1.3985243915868295,0.004122047501690096,1.993779855324584,1.993779855324584,9230.625,9583.55,9329.770896637889,9008.3,9683.7,0,69.0,2.9219842199405752,2574546294.5979495
2020-07-20,9162.4,9208.1,9218.4,9139.9,312980.0,19345.5,0.1,9180.199999999999,46.54633588797511,-1.255518644993451,9387.14427929242,9033.32572070758,9221.980472534564,27.17204036426282,176.08101700126716,66527650.0,-1.8909947531855698,-0.004952215464813281,1.92177832228747,1.92177832228747,9178.349999999999,9583.55,9311.192060772373,9162.4,9683.7,0,70.0,2.9221607684412265,2580339778.6617327
2020-07-21,9387.3,9162.3,9426.9,9155.1,458990.0,19345.5,0.1,9252.566666666666,55.80010627689212,12.762401766459615,9411.08739790137,9025.122602098629,9237.725189436034,82.52522766428744,182.9180872154623,66986640.0,1.4185393258426888,0.024545970488081714,1.9485697401325441,1.9485697401325441,9200.625,9583.55,8865.3,9162.4,9683.7,0,71.0,2.922343647081788,2586280299.1013565
2020-07-22,9513.7,9387.4,9523.1,9296.0,386000.0,19345.5,0.1,9354.466666666665,59.99217577767922,29.205357815691464,9461.666585101624,9017.403414898376,9264.00850472784,98.00466992146049,186.07393812864356,67372640.0,0.8886626581406069,0.013465000585898057,1.9558524877665215,1.9558524877665215,9240.875,9583.55,8876.532,9162.4,9683.7,0,72.0,2.922529846844123,2592304824.7831955
2020-07-23,9599.6,9513.6,9646.5,9451.1,425660.0,19345.5,0.1,9500.199999999999,62.58897084732549,43.65513199242665,9524.015528542162,9008.304471457837,9295.969599515665,92.11101766190082,186.74008540516897,67798300.0,3.9401453057158595,0.009029084373062046,1.9452902767320406,1.9452902767320406,9319.275,9536.3,8902.394719999998,9162.4,9683.7,0,73.0,2.9227181534487934,2598387997.83068
2020-07-24,9546.4,9599.2,9626.2,9480.5,359160.0,19345.5,0.1,9553.233333333332,59.991872969794485,47.12160143299345,9564.296998614158,9009.223001385843,9319.820113847505,83.16232127838514,183.80865073337122,67439140.0,2.81418616923888,-0.005541897579065869,1.9254237276184867,1.9254237276184867,9319.275,9418.099999999999,8947.0410368,9162.4,9683.7,0,74.0,2.922904551150009,2604444351.668968
2020-07-25,9704.1,9546.7,9729.3,9536.2,306290.0,19345.5,0.1,9616.699999999999,64.67158761995304,56.873975828515924,9633.369194931294,9002.460805068704,9356.418198242982,96.27934445592811,184.4723185381303,67745430.0,5.098935375217974,0.016519316182016297,1.9009729757332499,1.9009729757332499,9370.55,9418.099999999999,8989.008574591999,9162.4,9683.7,0,75.0,2.923095094536147,2610603322.39851
2020-07-26,9932.5,9690.0,10086.6,9645.9,415070.0,19345.5,0.1,9727.666666666666,70.12245006383031,74.4372796273153,9761.646705778023,8933.533294221977,9411.28313174365,85.1053547264643,202.77429578540676,68160500.0,6.791888869774651,0.02353644335899263,2.0415232397221925,2.0415232397221925,9552.925,9475.95,9048.23188862464,9162.4,9683.7,0,76.0,2.9232916762000065,2616906220.556421
2020-07-27,11022.8,9932.7,11367.0,9894.6,908990.0,19345.5,0.1,10219.8,83.3382984573385,150.81041207318393,10272.479518199454,8599.380481800546,9564.760928720445,85.13174946004317,293.4618460864491,69069490.0,19.247912068890898,0.10977095393908876,2.6623167079730115,2.6623167079730115,10193.125,10116.15,9152.068699762176,9162.4,11022.8,1,77.0,2.923516590156315,2623834005.528513
2020-07-28,10908.5,10961.1,11046.1,10873.6,658370.0,19345.5,0.1,10621.266666666665,79.37446169043685,182.8223147062103,10564.202318983607,8455.517681016394,9692.736078366117,80.19438444924405,284.8217142231313,68411120.0,17.886398512979017,-0.0103694161193163,2.6110071432656303,2.6110071432656303,10201.5,10116.15,9417.860455790715,9162.4,11022.8,0,78.0,2.923738226146435,2630709113.359686
2020-07-29,11105.9,10908.4,11336.5,10771.8,576830.0,19345.5,0.1,11012.4,81.05075015309822,204.8266178547997,10856.804178726477,8349.93582127352,9827.323118521726,88.72138228941684,304.8130203500506,68987950.0,20.733364497157194,0.01809598019892733,2.744604402615282,2.744604402615282,10205.3,10116.15,9651.757201095828,9162.4,11022.8,0,79.0,2.9239644014834774,2637700239.555574
2020-07-30,11096.2,11105.8,11164.4,10861.6,501140.0,19345.5,0.1,11036.866666666667,80.7036570786257,205.72137012363348,11095.26205135478,8292.587948645218,9948.168535805371,88.09931883102617,304.6692331821897,68486810.0,21.465085985134603,-0.0008734096291159732,2.7457078385590536,2.7457078385590536,10240.525,10116.15,9857.586336964328,9162.4,11022.8,0,80.0,2.924189930314728,2644695663.2166576
2020-07-31,11333.4,11096.5,11434.8,10964.6,530950.0,19345.5,0.1,11178.5,82.65927413332068,208.6258610494706,11352.886855385535,8244.973144614465,10080.095341919145,95.64507816526371,316.49285938346173,69017760.0,23.7838310142205,0.02137668751464461,2.7925676265150945,2.7925676265150945,10343.175,10150.05,10038.715976528609,9162.4,11022.8,0,81.0,2.9244208788638613,2651827340.2027483
2020-08-01,11803.1,11333.2,11847.7,11226.1,611470.0,19345.5,0.1,11410.9,85.74096751004085,226.99986531623506,11686.395599029516,8161.694400970488,10244.191023641131,98.37303469156967,338.28622657035737,69629230.0,28.711478484656816,0.041443873859565494,2.8660794754798093,2.8660794754798093,10556.975,10356.5,10234.167739814604,9162.4,11022.8,0,82.0,2.9246625978883625,2659213062.8116064
2020-08-02,11066.8,11802.6,12061.1,10730.7,647950.0,19345.5,0.1,11401.099999999999,65.95389572884761,176.62518401104046,11815.542682186227,8214.867317813772,10322.53473567531,65.96261810214978,409.1514961010461,68981280.0,20.186794092093823,-0.0623819166151266,3.6971075297380107,3.6971075297380107,10677.6,10463.2,10492.332901444268,9162.4,11022.8,0,83.0,2.924886170094752,2666221982.3744373
2020-08-03,11224.4,11066.9,11461.1,10981.6,470240.0,19345.5,0.1,11364.766666666665,67.67353540133374,142.44492767158994,11951.886795573884,8275.623204426118,10408.426665610996,71.20784583620095,414.1763892366857,69451520.0,22.505020518641405,0.014240792279611059,3.689964623825645,3.689964623825645,10705.025,10463.2,10730.7,9162.4,11022.8,0,84.0,2.92511323011826,2673325650.770473
2020-08-04,11184.7,11223.8,11407.8,11043.0,485790.0,19345.5,0.1,11158.633333333331,66.75879575639888,107.2909228049964,12057.29089757375,8368.81910242625,10482.35745936233,68.30494376333587,410.6495042912081,68965730.0,19.147145611624232,-0.0035369373864080345,3.6715290020403595,3.6715290020403595,10767.2,10463.2,10730.7,9162.4,11022.8,0,85.0,2.9253389096907254,2680417623.0542054
2020-08-05,11735.1,11184.8,11771.5,11114.5,570830.0,19345.5,0.1,11381.4,72.34080738525691,110.78368795358455,12231.06763596061,8455.022364039394,10601.666272756394,87.5095785440613,428.2459682704075,69536560.0,23.34948547883578,0.049210081629368574,3.6492741286431944,3.6492741286431944,10976.225,10463.2,10970.172,9162.4,11022.8,0,86.0,2.9255773955982747,2687810686.1099777
2020-08-06,11757.1,11735.0,11898.4,11563.0,554850.0,19345.5,0.1,11558.966666666665,72.53930461848633,104.34265131939037,12374.415348332988,8571.80465166701,10711.707580112929,88.2197938463923,421.6141133939498,70091410.0,22.474894787282803,0.0018747177271603022,3.586038337633854,3.586038337633854,10976.225,10463.2,11043.0,9162.4,11022.8,0,87.0,2.9258159816065636,2695226120.5114822
2020-08-07,11592.0,11757.1,11901.8,11352.4,517000.0,19345.5,0.1,11694.733333333332,68.56270403290087,79.83484705215409,12456.236237026449,8732.163762973552,10795.544953435507,81.42104637807437,430.7416767229534,69574410.0,21.42797284840359,-0.014042578527017735,3.7158529738004953,3.7158529738004953,10976.225,10463.2,11114.5,9162.4,11022.8,0,88.0,2.9260502657585934,2702566338.058493
2020-08-08,11764.3,11591.6,11805.5,11533.5,317060.0,19345.5,0.1,11704.466666666665,70.38719223369748,66.63800244761217,12536.22253087942,8907.807469120582,10887.8073388226,87.71116263663461,419.4029855284567,69891470.0,21.230201667336473,0.014863699102829475,3.5650483711606875,3.5650483711606875,10976.225,10463.2,11284.888,9162.4,11022.8,0,89.0,2.9262881930756546,2710007353.5598006
2020-08-09,11681.2,11764.4,11792.8,11527.5,303000.0,19345.5,0.1,11679.166666666666,68.3275483194751,44.77153580477534,12558.344667268715,9137.565332731285,10963.36854464902,82.46480498499886,408.3956294192812,69588470.0,17.6058394160584,-0.007063743699157521,3.4961787266657636,3.4961787266657636,10976.225,10463.2,11352.4,9162.4,11022.8,0,90.0,2.9265237591192736,2717415941.7951217
2020-08-10,11889.2,11681.1,12041.1,11546.9,564110.0,19345.5,0.1,11778.233333333332,70.64310598558441,37.0926728917359,12601.845076736043,9344.254923263956,11051.542968968162,87.079073962718,414.5245130321897,70152580.0,7.860071851072337,0.017806389754477348,3.4865635453368578,3.4865635453368578,10976.225,10463.2,11479.966,9162.4,11022.8,0,91.0,2.926763760535308,2724943766.2751665
2020-08-11,11390.4,11889.2,11931.8,11146.7,615900.0,19345.5,0.1,11653.599999999999,59.42344927156515,-6.482002671325404,12559.081063893602,9574.688936106395,11083.81506716167,49.586590499097944,440.9941906727475,69536680.0,4.4176559563643,-0.04195404232412614,3.871630413969198,3.871630413969198,11043.825,10463.2,12061.1,11390.4,11022.8,0,92.0,2.9269915792166086,2732218914.607579
2020-08-12,11557.2,11390.4,11605.4,11190.6,549590.0,19345.5,0.1,11612.266666666665,61.618698177233846,-27.779410856915206,12508.574443745487,9820.955556254516,11128.899346479608,62.12417318099821,439.12317705326547,70086270.0,4.063605831134812,0.01464391066160986,3.7995637096638064,3.7995637096638064,11062.9,10463.2,12042.812,11390.4,11022.8,0,93.0,2.9272229830881176,2739593874.045466
2020-08-13,11770.9,11557.2,11772.9,11298.4,545670.0,19345.5,0.1,11572.833333333334,64.28467522358822,-30.94105077371728,12418.792997720755,10133.187002279248,11190.042265862501,78.18701142513522,441.6500929780322,70631940.0,6.080459977289513,0.018490637870764548,3.7520503358114694,3.7520503358114694,11080.775,10463.2,12024.88976,11390.4,11022.8,0,94.0,2.9274590066417128,2747092688.9687657
2020-08-14,11750.8,11771.1,11835.5,11651.5,435440.0,19345.5,0.1,11692.966666666665,63.835541700787466,-37.419852986185106,12281.115205695392,10475.534794304609,11243.447764351788,76.67618761274795,423.24651490817274,70196500.0,3.68291951223816,-0.0017076009481008514,3.601852766689696,3.601852766689696,11097.2,10463.2,12007.3259648,11390.4,11022.8,0,95.0,2.927694149761983,2754591873.998251
2020-08-15,11845.3,11751.1,11964.0,11711.5,499100.0,19345.5,0.1,11789.0,65.07112780361007,-38.239367056055244,12109.553908886488,10838.376091113512,11300.767024889712,83.77931449188205,411.0503352718747,70695600.0,0.35753319043301257,0.00804200565067914,3.470155549220997,3.470155549220997,11101.0,10463.2,11990.113445504001,11390.4,11022.8,0,96.0,2.927931078934168,2762151795.304491
2020-08-16,11899.0,11845.5,11922.5,11688.9,410810.0,19345.5,0.1,11831.699999999997,65.78647363418908,-37.98539410626205,12143.647970737284,10891.902029262716,11357.741593947834,86.58801321378006,398.3753113238837,71106410.0,7.519788918205812,0.0045334436443147386,3.3479730340691125,3.3479730340691125,11136.225,10463.2,11973.24517659392,11390.4,11022.8,0,97.0,2.9281688362722527,2769751058.480465
2020-08-17,12282.6,11898.8,12444.1,11764.0,628410.0,19345.5,0.1,12008.966666666665,70.44317385095724,-15.931870280872033,12231.137830480251,10941.822169519748,11445.823346905183,88.47334237384912,418.49850337217777,71734820.0,9.427675421403379,0.03223800319354564,3.4072468644438287,3.4072468644438287,11371.5,10654.7,11146.7,11390.4,12282.6,0,98.0,2.9284148782993475,2777559943.9338946
2020-08-18,11947.6,12283.0,12381.4,11842.0,606790.0,19345.5,0.1,12043.066666666666,62.44927360553888,-27.193953719101955,12251.773819818445,11005.356180181552,11493.61159958088,62.657942238267154,427.1343245598793,71128030.0,6.820925013634693,-0.02727435559246416,3.5750638166650988,3.5750638166650988,11378.85,10688.1,11172.648000000001,11390.4,12282.6,0,99.0,2.928652923281187,2785207700.3763537
2020-08-19,11750.2,11944.4,12013.2,11602.6,550260.0,19345.5,0.1,11993.466666666665,58.25424963636629,-49.903946273451595,12236.05938854211,11086.47061145789,11518.048590096987,46.51610914135966,425.95330137703075,70577770.0,0.1286738076369214,-0.016522146707288465,3.6250727764381097,3.6250727764381097,11392.775000000001,10688.1,11198.07704,11390.4,12282.6,0,100.0,2.9288859916169314,2792762131.0277524
2020-08-20,11856.9,11751.0,11881.0,11672.7,430930.0,19345.5,0.1,11851.566666666666,59.82520094071979,-59.07807838770884,12247.62174336504,11127.258256634957,11550.320152944894,54.740249730229614,410.40663699295703,71008700.0,0.8488487807367402,0.009080696498782848,3.461331688661936,3.461331688661936,11431.175,10688.1,11222.9974992,11390.4,12282.6,0,101.0,2.92912112753218,2800384352.8349886
2020-08-21,11529.2,11856.9,11877.4,11495.6,506380.0,19345.5,0.1,11712.099999999999,53.20325867168273,-86.87501451782589,12235.337295085588,11112.152704914413,11548.308709807285,29.482041005087105,408.36330577917437,70502320.0,-0.5417529330572746,-0.027637915475377084,3.5419916887483462,3.5419916887483462,11520.3,10688.1,11247.419549216002,11390.4,12282.6,0,102.0,2.92934817964268,2807840709.389029
2020-08-22,11661.3,11529.2,11677.0,11382.1,433980.0,19345.5,0.1,11682.466666666665,55.348840229380286,-95.34583454276026,12191.533656093643,11215.406343906356,11559.069785063733,39.6639432711576,400.25878393780476,70936300.0,-0.8755302057921,0.011457863511778577,3.432368466104163,3.432368466104163,11750.25,10688.1,11271.353158231681,11390.4,12282.6,0,103.0,2.929577947300526,2815379450.653606
2020-08-23,11641.6,11661.1,11705.4,11520.8,377330.0,19345.5,0.1,11610.699999999997,54.94426445776767,-100.72957394310038,12161.74232309972,11286.91767690028,11566.929805533855,38.145521812856465,384.8545850851045,70558970.0,-0.33900626647947435,-0.0016893485288945742,3.30585645517029,3.30585645517029,11750.25,10688.1,11294.808095067046,11390.4,12282.6,0,104.0,2.929806847177076,2822918056.3626714
2020-08-24,11753.5,11641.6,11824.6,11587.1,429130.0,19345.5,0.1,11685.466666666665,56.87264488370351,-95.268178866141,12113.358791283772,11392.181208716229,11584.698395483012,46.7704640049329,374.3292575790256,70988100.0,-1.141372001480341,0.009612080813633739,3.184832242132349,3.184832242132349,11750.25,10688.1,11317.793933165705,11390.4,12282.6,0,105.0,2.9300379599802717,2830528037.762547
2020-08-25,11324.8,11752.9,11766.9,11131.0,594070.0,19345.5,0.1,11573.299999999997,48.33709913679245,-117.57825256786441,12138.346164517887,11326.163835482112,11559.946167341772,14.758967329220868,393.0128820376666,70394030.0,-0.5759235847731455,-0.036474241715233835,3.4703737111266126,3.4703737111266126,11687.475,10688.1,12444.1,11390.4,12282.6,0,106.0,2.930258504382955,2837911914.8051643
2020-08-26,11462.3,11324.9,11533.6,11254.6,513059.99999999994,19345.5,0.1,11513.533333333331,50.88329044502954,-119.72386807341559,12139.998903953152,11295.03109604685,11550.64653235684,25.230370878074723,384.8691047492618,70907090.0,-0.8211331464368656,0.012141494772534678,3.3576952683951897,3.3576952683951897,11671.800000000001,10748.05,12417.838,11390.4,12282.6,0,107.0,2.930481951599769,2845382627.411197
2020-08-27,11327.4,11462.3,11580.3,11135.3,560590.0,19345.5,0.1,11371.499999999998,48.364826089522694,-126.22937183276247,12157.142214913812,11251.427785086187,11529.384957846665,14.95697205087195,389.1641686957431,70346500.0,-3.7677662710582878,-0.011769016689495149,3.4356001262049816,3.4356001262049816,11579.75,10748.05,12392.10124,11390.4,12282.6,0,108.0,2.930701763241422,2852787540.8653398
2020-08-28,11527.4,11327.5,11539.0,11281.9,464940.0,19345.5,0.1,11439.033333333331,52.14644335126768,-113.46630194309446,12150.758384531426,11234.121615468572,11529.195914242222,30.188104485568466,379.73101378890436,70811440.0,-1.901147155938316,0.017656302417147884,3.29416012100651,3.29416012100651,11609.425,10748.05,12366.8792152,11390.4,12282.6,0,109.0,2.9309259617918784,2860314527.3467813
2020-08-29,11468.1,11527.8,11576.8,11433.5,389850.0,19345.5,0.1,11440.966666666665,50.95485331156353,-105.58443217203816,12150.444839435275,11213.125160564725,11523.377255742964,25.672073718681006,362.84308423255396,70421590.0,-3.1843853680362586,-0.005144264968683254,3.1639337312419142,3.1639337312419142,11623.875,10748.05,12342.161630896,11390.4,12282.6,0,110.0,2.9311483516180274,2867818493.5879235
2020-08-30,11702.0,11468.1,11704.2,11462.6,409360.0,19345.5,0.1,11565.83333333333,55.294217352429904,-82.22319739854456,12131.521002486948,11213.32899751305,11540.388945672206,43.48488310105855,354.18286393022873,70830950.0,-1.6556013110345407,0.02039570635065968,3.026686582893768,3.026686582893768,11628.55,10748.05,12317.93839827808,11390.4,12282.6,0,111.0,2.931375858204195,2875462744.6189175
2020-08-31,11644.2,11701.1,11760.2,11563.8,496140.0,19345.5,0.1,11604.766666666665,54.02222409820726,-68.812640292792,12125.99673595591,11244.233264044089,11550.275712751045,41.042866282789575,342.9126593637839,70334810.0,-5.197596600068386,-0.004939326610835737,2.94492244519833,2.94492244519833,11632.675,10748.05,12294.199630312518,11390.4,12282.6,0,112.0,2.9316016106817555,2883085559.771207
2020-09-01,11914.9,11644.2,12045.9,11544.6,580690.0,19345.5,0.1,11753.699999999999,58.80218531851521,-41.2210382452017,12150.643822697795,11255.356177302205,11585.001835346184,85.68149524538201,354.2260408377993,70915500.0,-0.27369513542469387,0.02324762542725134,2.972966964370656,2.972966964370656,11688.0,10748.05,12270.935637706267,11390.4,12282.6,0,113.0,2.93183323638677,2890867806.894137
2020-09-02,11413.3,11914.4,11947.5,11244.9,20260000.0,19345.5,0.1,11657.466666666665,48.69915232526976,-55.37986001491697,12148.767873282619,11221.472126717379,11568.649279598929,30.855831238386642,379.10989506367076,50655500.0,-2.8671852394001927,-0.042098548875777464,3.321650136802422,3.321650136802422,11688.0,10748.05,12248.136924952141,11390.4,12282.6,1,114.0,2.9320527189071393,2898381617.9309683
2020-09-03,10168.8,11413.2,11442.7,10009.5,9650000.0,19345.5,0.1,11165.666666666664,33.376809350844965,-142.24873030666376,12411.578567951148,10800.461432048853,11435.330300589509,7.82262816735412,454.4020454162657,41005500.0,-14.237279558737953,-0.10903945397036796,4.468590644090411,4.468590644090411,11127.25,10748.05,12225.794186453099,11390.4,12282.6,1,115.0,2.9322403057275674,2905153237.791672
2020-09-04,10472.5,10168.7,10614.2,9960.3,12500000.0,19345.5,0.1,10684.866666666665,38.46496949848543,-171.0103199067679,12473.115722519722,10601.644277480276,11343.63217672384,24.558879938626806,468.65189931510395,53505500.0,-9.165423446553106,0.029865864212099913,4.475071848318014,4.475071848318014,11102.65,10748.05,12137.142418994974,11390.4,12282.6,1,116.0,2.9324355507279662,2912123588.234418
2020-09-05,10092.2,10472.3,10558.7,9897.8,14720000.0,19345.5,0.1,10244.499999999998,34.873313191476825,-205.1051765817195,12558.125649983616,10335.954350016382,11224.448159892998,9.049858014059001,482.38390650688234,38785500.0,-13.455618155780218,-0.036314156123179675,4.779769589454057,4.779769589454057,11071.4,10748.05,12006.531873855276,10092.2,12282.6,1,117.0,2.932620333934793,2918859419.834781
2020-09-06,10296.4,10092.2,10337.7,10004.7,12120000.0,19345.5,0.1,10287.033333333333,38.20960803999611,-202.98661232328763,12496.739920061407,10198.720079938592,11136.06262085557,18.555933150225794,471.71362747067644,50905500.0,-11.555112699285328,0.020233447613007938,4.581345202893015,4.581345202893015,11071.4,10767.8,11837.833323946854,10092.2,12282.6,1,118.0,2.932810211724869,2925732975.445099
2020-09-07,10376.9,10296.4,10400.9,9887.0,12400000.0,19345.5,0.1,10255.166666666666,39.52485463745271,-185.71283349833237,12457.507326747278,10080.882673252721,11063.761418869324,22.692111723562913,474.72693979419955,63305500.0,-11.71225592376739,0.007818266578609956,4.574843544740718,4.574843544740718,11066.0,10775.25,11682.630658031105,10092.2,12282.6,1,119.0,2.9330018417089225,2932664617.0079947
2020-09-08,10126.6,10376.9,10434.4,9877.1,113900.0,19345.5,0.1,10266.633333333331,36.89516018793377,-180.53318589544847,12453.146187308072,9922.883812691927,10974.50795040558,11.504057543341943,480.62501552318525,63191600.0,-10.580319299237063,-0.024120883886324385,4.74616372250494,4.74616372250494,11061.05,10775.25,11503.067592227995,10092.2,12282.6,0,120.0,2.933186447348815,2939442675.6717305
2020-09-09,10224.6,10126.8,10343.3,9984.6,71370.0,19345.5,0.1,10242.699999999999,38.61715535684562,-160.56626717015004,12398.710006151596,9814.089993848404,10903.088145605048,16.02268535595722,471.91608584295767,63262970.0,-10.79800738071765,0.009677483064404635,4.615496800294952,4.615496800294952,11061.05,10792.0,11307.951481160635,10092.2,12282.6,0,121.0,2.933373310655871,2946290727.6663957
2020-09-10,10339.7,10224.3,10480.3,10219.2,88010.0,19345.5,0.1,10230.3,40.665078087913855,-130.92042720233567,12365.15482044086,9728.69517955914,10849.432131737902,21.329767613426803,456.857793997032,63350980.0,-8.719564948708431,0.011257164094438998,4.4184821029336625,4.4184821029336625,11036.45,10799.6,11136.249303421358,10092.2,12282.6,0,122.0,2.9335628549475827,2953219468.5388966
2020-09-11,10390.2,10339.8,10398.8,10212.6,62280.0,19345.5,0.1,10318.166666666666,41.5859194919109,-100.58633777666938,12299.553545102865,9667.186454897133,10805.695738239054,23.658244190335694,437.5250944258154,63413260.0,-9.865190762878004,0.0048840875460602895,4.210940062999898,4.210940062999898,10910.25,10870.05,10985.151387010796,10092.2,12282.6,0,123.0,2.9337533561992064,2960187455.826369
2020-09-12,10441.9,10390.2,10476.8,10275.9,48490.0,19345.5,0.1,10390.599999999999,42.56858970663274,-71.1051922099274,12223.358433997615,9623.411566002385,10771.048525073431,26.04205090372554,420.62330196682854,63461750.0,-8.948300067142775,0.0049758426209312034,4.028225724885591,4.028225724885591,10687.45,10947.6,10852.1852205695,10092.2,12282.6,0,124.0,2.9339448382675632,2967195474.6169777
2020-09-13,10326.0,10441.7,10579.6,10219.4,66120.0,19345.5,0.1,10386.033333333333,40.9072144745899,-54.2378830352759,12118.149388692873,9585.870611307128,10728.662951256912,20.698081888601983,416.30735182634083,63395630.0,-11.758673730986157,-0.011099512540821088,4.031641989408685,4.031641989408685,10594.925,10962.3,10735.17499410116,10092.2,12282.6,0,125.0,2.9341329125264908,2974136453.6988583
2020-09-14,10675.3,10332.7,10744.3,10264.5,96640.0,19345.5,0.1,10481.066666666666,47.550998786218386,-16.34929804479799,12068.706588333469,9570.36341166653,10723.580765422921,36.80376244928067,420.84254098160216,63492270.0,-8.320880781848485,0.033827232229324045,3.9422080970239914,3.9422080970239914,10636.1,10990.150000000001,9877.1,10092.2,12282.6,0,126.0,2.9343296685576727,2981306069.8020587
2020-09-15,10785.3,10675.2,10931.8,10627.8,91700.0,19345.5,0.1,10595.533333333331,49.477394848375056,17.494529549931173,11999.543066290933,9571.826933709066,10729.458787763595,43.86591962905714,412.496645197202,63583970.0,-9.480566349696602,0.010304160070442991,3.824619113026082,3.824619113026082,10682.975,11045.0,9894.444,10092.2,12282.6,0,127.0,2.9345288377143124,2988551926.8504095
2020-09-16,10949.5,10785.2,11093.3,10669.2,94940.0,19345.5,0.1,10803.366666666663,52.29412581860278,50.44807600948127,11957.88166884819,9575.698331151809,10750.41509369087,68.49770056208479,413.3254562545446,63678910.0,-4.0636800925236285,0.015224425838873401,3.774834067807156,3.774834067807156,10723.35,11160.6,9935.93824,10092.2,12282.6,0,128.0,2.934731738275178,2995906966.1314025
2020-09-17,10941.3,10950.1,11039.3,10755.2,77220.0,19345.5,0.1,10892.033333333333,52.137797485804164,69.9989855305642,11880.135193672399,9594.834806327603,10768.594608577454,87.50205558296331,404.095066522077,63601690.0,7.59676658012745,-0.0007488926434997545,3.693300307295084,3.693300307295084,10750.225,11160.6,10005.3799456,10092.2,12282.6,0,129.0,2.9349340557502477,3003265401.048556
2020-09-18,10933.0,10941.3,11029.7,10818.7,63480.0,19345.5,0.1,10941.266666666665,51.96845205112188,79.9585672736556,11807.849734759871,9613.610265240128,10784.25226490341,86.81960203913836,390.30256177050006,63538210.0,4.397230842683218,-0.0007585935857712389,3.569949343917498,3.569949343917498,10807.225,11160.6,10070.655148864,10092.2,12282.6,0,130.0,2.9351357881756246,3010627117.9830437
2020-09-19,11081.8,10933.0,11177.1,10890.7,51630.0,19345.5,0.1,10985.366666666663,54.802730614167864,93.2279060849788,11695.023195306492,9664.416804693506,10812.590144436419,92.66923076923068,382.88095021546434,63589840.0,9.805592437724169,0.013610171041799957,3.4550429552551423,3.4550429552551423,10828.175,11160.6,10132.01383993216,10092.2,11081.8,0,131.0,2.9353408147305213,3018088295.0145197
2020-09-20,10921.5,11081.6,11081.6,10772.7,53390.0,19345.5,0.1,10978.766666666665,51.29136932538734,87.93761069691615,11566.22512762267,9720.944872377331,10822.96251163295,80.33846153846152,377.6108823429311,63536450.0,6.071053960607594,-0.014465159089678492,3.4575001816868665,3.4575001816868665,10829.875,11160.6,10215.620732737587,10092.2,11081.8,0,132.0,2.935541503368786,3025459758.764971
2020-09-21,10416.8,10919.9,10987.2,10328.5,109850.0,19345.5,0.1,10806.699999999999,42.13712178917155,49.11259115705067,11286.913729644872,9850.446270355125,10784.280367667909,41.515384615384534,397.68867646129326,63426600.0,0.3845078973489157,-0.04621160097056276,3.817762426669354,3.817762426669354,10829.875,11160.6,10292.53907411858,10092.2,11081.8,0,133.0,2.9357289689154884,3032519227.6263723
2020-09-22,10531.5,10419.4,10570.7,10361.7,63520.0,19345.5,0.1,10623.266666666665,44.55884991457768,30.720651312943644,11129.3080000625,9919.8719999375,10760.206046937632,45.861635220125756,384.21091385691517,63490120.0,3.998380502834116,0.011011059058444017,3.6482069397228805,3.6482069397228805,10841.15,11160.6,11177.1,10092.2,11081.8,0,134.0,2.9359190406993316,3039659960.4598393
2020-09-23,10237.3,10531.5,10535.4,10146.6,74950.0,19345.5,0.1,10395.199999999997,39.94130110271363,-0.06515546806360817,11125.364764459307,9930.665235540695,10710.40547103881,8.801552644347298,384.5387057242783,63415170.0,0.1242102380533117,-0.0279352418933676,3.75625121588972,3.75625121588972,10811.675,11160.6,11160.792000000001,10092.2,11081.8,0,135.0,2.936101055846551,3046615359.294631
2020-09-24,10739.4,10238.1,10787.8,10201.0,82950.0,19345.5,0.1,10502.733333333332,49.55011791702966,13.812799127076062,11145.04429298731,9937.675707012691,10713.1668547494,57.52547307132453,398.985941029687,63498120.0,3.865682756753087,0.04904613521143264,3.7151604468563146,3.7151604468563146,10811.675,11160.6,11120.224320000001,10092.2,11081.8,0,136.0,2.9362956991149254,3053903390.901572
2020-09-25,10688.8,10739.9,10756.0,10558.9,71430.0,19345.5,0.1,10555.166666666666,48.70443514337979,19.654123804551148,11141.167350075933,10001.212649924064,10710.846201916123,52.6152353226588,384.5655166704237,63426690.0,2.8738619083366874,-0.004711622623237877,3.5978362086522684,3.5978362086522684,10811.675,11160.6,11081.279347200001,10092.2,11081.8,0,137.0,2.9364886898989,3061166935.109485
2020-09-26,10727.9,10688.9,10793.3,10650.2,37850.0,19345.5,0.1,10718.699999999999,49.42277296068376,25.831681373777286,11152.069883851002,10033.460116148997,10712.470373162208,56.40950994662778,367.3179797653933,63464540.0,2.738965130866988,0.003658034578250202,3.4239504447785056,3.4239504447785056,10811.675,11160.6,11043.892173312,10092.2,11081.8,0,138.0,2.9366823005973495,3068463064.0900917
2020-09-27,10776.2,10727.9,10799.2,10602.7,40920.0,19345.5,0.1,10730.966666666665,50.347774990430416,32.424392309990694,11168.281697324002,10057.178302675997,10718.539861432473,61.096555070354235,355.11669549643665,63505460.0,4.359868293627743,0.0045022791040185695,3.295379591102955,3.295379591102955,10787.075,11160.6,11008.00048637952,10092.2,11081.8,0,139.0,2.936876758501739,3075797678.744567
2020-09-28,10693.2,10776.4,10946.6,10685.2,72290.0,19345.5,0.1,10732.433333333332,48.699506794844496,30.47855152444498,11150.430142037772,10131.68985796223,10716.126541296047,53.042212518195086,348.4226458181197,63433170.0,0.16767678660085858,-0.0077021584603106374,3.2583571411562455,3.2583571411562455,10637.0,11160.6,10973.544466924339,10092.2,11081.8,0,140.0,2.9370687500595705,3083086966.1273723
2020-09-29,10840.9,10694.3,10858.4,10642.4,59640.0,19345.5,0.1,10770.099999999999,51.72802212367605,37.9361843868997,11150.371712109474,10193.378287890526,10728.009727839282,67.37506065016974,338.96388540253974,63492810.0,0.5155164900373691,0.013812516365540706,3.1267135145840266,3.1267135145840266,10547.0,11160.6,10946.6,10092.2,11081.8,0,141.0,2.937264089235177,3090478268.531159
2020-09-30,10776.1,10843.4,10847.7,10667.6,55550.0,19345.5,0.1,10770.066666666666,50.32435022413115,37.24907311938337,11148.842424357837,10238.547575642162,10732.58975375935,61.08685104318292,327.6164650166441,63437260.0,-1.5836339558883934,-0.005977363503030131,3.04021366743668,3.04021366743668,10536.85,11160.6,10946.6,10092.2,11081.8,0,142.0,2.9374574331456667,3097836129.593551
2020-10-01,10620.5,10776.6,10913.7,10462.7,95330.0,19345.5,0.1,10745.83333333333,47.024578374718494,25.613471482163334,11140.271438879125,10270.148561120877,10721.914539115603,45.98738476467731,336.4295746583124,63341930.0,-2.9320099074150177,-0.014439361178905208,3.167737626837836,3.167737626837836,10536.85,11160.6,10914.6,10092.2,11081.8,0,143.0,2.937646469041891,3105101162.629699
2020-10-02,10572.3,10619.6,10662.9,10387.6,77940.0,19345.5,0.1,10656.299999999997,46.017981832088296,14.521164464899314,11134.547923460646,10288.912076539353,10707.665535390308,41.31004366812216,332.0631764684329,63263990.0,-3.2991859507911894,-0.004538392731039065,3.1408792454662935,3.1408792454662935,10550.45,11160.6,10913.7,10092.2,11081.8,0,144.0,2.9378339075247935,3112342003.3150554
2020-10-03,10544.2,10572.2,10597.8,10501.2,29100.0,19345.5,0.1,10579.0,45.407736671094995,5.60049942466172,11115.265289047422,10330.014710952577,10692.09738916266,42.52406417112304,315.24437814925903,63234890.0,-4.851197458896556,-0.0026578890118515996,2.9897420207247496,2.9897420207247496,10597.1,11160.6,10913.7,10544.2,11081.8,0,145.0,2.938020261116993,3119571549.0015407
2020-10-04,10672.9,10544.4,10693.3,10520.8,31400.0,19345.5,0.1,10596.466666666665,48.759309492282895,8.502458521590135,11115.20455329892,10329.835446701081,10690.269066385265,62.61004044729943,305.0483511385977,63266290.0,-2.2762441056631446,0.012205762409665866,2.858158055810489,2.858158055810489,10623.975,11160.6,10883.016000000001,10544.2,11081.8,0,146.0,2.9382095334464404,3126892602.8051877
2020-10-05,10789.5,10672.5,10789.6,10623.4,48860.0,19345.5,0.1,10668.866666666667,51.65513631746112,17.870911339249503,11115.553090461306,10329.906909538693,10699.719631491429,80.36249999999995,295.13061177155504,63315150.0,3.577874203210206,0.010924865781559046,2.735350218004125,2.735350218004125,10664.475,11160.6,10853.559360000001,10544.2,11081.8,0,147.0,2.938401378911152,3134296827.8863106
2020-10-06,10602.6,10790.2,10800.3,10530.8,69070.0,19345.5,0.1,10688.33333333333,47.063791030173455,11.39193497640867,11087.102043239587,10323.667956760413,10690.47014277796,57.0,293.29985378787256,63246080.0,0.6751175046289737,-0.01732239677464198,2.7663012259999675,2.7663012259999675,10664.475,11160.6,10825.2809856,10544.2,11081.8,0,148.0,2.9385881314167808,3141586639.724411
2020-10-07,10670.9,10601.0,10680.1,10553.3,49270.0,19345.5,0.1,10687.666666666666,48.852926866941424,11.58003894799873,11058.039009317392,10325.690990682608,10688.60631965625,63.02306866952782,281.4070070887389,63295350.0,4.235491780059199,0.0064418161583006395,2.6371440749022006,2.6371440749022006,10656.25,11160.6,10800.3,10544.2,11081.8,0,149.0,2.938776256287362,3148928603.810948
2020-10-08,10924.1,10670.7,10948.6,10549.6,79780.0,19345.5,0.1,10732.533333333333,54.933838946041824,27.710571778102576,11056.44056709119,10326.399432908811,10711.034289212797,95.63279857397504,289.8065065824004,63375130.0,1.7198353725534083,0.023728082917092275,2.6529096821010465,2.6529096821010465,10664.975,11129.25,10146.6,10544.2,11081.8,0,150.0,2.9389703546294212,3156442471.7217665
2020-10-09,11054.2,10923.5,11103.0,10836.9,70950.0,19345.5,0.1,10883.066666666666,57.715639463080485,45.06880856084845,11049.310028807822,10330.769971192176,10743.716737859197,93.1786413195416,288.11318468365755,63446080.0,3.418531547039906,0.011909447917906268,2.6063684815152386,2.6063684815152386,10703.575,10961.5,10162.640000000001,10544.2,11081.8,0,151.0,2.939167282632196,3164047579.8715363
2020-10-10,11298.4,11053.5,11475.0,11053.1,65810.0,19345.5,0.1,11092.233333333332,62.40639153888446,69.46547345165848,11145.874758575157,10271.895241424843,10796.543715205938,83.75942615412907,297.66938577768195,63511890.0,5.317909376485613,0.02209115087478053,2.6346153949026583,2.6346153949026583,10871.05,10961.5,10200.254400000002,10544.2,11081.8,0,152.0,2.9393697416070728,3171814991.0756435
2020-10-11,11371.0,11295.6,11439.4,11277.6,41060.0,19345.5,0.1,11241.199999999999,63.69581351021718,85.88533825990855,11259.060519115068,10254.129480884934,10851.25383756728,90.43590215192202,287.96442965070463,63552950.0,5.519570906256373,0.0064256885930751295,2.532445955946747,2.532445955946747,10899.45,10961.5,10276.739136000002,10544.2,11081.8,0,153.0,2.9395735546426183,3179636564.6877484
2020-10-12,11533.9,11370.8,11715.9,11227.4,84020.0,19345.5,0.1,11401.099999999999,66.47441677106366,102.01172785094126,11400.96292898215,10212.46707101785,10916.267757798967,86.2982759918693,302.2883989613686,63636970.0,7.862005760670322,0.014325916805909777,2.6208689078400944,2.6208689078400944,11024.8,10961.5,10348.634787840001,10544.2,11081.8,0,154.0,2.939780831279796,3187567930.1322184
2020-10-13,11423.8,11533.5,11558.0,11315.9,64670.0,19345.5,0.1,11442.9,62.966645194196126,99.45407328657801,11457.956269078297,10274.123730921701,10964.604161818113,78.00948580892866,297.98922760698514,63572300.0,5.3768598548091,-0.009545773762560827,2.6084947881351668,2.6084947881351668,11027.3,10961.5,10458.016004812802,10544.2,11081.8,0,155.0,2.939985139919665,3195440735.035006
2020-10-14,11420.4,11424.4,11541.0,11293.5,59120.0,19345.5,0.1,11459.366666666663,62.85633843403904,91.9023670731236,11535.686352726769,10264.493647273232,11008.013289264007,77.75351953624933,294.38285420648623,63513180.0,5.97897198429858,-0.00029762425812773774,2.5776930248195007,2.5776930248195007,11027.3,10961.5,10558.646724427777,10544.2,11081.8,0,156.0,2.9401889915609694,3203320617.3336334
2020-10-15,11503.0,11421.4,11590.9,11276.7,70840.0,19345.5,0.1,11449.066666666666,64.48413376763385,86.89521395900925,11619.861785112054,10261.738214887944,11055.154880762673,83.97199427840098,295.79836462030863,63584020.0,8.309401628925192,0.007232671360022369,2.571488869167249,2.571488869167249,11032.0,10961.5,10651.226986473555,10544.2,11081.8,0,157.0,2.940394411061214,3211261031.1390023
2020-10-16,11322.0,11503.2,11542.2,11224.6,71420.0,19345.5,0.1,11415.133333333331,58.44032241970387,66.72503271950413,11661.585867843678,10279.42413215632,11080.568701642418,67.5722400592739,297.3556242902866,63512600.0,7.091172214182352,-0.01573502564548379,2.6263524491281274,2.6263524491281274,11032.0,10961.5,10736.400827555672,10544.2,11081.8,0,158.0,2.9405951760748748,3219097522.2443995
2020-10-17,11362.1,11321.8,11402.7,11274.4,29860.0,19345.5,0.1,11395.699999999999,59.34934783982243,52.06631906132304,11704.979707592021,10294.620292407977,11107.381206247903,70.39578277968378,285.2802225552662,63542460.0,7.756871076041801,0.0035417770711889673,2.5108054193790426,2.5108054193790426,11103.825,10961.5,10814.760761351217,10544.2,11081.8,0,159.0,2.9407965209028184,3226968201.2222295
2020-10-18,11506.9,11362.1,11506.9,11349.8,31510.0,19345.5,0.1,11397.0,62.53594735741427,48.19356022921846,11763.870590884675,10317.099409115322,11145.430615176674,82.36435743819086,276.1244923727472,63573970.0,7.814183586466659,0.012744123005430374,2.3996427567176846,2.3996427567176846,11157.875,10961.5,10886.85190044312,10544.2,11081.8,0,160.0,2.9410009053223503,3234938701.9105306
2020-10-19,11753.4,11507.1,11823.3,11413.9,73040.0,19345.5,0.1,11540.799999999997,67.24345564707555,57.66465887877905,11866.265673952046,10305.954326047955,11203.332461350325,94.5918762088975,285.64417148897957,63647010.0,8.933685527596271,0.021421929451024946,2.4303109865143666,2.4303109865143666,11268.05,10961.5,10953.17574840767,10544.2,11081.8,0,161.0,2.9412106252137837,3243070944.5069838
2020-10-20,11913.5,11753.9,12029.4,11685.7,94590.0,19345.5,0.1,11724.599999999999,69.8898152053224,69.3576626671188,11987.609913275377,10298.350086724622,11270.967465031246,92.16786052169215,289.7910163826238,63741600.0,12.36394846547073,0.013621590348324775,2.4324591126253727,2.4324591126253727,11417.75,10961.5,11040.188173566903,10544.2,11081.8,0,162.0,2.9414236097143243,3251310656.745112
2020-10-21,12808.7,11913.6,13213.5,11894.6,197720.0,19345.5,0.1,12158.533333333333,79.74395699075455,128.58463150016502,12332.133048877633,10172.646951122366,11417.418182647318,84.80423439318295,363.29880092672204,63939320.0,20.033924036398066,0.07514164603181261,2.836344054640377,2.836344054640377,12009.8,11545.3,11158.893592738874,10544.2,11081.8,1,163.0,2.941655724442297,3260084177.569381
2020-10-22,12974.6,12805.5,13183.9,12698.2,113310.0,19345.5,0.1,12565.599999999999,80.98587446721817,167.66490055573925,12640.902246094287,10104.107753905715,11565.721212871382,89.9478246234116,372.0417437176704,64052630.0,18.770425023571736,0.012952134096356316,2.8674621469461132,2.8674621469461132,12009.8,11545.3,11446.538489755432,10544.2,11081.8,0,164.0,2.941890906210199,3268963602.35482
2020-10-23,12934.1,12972.7,13025.5,12738.9,73940.0,19345.5,0.1,12905.799999999997,79.70119063677619,178.51484818079626,12871.20749272891,10112.79250727109,11696.043002121725,87.06720977596743,365.9387620235511,63978690.0,17.006205786036073,-0.003121483513942591,2.829255704096544,2.829255704096544,12009.8,11545.3,11693.913101189672,12934.1,11081.8,0,165.0,2.9421248462168568,3277833439.534026
2020-10-24,13117.2,12933.6,13161.5,12876.4,51200.0,19345.5,0.1,13008.633333333333,81.15653494911345,184.96456324300874,13109.72071015278,10118.70928984722,11831.391287633942,95.15812760822568,360.1645647361546,64029890.0,16.097854563478027,0.014156377328148118,2.7457427250949484,2.7457427250949484,12009.8,11545.3,11906.655267023118,12934.1,11081.8,0,166.0,2.9423621699598534,3286818597.4015822
2020-10-25,13032.2,13117.0,13345.3,12900.4,59730.0,19345.5,0.1,13027.833333333334,78.34825885890469,170.78710573665842,13292.34668645868,10160.35331354132,11945.754022144994,85.2360069788278,366.2170958264292,63970160.0,14.609093307536721,-0.006480041472265441,2.8100941961175336,2.8100941961175336,12088.15,11611.2,12089.61352963988,12934.1,11081.8,0,167.0,2.942597343050118,3295769775.927091
2020-10-26,13061.6,13033.0,13229.7,12792.4,89470.0,19345.5,0.1,13070.333333333334,78.62378336741781,151.33562420878087,13429.140027344403,10269.459972655595,12052.025067654995,86.62234167963413,371.2944461245415,64059630.0,13.24530297644336,0.002255950645324578,2.842641377201426,2.842641377201426,12107.0,11611.2,12290.523364897499,12934.1,11081.8,0,168.0,2.942832722440435,3304750666.811004
2020-10-27,13657.8,13061.5,13782.3,13050.3,128639.99999999999,19345.5,0.1,13250.533333333331,83.27245559974483,165.42509275500612,13666.90395289058,10330.386047109421,12204.956013592615,95.13234546663017,397.05912854421706,64188270.0,19.555664489924546,0.04564525019905674,2.9071968292420234,2.9071968292420234,12341.525,11829.7,12459.287626513898,12934.1,11081.8,0,169.0,2.9430797035607035,3314072206.3188224
2020-10-28,13278.9,13658.3,13851.7,12907.6,144180.0,19345.5,0.1,13332.766666666665,72.48403731862129,137.1931445515093,13797.015323747482,10435.754676252514,12307.236393250461,78.19649042670622,436.13347650534445,64044090.0,16.273510560050436,-0.027742388964547726,3.2844096762935515,3.2844096762935515,12472.575,11864.400000000001,12697.429853741396,12934.1,11081.8,0,170.0,2.943318712765489,3323201714.0599546
2020-10-29,13457.2,13278.3,13640.0,12982.9,111230.0,19345.5,0.1,13464.633333333331,74.17929573604945,119.16142895873782,13939.674387454701,10533.395612545299,12416.756736750418,84.9834418179742,451.9167996121056,64155320.0,16.988611666521784,0.01342731702174138,3.3581785186525095,3.3581785186525095,12529.7,11864.400000000001,12907.6,12934.1,11081.8,0,171.0,2.9435609040315662,3332443385.0459986
2020-10-30,13559.9,13457.0,13667.9,13134.5,108770.0,19345.5,0.1,13432.0,75.12975823999216,103.3720654973032,14088.511802747806,10610.708197252192,12525.627523726567,88.678073953362,457.7370282112409,64264090.0,19.765942413001234,0.007631602413577854,3.3756666952650156,3.3756666952650156,12733.1,11918.150000000001,12907.6,12934.1,11081.8,0,172.0,2.9438047330754573,3341755542.562306
2020-10-31,13797.3,13560.2,14065.4,13441.7,102750.0,19345.5,0.1,13604.799999999997,77.21744037523311,98.17650290249662,14257.691891203096,10684.158108796903,12646.73918813356,90.12741198998378,469.5915261961522,64366840.0,21.432657695320398,0.017507503742652863,3.4035030491194087,3.4035030491194087,12850.125,12106.0,12982.9,12934.1,13797.3,0,173.0,2.9440528179248373,3351210860.494969
2020-11-01,13759.4,13795.5,13889.5,13628.7,51710.0,19345.5,0.1,13705.533333333333,76.11888995907377,82.10052247316435,14398.635469814324,10765.764530185677,12752.706884501793,88.45936262492928,454.67784575356984,64315130.0,19.57521139490219,-0.0027469142513389944,3.304488900341365,3.304488900341365,12868.2,12106.0,13134.5,12934.1,13797.3,0,174.0,2.9442997548843017,3360660917.9733615
2020-11-02,13561.4,13759.7,13828.4,13214.2,97760.0,19345.5,0.1,13706.033333333331,70.47774505597914,49.64330471712378,14471.53137223981,10906.62862776019,12829.725276454003,78.82085977224018,466.0722853426005,64217370.0,15.382782854323004,-0.014390162361730852,3.4367564214800868,3.4367564214800868,12868.2,12106.0,14065.4,12934.1,13797.3,0,175.0,2.944542392488502,3370018083.252621
2020-11-03,14019.9,13560.5,14054.0,13294.6,108170.0,19345.5,0.1,13780.233333333332,75.08278267514719,50.403254912824764,14591.585811551546,11046.524188448455,12943.07525012505,97.90399852588908,487.02426496098616,64325540.0,17.68078230578755,0.033809193741059174,3.4738069812265864,3.4738069812265864,12940.025,12106.0,13214.2,12934.1,13797.3,0,176.0,2.9447935492779176,3379638060.266227
2020-11-04,14145.6,14023.0,14238.8,13544.4,140800.0,19345.5,0.1,13908.966666666665,76.17979081032945,50.589846880182904,14705.487227411111,11196.882772588891,13057.601416779808,93.95040893158517,501.8368174637729,64466340.0,10.437437054502015,0.008965827145700045,3.5476531038893566,3.5476531038893566,13109.575,12192.7,13214.2,12934.1,13797.3,0,177.0,2.945046689698916,3389340597.062921
2020-11-05,15587.1,14145.6,15739.9,14099.7,227490.0,19345.5,0.1,14584.199999999999,84.56959325719696,134.26326511552213,15102.074214602844,11226.805785397153,13298.50604375316,94.90836387870712,583.1484733592176,64693830.0,20.135495506605213,0.10190447913131995,3.7412249447249177,3.7412249447249177,13903.0,12943.25,13255.184000000001,12934.1,13797.3,1,178.0,2.945325447308568,3399787720.826607
2020-11-06,15577.9,15593.9,15955.2,15223.5,186130.0,19345.5,0.1,15103.533333333331,84.36535918939752,172.9920117592194,15398.09148621194,11352.368513788058,13515.591182443335,88.07069685089158,593.7592966907022,64507700.0,20.440540895771637,-0.0005902316659289752,3.811549032223228,3.811549032223228,14029.475,13050.900000000001,13404.26696,12934.1,13797.3,0,179.0,2.9456036135014183,3410250236.388234
2020-11-07,14828.4,15578.2,15754.4,14385.1,160730.0,19345.5,0.1,15331.133333333331,69.6154856731392,133.88158376527144,15466.364526845753,11616.245473154251,13640.620593639209,64.37334007841152,649.1550612127947,64346970.0,13.045467020400686,-0.04811303192342997,4.3777822368751504,4.3777822368751504,14067.375,13050.900000000001,13608.3416032,12934.1,13797.3,0,180.0,2.9458681277211434,3420360249.266323
2020-11-08,15483.7,14826.6,15648.3,14720.7,94990.0,19345.5,0.1,15296.666666666666,73.91031734358289,137.37921328640982,15646.663821263102,11808.976178736893,13816.151965673569,85.09232325787278,669.0439854118807,64441960.0,18.811098663310872,0.04419222572900661,4.320956783016209,4.320956783016209,14087.300000000001,13050.900000000001,13796.090274944001,12934.1,13797.3,0,181.0,2.9461438108648843,3430815505.079546
2020-11-09,15327.2,15483.3,15819.6,14816.9,165040.0,19345.5,0.1,15213.099999999999,71.31763310956416,115.27910178048523,15747.472278753085,12049.537721246914,13960.061302276086,79.39362121013257,692.8765578824607,64276920.0,17.345501316837144,-0.01010740326924442,4.520568387457987,4.520568387457987,14087.300000000001,13050.900000000001,13968.819052948482,12934.1,13797.3,0,182.0,2.9464163417564952,3441213186.1168685
2020-11-10,15303.6,15328.0,15465.3,15096.5,93360.0,19345.5,0.1,15371.5,70.91365597870353,86.51196960313564,15897.752105093403,12148.747894906597,14088.017368725983,78.61924137025855,669.7282323194278,64183560.0,12.050256996002293,-0.0015397463333159944,4.3762789952653485,4.3762789952653485,14087.300000000001,13050.900000000001,14127.729528712603,12934.1,13797.3,0,183.0,2.946688032362223,3451618278.951274
2020-11-11,15695.8,15303.1,15953.9,15281.0,119070.0,19345.5,0.1,15442.199999999999,73.59093230946091,81.41230497184836,16103.34193996385,12215.278060036153,14241.139524085414,91.27275174107588,669.9547871537543,64302630.0,18.201055810345736,0.025627956820617248,4.2683698005438035,4.2683698005438035,14119.85,13050.900000000001,14273.927166415595,12934.1,13797.3,0,184.0,2.9469660732097243,3462235660.850257
2020-11-12,16294.7,15695.8,16342.7,15483.5,165540.0,19345.5,0.1,15764.699999999997,77.06288821067933,104.41983933022345,16395.69056061578,12258.989439384222,14436.716712267757,98.50383392556573,683.4723023570576,64468170.0,21.085366941117023,0.03815670434128893,4.194445447642838,4.194445447642838,14394.9,13244.650000000001,14408.428993102347,12934.1,13797.3,0,185.0,2.9472537083388857,3473159897.534623
2020-11-13,16324.2,16293.0,16474.1,15973.4,113750.0,19345.5,0.1,16104.9,77.22174070890648,107.26255680560155,16650.980955835486,12324.399044164513,14616.477025385113,95.40169943863314,670.4171379029821,64581920.0,20.385843553418546,0.0018104046100879678,4.106891228378616,4.106891228378616,14615.45,13310.349999999999,14601.856093792112,12934.1,13797.3,0,186.0,2.9475413884865134,3484119704.0922894
2020-11-14,16071.0,16323.1,16328.2,15717.7,83640.0,19345.5,0.1,16229.966666666665,72.5758014535694,79.03161114351144,16799.530133894994,12479.729866105004,14755.003022967485,87.63459001809875,666.1373423384833,64498280.0,16.479311169576665,-0.015510714154445604,4.144965106953415,4.144965106953415,14754.75,13337.55,14826.525362537059,12934.1,13797.3,0,187.0,2.9478244465187506,3494980861.6531153
2020-11-15,15953.0,16074.7,16158.1,15782.3,58430.0,19345.5,0.1,16116.066666666666,70.44859678948646,41.252227364684245,16888.604681614168,12679.795318385834,14869.097973161059,84.01484708119885,645.3989607428774,64439850.0,15.942555634693376,-0.007342418020036101,4.045627535528599,4.045627535528599,14806.974999999999,13430.849999999999,15024.234319032612,15953.0,13797.3,0,188.0,2.948105097874414,3505806187.39061
2020-11-16,16715.8,15954.1,16880.7,15870.7,118090.0,19345.5,0.1,16246.599999999999,75.4566088431625,55.58510140339456,17134.249458730475,12739.950541269525,15044.974356669529,95.40168985806304,671.4418921183861,64557940.0,23.26013538425236,0.047815457907603554,4.0168097974275,4.0168097974275,15295.075,13634.150000000001,15198.218200748699,15953.0,13797.3,0,189.0,2.9483978081241666,3517014127.2675447
2020-11-17,17662.3,16715.8,17845.4,16562.0,175870.0,19345.5,0.1,16777.03333333333,79.98834725848242,113.42619127237435,17516.511798714622,12796.028201285379,15294.243465558146,95.74285049988369,715.1531855385016,64733810.0,25.98021383890042,0.05662307517438592,4.049037699158669,4.049037699158669,15811.650000000001,14116.5,15433.76565264388,15953.0,13797.3,0,190.0,2.948704802577353,3528672842.1422257
2020-11-18,17774.6,17662.3,18466.1,17258.9,233430.0,19345.5,0.1,17384.233333333334,80.44959042581048,142.01004603038905,17857.71931790551,12886.560682094487,15530.46789740975,84.16315500183217,750.2993865714656,64967240.0,25.654620518040932,0.006358175322579651,4.2211885869244075,4.2211885869244075,16205.275,14426.849999999999,15819.62714822086,15953.0,13797.3,0,191.0,2.9490130374213743,3540406219.6501584
2020-11-19,17803.5,17775.1,18166.0,17380.1,135940.0,19345.5,0.1,17746.8,80.57368142004297,145.11155694571335,18138.430933847554,13030.209066152442,15746.947145275488,83.76378338642492,752.8422875306467,65103180.0,14.21945069961699,0.001625915632419428,4.228619583400155,4.228619583400155,16251.4,14426.849999999999,16295.992261541105,15953.0,13797.3,0,192.0,2.9493212517572003,3552177857.8515854
2020-11-20,18675.2,17805.5,18811.0,17758.4,134420.0,19345.5,0.1,18084.43333333333,83.89429304171104,185.53343056249219,18577.317274761645,13079.112725238358,16025.828369534966,96.93169750785154,774.2535527070289,65237600.0,19.88265427304066,0.04896228269722247,4.1458916247591935,4.1458916247591935,16474.475,14599.3,16686.611654463704,15953.0,13797.3,0,193.0,2.949641782519639,3564350076.9635744
2020-11-21,18687.2,18673.8,18966.0,18397.5,108910.0,19345.5,0.1,18388.63333333333,83.93500360324865,191.941089294143,18919.511173127623,13229.69882687238,16279.29233434116,93.43273738016161,759.5568703708125,65346510.0,26.02303687518546,0.0006425633995887914,4.064583620717991,4.064583620717991,16639.324999999997,14676.8,17111.489323570964,15953.0,13797.3,0,194.0,2.949962020689783,3576555254.2121787
2020-11-22,18412.9,18689.3,18751.5,17644.6,121760.0,19345.5,0.1,18591.766666666666,79.01819130179877,157.98492732258865,19089.977403056997,13544.382596942998,16482.493064403905,86.66939818273846,784.3670939157546,65224750.0,18.917958885796036,-0.014678496510980743,4.2598780958771,4.2598780958771,16639.324999999997,14676.8,17482.39145885677,15953.0,13797.3,0,195.0,2.950277846525317,3588671649.747319
2020-11-23,18379.6,18428.1,18756.8,18016.0,127350.0,19345.5,0.1,18493.233333333334,78.41763000869574,115.52952000548703,19235.82265492401,13834.507345075992,16663.16991541306,84.84558728517894,781.2551586360578,65097400.0,19.91492249073541,-0.0018085146826410936,4.250664642517018,4.250664642517018,16674.300000000003,14733.6,17644.6,15953.0,13797.3,0,196.0,2.950592729036484,3600800968.4329567
2020-11-24,19152.6,18394.6,19416.6,18074.8,180790.0,19345.5,0.1,18648.366666666665,81.8635319336523,121.16540016020667,19482.00165806075,14089.028341939247,16900.25849489753,93.61640390753458,821.2940758763392,65278190.0,25.150944875715503,0.042057498530980064,4.288159706130443,4.288159706130443,16959.6,14968.699999999999,17644.6,15953.0,19152.6,0,197.0,2.950918147116018,3613284740.2340693
2020-11-25,18723.0,19151.5,19486.7,18527.7,146120.0,19345.5,0.1,18751.733333333334,74.72304539221894,79.62524250531806,19705.68321612548,14178.936783874526,17073.85292395491,80.92276179056753,831.1302133137435,65132070.0,19.286688158615686,-0.022430374988252177,4.439086755935179,4.439086755935179,17187.4,15008.75,17999.0,15953.0,19152.6,0,198.0,2.951237044957151,3625616905.4090657
2020-11-26,17162.0,18721.9,18894.9,16235.2,312070.0,19345.5,0.1,18345.866666666665,55.70862537653769,-61.69112486828453,19713.812831425723,14329.217168574276,17082.24788357825,38.320509418944,961.7423409341906,64820000.0,5.322589553658546,-0.08337339101639696,5.603905960460264,5.603905960460264,17105.7,15008.75,19486.7,15953.0,19152.6,1,199.0,2.9515322596703446,3637281246.023831
2020-11-27,17127.1,17160.9,17450.3,16481.6,138800.0,19345.5,0.1,17670.699999999997,55.36938663829665,-160.60450671068975,19633.629679958907,14639.270320041094,17086.519513713654,37.39453435924642,962.2393165817484,64681200.0,4.918464610823181,-0.002033562521850718,5.618226766830045,5.618226766830045,17105.7,15018.150000000001,19486.7,15953.0,19152.6,0,200.0,2.95182648848193,3648953290.3801613
2020-11-28,17730.7,17142.6,17874.4,16874.4,95200.0,19345.5,0.1,17339.93333333333,59.91576037443338,-186.64168727636275,19638.303371832662,14859.296628167336,17147.870036217115,52.596911780585266,964.9365082544807,64776400.0,10.327297616825343,0.035242393633481583,5.442179430335411,5.442179430335411,17125.800000000003,15018.150000000001,19421.670000000002,15953.0,19152.6,0,201.0,2.9521295089420745,3660927783.552266
2020-11-29,18185.5,17729.7,18336.3,17530.4,79120.0,19345.5,0.1,17681.1,62.97610472331518,-174.70723891579314,19642.270407249434,15141.159592750566,17246.69193752977,64.0154867256637,953.5767576648748,64855520.0,13.994233059612613,0.025650425533114918,5.2436103360637585,5.2436103360637585,17188.25,15161.8,19357.9406,15953.0,19152.6,0,202.0,2.952438830748724,3673132110.261231
2020-11-30,19698.1,18186.0,19831.2,18186.0,185590.0,19698.1,0.1,18538.1,70.9264075016932,-71.69401475730001,19861.711281779084,15361.168718220913,17480.159372050744,96.2986651835372,1003.0141321173838,65041110.0,17.841204130224096,0.08317615682824231,5.091933395187271,5.091933395187271,17499.325,15442.150000000001,16235.2,15953.0,19152.6,0,203.0,2.9527689879207992,3686009727.2083464
2020-12-01,18770.7,19697.8,19897.4,18257.0,208720.0,19698.1,0.1,18884.766666666663,62.118900470792056,-72.54619640270221,19887.450810189595,15642.919189810407,17603.068003284006,69.2343400141991,1048.5416941089993,64832390.0,6.275513381609425,-0.04708068290850376,5.586055363460069,5.586055363460069,17603.775,15561.0,16307.12,15953.0,19152.6,0,204.0,2.953085828392472,3698526509.4575715
2020-12-02,19218.8,18767.9,19335.5,18346.7,91920.0,19698.1,0.1,19229.199999999997,64.41805049291173,-50.50798539129369,20011.066795985444,15811.713204014555,17756.947241066482,81.47015455190864,1044.2744302440708,64924310.0,8.125077357577672,0.023872311634622,5.43360891545815,5.43360891545815,17603.775,15561.0,16450.731200000002,15953.0,19152.6,0,205.0,2.9534084921953734,3711263739.406954
2020-12-03,19433.3,19219.8,19596.6,18883.7,99970.0,19698.1,0.1,19140.933333333334,65.49757231154734,-30.070487513212584,20133.57797982582,16000.112020174183,17916.599884774438,87.32728960733981,1020.6048280837798,65024280.0,9.15437975678939,0.011160946573147035,5.251834881794547,5.251834881794547,17687.675000000003,15561.0,16588.597952000004,15953.0,19152.6,0,206.0,2.9537336470806697,3724121151.78022
2020-12-04,18658.1,19431.1,19529.5,18610.8,110630.0,19698.1,0.1,19103.399999999998,58.58044879398077,-74.79945818293368,20061.056934995206,16331.343065004796,17987.21894336735,66.15968543498435,1013.3259117920813,64913650.0,-0.0915652844414099,-0.03989029140701794,5.431024122456636,5.431024122456636,17711.725000000002,15561.0,16720.950033920002,15953.0,19152.6,0,207.0,2.9540475008553235,3736674962.7745132
2020-12-05,19146.5,18657.5,19172.7,18507.1,59440.0,19698.1,0.1,19079.3,61.349922650537266,-77.21825920492438,19952.725567679932,16759.024432320068,18097.62666304665,79.49593140735074,988.4883466640757,64973090.0,2.457832098976836,0.026176298765683725,5.162762628491242,5.162762628491242,17843.225,15561.0,16848.0080325632,15953.0,19152.6,0,208.0,2.954367773921392,3749469293.7158203
2020-12-06,19379.9,19146.0,19417.1,18873.0,54560.0,19698.1,0.1,19061.5,62.63567950822319,-69.08857627059592,19955.611174711168,17022.548825288828,18219.747933232684,85.8691496914423,956.7463219023559,65027650.0,5.251752847188655,0.012190217533230685,4.936797000512675,4.936797000512675,17987.550000000003,15561.0,16969.983711260673,15953.0,19152.6,0,209.0,2.95469080874042,3762392929.4759707
2020-12-07,19170.7,19368.4,19424.6,18908.8,61980.0,19698.1,0.1,19232.366666666665,60.68695980932738,-82.86171052881491,20008.165166165523,17120.834833834477,18310.314796734332,80.1567363879635,925.2501560521877,64965670.0,4.304228601275339,-0.010794689343082253,4.826376481047576,4.826376481047576,18202.175000000003,15585.900000000001,17087.080362810248,15953.0,19152.6,0,210.0,2.9550104933202523,3775256735.8752894
2020-12-08,18326.6,19170.8,19288.6,18229.2,101410.0,19698.1,0.1,18959.066666666666,53.45973905975784,-149.97007197674327,19994.830534350673,17189.369465649324,18311.865768473923,57.10774944022711,934.8322877627455,64864260.0,-4.312730386474944,-0.04403073440197813,5.100958648973326,5.100958648973326,18424.625,15623.6,17199.49314829784,15953.0,19152.6,0,211.0,2.955317744129962,3787776199.126195
2020-12-09,18546.0,18322.4,18637.9,17658.8,129720.0,19698.1,0.1,18681.1,54.961120096546615,-178.77809175376092,19985.022528947346,17273.42747105265,18334.164266714502,63.098683851236935,937.9942672082638,64993980.0,-0.9453613203012338,0.011971669595014944,5.0576634703346475,5.0576634703346475,18292.825,15655.650000000001,17307.409422365927,15953.0,19152.6,0,212.0,2.95562770753002,3800421983.405167
2020-12-10,18247.2,18546.1,18551.8,17926.8,85310.0,19698.1,0.1,18373.266666666663,52.47816204847213,-214.73287732878873,19973.519321398362,17242.13067860164,18325.881955598834,51.68920897008024,915.6375338362449,64908670.0,6.323272345880437,-0.016111290844386894,5.017961845303635,5.017961845303635,18233.774999999998,15791.550000000001,17411.009045471288,15953.0,19152.6,0,213.0,2.955932901674211,3812959935.173354
2020-12-11,18023.6,18250.5,18288.3,17600.1,111530.0,19698.1,0.1,18272.266666666666,50.634684697422415,-247.9937999953172,19963.068934502615,17186.22106549738,18297.093197922753,38.01521667217986,899.3919957050846,64797140.0,5.234394614383054,-0.01225393485027848,4.990079649487809,4.990079649487809,18241.2,15896.0,17510.464683652437,18023.6,19152.6,0,214.0,2.956234371208192,3825421635.6851196
2020-12-12,18808.9,18026.7,18936.2,18025.1,71370.0,19698.1,0.1,18359.899999999998,56.42432749408254,-212.87179999253067,19984.371492264872,17204.518507735127,18345.83670288249,54.013519222644696,900.335424583293,64868510.0,6.080978190370379,0.04357065181206887,4.786752147033016,4.786752147033016,18315.550000000003,16297.800000000001,17600.1,18023.6,19152.6,0,215.0,2.956546722683972,3838268164.802972
2020-12-13,19176.8,18808.1,19403.6,18716.8,82450.0,19698.1,0.1,18669.766666666666,58.85869843663674,-162.88217712025119,20042.89868516962,17225.71131483038,18424.976064512728,68.63274278500843,885.0828942559149,64950960.0,5.451046163151958,0.019559889201388625,4.615383662842158,4.615383662842158,18289.325,16318.150000000001,17600.1,18023.6,19152.6,0,216.0,2.9568637636583524,3851306556.525032
2020-12-14,19273.8,19176.4,19346.5,19007.0,67110.0,19698.1,0.1,19086.5,59.50110862766939,-123.11131860086618,20058.833929902845,17221.89607009715,18505.81643932104,72.85509075871668,846.1126875233496,65018070.0,-2.1540148542245157,0.005058195319344261,4.389962993926209,4.389962993926209,18289.325,16344.900000000001,17691.992,18023.6,19152.6,0,217.0,2.957181686212674,3864417176.927248
2020-12-15,19434.9,19273.9,19556.3,19076.2,98390.0,19698.1,0.1,19295.166666666668,60.60143935304507,-87.45892988065907,20136.05504950867,17215.864950491326,18594.300587957132,91.90082644628114,819.9689241288245,65116460.0,3.538493503172501,0.008358497027052492,4.219053991164475,4.219053991164475,18322.25,16344.900000000001,17780.208319999998,18023.6,19152.6,0,218.0,2.957501359503055,3877628248.3541956
2020-12-16,21352.2,19434.7,21525.3,19299.7,199810.0,21352.2,0.1,20020.3,70.77744788481634,56.01904241684349,20597.292690701273,17173.64730929873,18856.957674818357,95.59003362885971,920.3711438339084,65316270.0,11.100589006597716,0.09865242424710186,4.3104277022222925,4.3104277022222925,19221.475,17158.85,17864.895987199998,18023.6,19152.6,0,219.0,2.957845536349399,3891670415.757705
2020-12-17,22825.4,21352.3,23738.0,21243.1,310740.0,22825.4,0.1,21204.166666666668,75.92323252459435,231.08954594739794,21426.90164409987,16913.868355900126,19234.904562930893,85.13172257612541,1032.8374907029151,65627010.0,17.455089974425352,0.06899523234139804,4.524948043420554,4.524948043420554,20327.824999999997,18322.8,18084.520227967998,18023.6,19152.6,1,220.0,2.9582069320690647,3906317837.37762
2020-12-18,23127.9,22823.3,23272.8,22361.5,131800.0,23127.9,0.1,22435.166666666668,76.82561376353198,341.54611206926074,22182.21803084837,16698.271969151636,19605.666033127953,90.06011828149694,1024.1562413669926,65758810.0,23.95635139698042,0.01325277979794448,4.428228422671287,4.428228422671287,20327.824999999997,18322.8,18536.79860973056,18023.6,19152.6,0,221.0,2.9585713268183578,3921117284.20541
2020-12-19,23844.0,23127.6,24107.1,22797.0,133880.0,23844.0,0.1,23265.766666666666,78.84677706265987,431.33013136431464,23003.713323353586,16442.626676646418,20009.316887115765,95.95666205624714,1044.5807955550645,65892690.0,24.534510223800694,0.03096260360862857,4.380895804206779,4.380895804206779,20512.375,18545.0,18952.894720952114,18023.6,23844.0,0,222.0,2.9589433111911387,3936219052.810347
2020-12-20,23474.9,23843.6,24280.9,23098.9,114090.0,23844.0,0.1,23482.266666666663,75.20594705320269,433.2123547561855,23577.292009832232,16246.727990167772,20339.37242167617,87.93557657765537,1054.396453015417,65778600.0,21.130139990402423,-0.015479785270927637,4.49159081834392,4.49159081834392,20705.525,18707.7,19468.315248856903,18023.6,23844.0,0,223.0,2.9593106601927275,3951227934.3107696
2020-12-21,22728.5,23474.1,24101.9,22015.5,154690.0,23844.0,0.1,23349.13333333333,68.33420467522292,354.8349830115412,23931.372999250394,16288.427000749607,20566.908381516536,76.7632618848042,1128.1109920857443,65623910.0,18.55852942250413,-0.03179566260133171,4.963420340478889,4.963420340478889,20878.45,18747.550000000003,20045.825418994074,18023.6,23844.0,0,224.0,2.9596689506478304,3965997764.813743
2020-12-22,23823.2,22730.4,23825.4,22388.6,130750.0,23844.0,0.1,23342.2,72.32781999434258,346.94708341407295,24462.080507622533,16218.159492377465,20877.031392800673,93.14902406897377,1150.160206936763,65754660.0,29.992469961695033,0.04816419913324688,4.827899723533207,4.827899723533207,21012.6,18747.550000000003,20554.034368714787,18023.6,23844.0,0,225.0,2.9600392131183737,3981215736.8563027
2020-12-23,23257.9,23820.8,24063.7,22694.7,178470.0,23844.0,0.1,23269.866666666665,67.58746835091293,276.9260315608867,24818.83251285061,16243.867487149384,21103.780783962513,84.68746257933181,1165.791620726994,65576190.0,25.406556669901875,-0.023728970079586298,5.012454351970703,5.012454351970703,21128.100000000002,18747.550000000003,21001.258244469012,18023.6,23844.0,0,226.0,2.9604026169540045,3996266046.0554533
2020-12-24,23736.5,23253.2,23783.7,22737.3,104590.0,23844.0,0.1,23605.866666666665,69.41510782589074,237.61983165239963,25198.58950173561,16371.950498264392,21354.515947394655,91.85127529637167,1157.2636478179231,65680780.0,30.082971634004117,0.020577954157511957,4.875460357752504,4.875460357752504,21347.975000000002,18787.75,21394.81525513273,18023.6,23844.0,0,227.0,2.960770920856696,4011535287.995884
2020-12-25,24689.6,23728.7,24778.9,23445.3,2400.0,24689.6,0.1,23894.666666666668,72.71467629666593,249.36549966650546,25718.79424819111,16406.05575180889,21672.143000023738,98.67778139713934,1169.8591015452146,65683180.0,36.98484209591869,0.04015335032544809,4.738266725849,4.738266725849,22100.25,19161.65,21741.145424516802,18023.6,23844.0,0,228.0,2.9611491486773263,4027192389.2972417
2020-12-26,26454.4,24714.7,26826.0,24515.1,155770.0,26454.4,0.1,24960.166666666668,77.54526292113499,343.72620543495805,26557.14113770875,16275.158862291255,22127.596047640527,95.41755043654123,1251.3620228634136,65838950.0,40.64831010851246,0.0714794893396411,4.730260458991372,4.730260458991372,23316.9,20462.85,22166.43106508445,18023.6,23844.0,0,229.0,2.961545142050521,4043502937.9808073
2020-12-27,26261.3,26460.3,28360.3,25858.2,231230.0,26454.4,0.1,25801.766666666663,75.96062245897825,359.18984668908115,27212.528064619215,16328.831935380786,22521.282138341427,77.55872258988805,1340.7004498017411,65607720.0,36.94307705143716,-0.0072993528486755554,5.105232603876202,5.105232603876202,24084.05,21372.7,22911.962094670936,18023.6,23844.0,0,230.0,2.961938678976247,4059797317.6932545
2020-12-28,27057.8,26259.2,27444.9,26144.3,126980.0,27057.8,0.1,26591.166666666668,77.96118400552913,386.72700056548,27870.25703984721,16544.222960152787,22953.331458499386,85.97063797244752,1337.8361319587598,65734700.0,40.386431321275516,0.03032980088571402,4.944364035356754,4.944364035356754,24084.05,21372.7,23892.66291763017,18023.6,23844.0,0,231.0,2.9623396023342687,4076405688.6187363
2020-12-29,27376.0,27065.3,27390.7,25902.8,119570.0,27376.0,0.1,26898.366666666665,78.72297982087235,388.98263747642113,28475.604792802376,16821.87520719762,23374.537986261348,89.13648102774651,1348.5549796759913,65854270.0,40.859999279646395,0.011760010052554115,4.926048289289857,4.926048289289857,24084.05,21540.5,24696.837592456737,18023.6,23844.0,0,232.0,2.962743095263283,4093168774.466306
2020-12-30,28868.7,27374.5,28979.3,27374.5,159820.0,28868.7,0.1,27767.5,81.88612255611301,449.34134116358587,29236.799422722244,17122.830577277753,23897.791511379317,98.57035753987748,1366.8581954134204,66014090.0,35.202461573046335,0.05452586206896548,4.734741070479171,4.734741070479171,24486.824999999997,21898.1,25356.260825814523,18023.6,23844.0,0,233.0,2.9631600990357403,4110458846.463999
2020-12-31,28949.4,28866.8,29298.8,28025.0,136690.0,28949.4,0.1,28398.033333333336,82.04156235317592,451.81913735786316,29795.177485141365,17657.03251485864,24378.897081724142,95.20272403992698,1360.2111814553189,66150780.0,26.82975982896247,0.0027954151035551877,4.698581599118872,4.698581599118872,24723.1,22197.65,25902.8,18023.6,23844.0,0,234.0,2.963577306337159,4127828946.173097
2021-01-01,29359.9,28951.7,29627.1,28712.4,100900.0,29359.9,0.1,29059.333333333332,82.84785650002232,437.90569022366253,30355.5033296375,18151.806670362497,24853.27831203613,96.48956855326085,1328.3889542085103,66251680.0,26.945810038957273,0.014179913918768605,4.5245009492829,4.5245009492829,24897.899999999998,22454.05,26582.0,18023.6,23844.0,0,235.0,2.9639976995735817,4145381445.310488
2021-01-02,32193.3,29359.7,33233.5,29008.0,240870.0,32193.3,0.1,30167.533333333336,87.13978587750084,568.0736372285583,31461.22931062642,18347.730689373588,25552.32799660412,90.72740238901764,1535.3254574793311,66492550.0,35.01635631605435,0.0965057782894354,4.76908380774674,4.76908380774674,26878.1,24358.5,27191.02,18023.6,23844.0,0,236.0,2.964441890974508,4163825930.899167
2021-01-03,32958.9,32192.9,34755.9,32029.6,155210.0,32958.9,0.1,31504.03333333333,88.01263019261738,648.4684719141696,32499.014788626508,18678.455211373494,26257.715806451346,85.89526231515495,1620.3950676593793,66647760.0,40.400598085614845,0.02378134580797875,4.916411250555629,4.916411250555629,27906.75,25236.800000000003,28399.516,18023.6,23844.0,0,237.0,2.9648917336259495,4182547575.904975
2021-01-04,32022.6,33016.6,33587.5,28204.5,255270.0,32958.9,0.1,32391.599999999995,80.79078464422678,583.3627811126262,33064.46585530121,19371.774144698797,26806.75239631312,77.89897552416451,1889.1525628265665,66392490.0,40.891831841080574,-0.028408108280312816,5.899435282664639,5.899435282664639,28242.525,25236.800000000003,34755.9,32022.6,23844.0,0,238.0,2.9653334085160954,4201070472.6521907
2021-01-05,33991.5,32015.4,34414.7,30010.5,202130.0,33991.5,0.1,32991.0,83.8009249136072,614.546602785967,34104.365416492044,19595.804583507954,27491.014072854727,93.6623221569993,2068.7988083389546,66594620.0,42.68234326203029,0.061484701429615374,6.086223933450876,6.086223933450876,28253.675,25269.1,34755.9,32022.6,23844.0,0,239.0,2.9657902789000623,4220204498.8460536
2021-01-06,36793.2,33999.3,36934.8,33408.3,227560.0,36793.2,0.1,34269.1,86.93767691766014,756.1947923893849,35746.467394696396,19350.4826053036,28376.936542106658,99.00264131008976,2172.920322029029,66822180.0,58.19656976769182,0.0824235470632364,5.905766070983305,5.905766070983305,29449.375,26402.75,28204.5,32022.6,23844.0,0,240.0,2.966267483063968,4240137027.7943816
2021-01-07,39460.2,36798.5,40340.9,36361.2,249600.0,39460.2,0.1,36748.299999999996,89.10117167178198,949.3347153888221,37799.55770621428,18930.62229378573,29432.485442858404,94.78740026989273,2301.97601331267,67071780.0,66.24270638046889,0.07248622027983442,5.833665347141348,5.833665347141348,31693.274999999998,28288.050000000003,28379.106,32022.6,23844.0,0,241.0,2.9667625667016804,4260792332.0698338
2021-01-08,40599.3,39466.4,41921.7,36613.4,251290.0,40599.3,0.1,38950.899999999994,89.87270122686618,1064.9532110139708,39788.170679085815,18617.539320914184,30495.991591157603,92.40288166557517,2516.713440933193,67323070.0,64.43887304776102,0.02886706098803371,6.198908456385191,6.198908456385191,32718.85,29078.449999999997,28857.57776,32022.6,40599.3,0,242.0,2.9672645609857597,4281792609.6483693
2021-01-09,40151.9,40607.2,41363.5,38775.1,128419.99999999999,40599.3,0.1,40070.46666666667,87.25990054730448,1022.2478977768396,41292.01967005254,18781.39032994745,31415.60191580926,88.98247579917205,2521.833909437965,67194650.0,51.77777609773799,-0.01101989443167739,6.280733687416946,6.280733687416946,32781.024999999994,29078.449999999997,29641.4250944,32022.6,40599.3,0,243.0,2.9677630340426924,4302771645.76604
2021-01-10,38192.2,40149.7,41362.4,35141.6,215780.0,40599.3,0.1,39647.799999999996,76.73644316320329,783.7056087438154,42075.38137053506,19544.39862946493,32060.99220954171,76.71812671282048,2786.045773049539,66978870.0,45.43149044411358,-0.048807154829534904,7.294803056774785,7.294803056774785,32836.899999999994,29078.449999999997,30378.241588736,32022.6,40599.3,0,244.0,2.9682477210855676,4323361940.307032
2021-01-11,35544.3,38195.3,38217.2,30411.6,251040.0,40599.3,0.1,37962.799999999996,65.28065651553062,389.21573838918175,42362.1482694046,20429.7417305954,32392.735808632977,60.18827759708847,3144.5853606888572,66727830.0,31.364338564110916,-0.06933091050004958,8.846946938577654,8.846946938577654,33322.75,29078.449999999997,41921.7,32022.6,40599.3,0,245.0,2.968712888575125,4343351418.859834
2021-01-12,34076.1,35426.0,36598.7,32572.7,241930.0,40599.3,0.1,35937.53333333333,59.93758693927632,-7.940647255877593,42294.38223935111,21579.327760648892,32553.056207810787,46.06797184337879,3207.5435492110814,66485900.0,24.474357101110456,-0.04130620099425242,9.412883367554038,9.412883367554038,33515.85,29078.449999999997,41691.498,32022.6,40599.3,0,246.0,2.9691663728786972,4363012884.606939
2021-01-13,37382.2,34061.2,37764.6,32451.9,209930.0,40599.3,0.1,35667.533333333326,66.57237796191828,-81.24598831466665,42513.45711830585,22724.822881694156,33012.97466420976,67.33397137449897,3357.911867124575,66695830.0,29.49041695677324,0.09702107929017689,8.982649140833272,8.982649140833272,33967.35,29078.449999999997,41465.90004,32022.6,40599.3,0,247.0,2.9696436844929504,4383625279.266484
2021-01-14,39175.7,37383.4,40054.3,36772.1,172400.0,40599.3,0.1,36878.0,69.52125895853641,-44.07040380333001,42925.78371191685,23761.106288083152,33599.90088666597,79.98133729915726,3352.503876615677,66868230.0,35.32473902740642,0.04797737960847681,8.557610653072382,8.557610653072382,34067.625,29078.449999999997,41244.8140392,32022.6,40599.3,0,248.0,2.9701327557730104,4404762664.125233
2021-01-15,36845.8,39175.7,39715.0,34488.7,118420.0,40599.3,0.1,37801.23333333333,61.88379323937695,-202.641630706637,43011.94461810835,24714.085381891648,33909.034135554924,62.996092497011084,3486.346456857415,66749810.0,25.49702144762074,-0.059473091737990535,9.461991480324528,9.461991480324528,34067.625,29078.449999999997,41028.149758415995,32022.6,40599.3,0,249.0,2.9706050982309287,4425391260.909958
2021-01-16,36019.5,36751.8,37931.7,35408.4,137020.0,40599.3,0.1,37347.0,59.391819668102315,-379.1725004351156,42843.48408472236,25858.365915277645,34110.03088454969,56.972268392966505,3417.557424224742,66612790.0,11.885081678485898,-0.022425893860358648,9.488075692957265,9.488075692957265,34160.899999999994,29078.449999999997,40815.81876324768,32022.6,40599.3,0,250.0,2.9710708966082966,4445876566.712418
2021-01-17,35839.6,36020.1,36801.3,33883.5,126820.0,40599.3,0.1,36234.96666666667,58.836312020666895,-515.5901377367804,42610.3510473256,26969.678952674392,34274.751752687815,55.66077625171318,3381.8604653515463,66485970.0,8.74027956030085,-0.004994516858923714,9.43609991560047,9.43609991560047,34097.875,29201.649999999998,40607.734387982724,32022.6,40599.3,0,251.0,2.9715348078298005,4466387324.166171
2021-01-18,36613.2,35838.2,37436.8,34801.0,111520.0,40599.3,0.1,36157.43333333333,60.545274085177574,-557.6890634417446,42321.22251441039,28182.527485589613,34497.46110957469,55.432701994761224,3328.5704321121507,66597490.0,14.33550055273463,0.021585062333284943,9.09117594777881,9.09117594777881,34108.25,29398.05,40403.81170022307,32022.6,40599.3,0,252.0,2.9720037679934137,4487179851.399889
2021-01-19,36002.9,36630.6,37821.0,36001.4,79110.0,40599.3,0.1,36151.899999999994,58.48248164908785,-625.5101314971353,42045.24013112986,29171.92986887014,34640.83624199615,48.57733642626913,3220.7868298184258,66518380.0,5.917361693364522,-0.016668851670981977,8.945909440124062,8.945909440124062,33958.225,29726.05,40203.96746621861,32022.6,40599.3,0,253.0,2.9724677360080616,4507883638.097418
2021-01-20,35476.3,35862.1,36384.4,33444.5,153610.0,40599.3,0.1,36030.799999999996,56.687801483945776,-699.1308450217034,41604.0636139132,30265.796386086822,34720.4042189489,44.00222413358707,3200.7234848313956,66364770.0,-3.5791939814965654,-0.014626599523927197,9.022145727799673,9.022145727799673,34735.75,29760.899999999998,40008.120116894235,32022.6,40599.3,0,254.0,2.9729272625499945,4528517130.478559
2021-01-21,30842.1,35472.3,35591.1,30101.8,253270.0,40599.3,0.1,34107.1,43.91576105289446,-1033.0713197951204,41362.38347353132,30655.69652646868,34351.04191238234,6.2631663550453,3364.1932359148673,66111500.0,-21.839980537351558,-0.13062805309460135,10.907795629723227,10.907795629723227,34484.0,29760.899999999998,39816.18971455635,32022.6,40599.3,0,255.0,2.973349433863994,4547842872.301456
2021-01-22,33000.5,30838.7,33821.2,28871.2,243090.0,40599.3,0.1,33106.299999999996,49.610249560770626,-1076.8270244348632,41298.21499616822,30800.58500383178,34222.41887310783,33.054761733227664,3477.4651476352333,66354590.0,-18.716578857270942,0.06998226450209288,10.537613513841407,10.537613513841407,34187.5,29760.899999999998,39427.6141259741,32022.6,40599.3,0,256.0,2.973788843665564,4567901055.995581
2021-01-23,32088.9,32994.1,33441.4,31418.2,100700.0,40599.3,0.1,31977.166666666668,47.42029449376855,-1129.8727119397686,41369.60803306821,30642.191966931798,34019.22659947851,25.759734853336752,3373.589065661288,66253890.0,-20.08124148545897,-0.027623823881456344,10.51325868341167,10.51325868341167,34102.675,29760.899999999998,38794.22927841565,32022.6,40599.3,0,257.0,2.974220346917208,4587748421.531124
2021-01-24,32241.3,32088.5,33034.8,30982.9,88210.0,40599.3,0.1,32443.566666666666,47.83487547467421,-1115.4832353725815,41348.81328400495,30684.856715995047,33849.90025667103,30.13565111641672,3279.1827038283386,66342100.0,-15.581453804703575,0.004749305834727879,10.170752121745522,10.170752121745522,34024.774999999994,29760.899999999998,38198.84752171071,32022.6,40599.3,0,258.0,2.9746525527478997,4607708851.2528305
2021-01-25,32252.3,32244.3,34854.3,31967.4,142430.0,40599.3,0.1,32194.166666666668,47.86682745510243,-1066.0624302717115,41444.73607127826,30415.013928721743,33697.747851273794,30.234013824431493,3251.162510697743,66484530.0,-9.26168190117685,0.0003411773098478399,10.080405151563589,10.080405151563589,34159.725,29760.899999999998,37639.18867040807,32022.6,40599.3,0,259.0,2.9750843060401455,4627738947.168816
2021-01-26,32502.1,32244.1,32917.7,30850.0,139840.0,40599.3,0.1,32331.899999999994,48.63623914535373,-979.6059573424341,41410.09124407999,30020.54875592001,33583.87662734296,32.46774150280331,3166.6294742193327,66624370.0,-4.619073192061298,0.007745184064392285,9.742845767563734,9.742845767563734,34204.6,29760.899999999998,37113.109350183586,32022.6,40599.3,0,260.0,2.975517542865462,4647913143.249831
2021-01-27,30404.0,32499.6,32545.4,29290.4,194350.0,40599.3,0.1,31719.466666666664,42.908230508206906,-1022.0732092387207,41131.70676988259,29393.313230117394,33281.03123426268,13.706396258640261,3172.9416546322377,66430020.0,-18.667173146577774,-0.06455275197602617,10.435934925115898,10.435934925115898,34204.6,29760.899999999998,36618.594789172574,30404.0,40599.3,0,261.0,2.975932726375634,4667479748.497149
2021-01-28,33374.8,30408.9,33790.8,29911.9,167390.0,40599.3,0.1,32093.63333333333,51.60021641569473,-817.3062829564981,40281.058325066806,29521.511674933205,33289.96159290433,41.531566425053974,3223.367250729935,66597410.0,-14.807393358638121,0.09771082752269455,9.658087091847547,9.658087091847547,33845.45,29760.899999999998,36153.75110182222,30404.0,40599.3,0,262.0,2.976371838876155,4688054786.208578
2021-01-29,34301.8,33381.7,38546.0,31953.3,297730.0,40599.3,0.1,32693.533333333336,53.95586669162356,-596.8797191185959,39421.03614513611,29796.523854863888,33386.32715548487,56.13139289701082,3464.033875677797,66895140.0,-6.904450439398792,0.027775447343504567,10.09869416671369,10.09869416671369,34385.85,29760.899999999998,28871.2,30404.0,34301.8,0,263.0,2.9768175899271503,4708978718.873344
2021-01-30,34283.1,34300.0,34920.9,32908.5,128570.0,40599.3,0.1,33986.566666666666,53.898877346006316,-437.1850776085289,38936.38063656918,29890.26936343082,33471.73409305774,55.93810724769502,3360.3457417008112,66766570.0,-4.820722108857707,-0.0005451608953467302,9.801755797173568,9.801755797173568,34552.524999999994,29760.899999999998,29064.696,30404.0,34301.8,0,264.0,2.9772626461123584,4729969050.833515
2021-01-31,33108.1,34281.6,34348.3,32189.9,101920.0,40599.3,0.1,33897.666666666664,50.30357984184897,-396.7234168785876,38817.39426894876,29765.635731051236,33437.10227467129,43.79315334683919,3274.492474436468,66664650.0,-7.62145782877041,-0.03427344668364296,9.89030622245453,9.89030622245453,34657.325,29760.899999999998,29254.322079999998,30404.0,34301.8,0,265.0,2.977698009276098,4750672896.945537
2021-02-01,33515.7,33106.8,34685.6,32324.9,126320.0,40599.3,0.1,33635.63333333333,51.511870823261376,-331.21369801632284,38801.285181784544,29725.70481821546,33444.58777232164,48.00616033406372,3209.2215834052913,66790970.0,-8.460063583625578,0.012311186688453768,9.575278402078105,9.575278402078105,34657.325,29973.399999999998,29440.1556384,30404.0,34301.8,0,266.0,2.9781360356741704,4771572406.962987
2021-02-02,35485.2,33514.0,35976.1,33462.4,120850.0,40599.3,0.1,34036.33333333332,56.95752610170327,-153.00675715845694,38517.07024253323,29820.21975746677,33638.93179400529,68.36317029809399,3159.541470304913,66911820.0,-1.437939721522445,0.05876350486488424,8.903828836542878,8.903828836542878,34657.325,30319.25,29622.272525632,30404.0,34301.8,0,267.0,2.978588477278983,4793134435.961498
2021-02-03,37646.8,35486.9,37646.8,35401.5,131030.0,40599.3,0.1,35549.23333333333,62.00162683891423,99.10282339449759,38128.388700246825,30056.011299753172,34020.63352790955,90.705751023277,3094.2385081402767,67042850.0,6.118169031156011,0.06091553661808313,8.219127543749472,8.219127543749472,34517.774999999994,30464.35,29800.74707511936,30404.0,34301.8,0,268.0,2.9790558509212963,4815387726.750263
2021-02-04,36982.1,37648.9,38707.9,36380.8,151440.0,40599.3,0.1,36704.7,59.685355968548116,203.72340734354907,38154.19381937408,30043.83618062592,34302.67795382293,82.45549828702713,3039.442900415971,66891410.0,19.907853226596114,-0.017656215136479192,8.218686608970208,8.218686608970208,34557.975000000006,30498.949999999997,29975.652133616975,30404.0,34301.8,0,269.0,2.979517991815223,4837535514.749786
2021-02-05,38297.6,36976.4,38303.6,36640.0,100600.0,40599.3,0.1,37642.166666666664,62.65857563864577,336.3237727074263,38592.480312908156,29833.359687091845,34683.14672012551,95.64321741438808,2941.168407529116,66992010.0,16.05157497613672,0.03557126285419154,7.679772120261102,7.679772120261102,34386.325,30610.699999999997,30324.942048272296,30404.0,34301.8,0,270.0,2.9799887195056187,4860129952.457723
2021-02-06,39256.6,38300.6,40939.7,38275.3,156020.0,40599.3,0.1,38178.76666666666,64.70230307769062,455.9926456792773,39244.04917597335,29523.490824026645,35118.71369916117,85.5519215746869,2921.3992355627497,67148030.0,22.337007501036172,0.02504073362299475,7.44180401655454,7.44180401655454,35675.975,31582.399999999998,30660.260366341405,30404.0,34301.8,0,271.0,2.9804653500061646,4883068145.5372305
2021-02-07,38852.9,39228.9,39691.7,37381.6,125370.0,40599.3,0.1,38802.36666666666,63.135795223815634,473.27943971816774,39650.6268775446,29340.883122455394,35474.35048971725,82.08647729906521,2877.735004451125,67022660.0,20.506617289005103,-0.01028362109810832,7.406744424357319,7.406744424357319,35735.125,31968.6,31277.02674436092,30404.0,34301.8,0,272.0,2.980938701106883,4905981968.314141
2021-02-08,46395.7,38853.6,46596.4,38057.0,248470.0,46395.7,0.1,41501.73333333333,75.21167059129957,931.537293793124,42320.19083191073,27710.59916808928,36514.47901450608,98.84028660580142,3282.13964699033,67271130.0,43.852376419666186,0.19413737455891322,7.0742324116035125,7.0742324116035125,38563.475000000006,34305.95,31856.787139699263,30404.0,34301.8,0,273.0,2.9814578922205732,4930869785.452552
2021-02-09,46508.6,46396.4,48143.5,45104.7,193870.0,46508.6,0.1,43919.06666666666,75.34187325396903,1165.8826090017506,44428.11553281024,26705.90446718975,37466.300060743604,91.32821657976672,3264.758243633878,67465000.0,43.09413853258713,0.00243341516562956,7.019687205449912,7.019687205449912,39370.774999999994,35079.5,33035.95616852332,30404.0,34301.8,0,274.0,2.9819771113396953,4955885344.854139
2021-02-10,44836.0,46507.8,47295.3,43800.5,151830.0,46508.6,0.1,45913.43333333333,69.51625764799809,1130.9953930490333,45715.449843305934,26817.960156694073,38168.17624543469,81.85842164154545,3281.18979766003,67313170.0,47.467438494934875,-0.03596324120700256,7.3182036703988524,7.3182036703988524,39655.149999999994,35079.5,34546.710551670985,30404.0,34301.8,0,275.0,2.9824861471259285,4980609266.344964
2021-02-11,47990.7,44834.8,48622.1,44041.1,145770.0,47990.7,0.1,46445.1,73.65406019743745,1234.6765292432997,47617.55976776887,26414.870232231122,39103.65469825044,96.21208485313879,3374.0333835414563,67458940.0,43.793221232786394,0.07036087072887853,7.030598394150234,7.030598394150234,40379.225000000006,35505.35,35906.389496503885,30404.0,34301.8,0,276.0,2.9830123565569147,5006166853.823988
2021-02-12,47371.7,47995.0,48927.4,46218.6,133730.0,47990.7,0.1,46732.79999999999,71.60037421291452,1176.1316920557251,49033.99434120427,26526.71565879572,39891.08758413135,90.70530246452574,3326.5167132884953,67325210.0,38.10266516625948,-0.012898332385232969,7.022160305179032,7.022160305179032,40776.700000000004,35811.05,37432.27475692342,30404.0,34301.8,0,277.0,2.9835345609743755,5031689510.793304
2021-02-13,47168.7,47373.1,48097.3,46270.5,89420.0,47990.7,0.1,47510.36666666666,70.90216286572172,1042.8432808128732,50184.68811640677,26868.76188359323,40584.19352849979,89.49245705750558,3219.3940909107455,67235790.0,37.585865922276575,-0.0042852589204103175,6.8252762762398484,6.8252762762398484,40841.5,35832.35,39041.59229095414,30404.0,34301.8,0,278.0,2.984055034217523,5057270332.460277
2021-02-14,48643.4,47172.1,49695.1,47051.9,106500.0,48643.4,0.1,47727.93333333333,72.96467066974301,974.3842879462654,51421.75776389823,27270.80223610176,41351.737001976,93.94537771585821,3178.2373701314064,67342290.0,46.922958430112274,0.03126437658871262,6.533748401903251,6.533748401903251,41410.75,36570.2,40425.60537022056,30404.0,34301.8,0,279.0,2.9845829402751054,5083293627.775092
2021-02-15,47936.3,48611.1,48936.5,45786.1,123180.0,48643.4,0.1,47916.13333333333,70.38836373952559,808.6896542852373,52317.34025628828,27918.63974371172,41978.83823988305,89.16508036247824,3176.248986550592,67219110.0,43.02640255164,-0.014536401649555719,6.625978614433303,6.625978614433303,41410.75,37105.1,41908.724510985274,30404.0,34301.8,0,280.0,2.9851064095090756,5109263958.573204
2021-02-16,49169.7,47934.2,50515.8,47044.4,141370.0,49169.7,0.1,48583.13333333333,72.23025766460191,712.7306005705404,53006.88176917708,29105.668230822925,42663.68221703705,91.09386475060039,3197.331201796978,67360480.0,38.56396469514051,0.02572997915984332,6.502645331976763,6.502645331976763,41989.95,38187.0,43154.54458922763,30404.0,34301.8,0,281.0,2.9856359006936577,5135622789.2156925
2021-02-17,52079.2,49161.3,52577.7,49018.1,140030.0,52079.2,0.1,49728.399999999994,76.01955397364208,770.8511186395722,54312.956757190215,29670.033242809775,43560.398196366856,96.92225055411839,3223.207544525765,67500510.0,38.33632606224166,0.05917262053663119,6.189049648469572,6.189049648469572,44561.575,39240.25,44479.57056316666,30404.0,34301.8,0,282.0,2.986179780572843,5162731582.748428
2021-02-18,51582.2,52094.5,52524.0,50941.6,94350.0,52079.2,0.1,50943.69999999999,74.15803427358892,703.3471562671084,55321.562498429535,30389.467501570463,44324.37932052239,93.75380387383375,3106.007005631068,67406160.0,39.478828946977046,-0.009543157344966913,6.02147059573083,6.02147059573083,44561.575,39240.25,46099.19645053332,30404.0,34301.8,0,283.0,2.986720533342274,5189849828.488651
2021-02-19,55906.6,51590.1,56238.5,50816.8,139430.0,55906.6,0.1,53189.333333333336,78.98094894097775,866.7302864459666,56978.756050269854,30894.62394973015,45427.44795666312,98.23990157448996,3271.4136480859916,67545590.0,45.97938252005348,0.08383512141785343,5.8515696681357685,5.8515696681357685,46452.125,41806.5,47394.897160426655,30404.0,34301.8,0,284.0,2.9872816624934577,5217989202.993327
2021-02-20,55923.7,55922.0,57523.8,54124.1,127850.0,55923.7,0.1,54470.833333333336,78.9976408898927,889.4068825417517,58122.62160112758,32032.31839887241,46427.09100840949,92.05598196820603,3280.5769589369925,67673440.0,42.456809810324884,0.0003058672857945144,5.866165791850311,5.866165791850311,47531.025,42774.4,49163.61772834133,30404.0,34301.8,0,285.0,2.987842233033901,5246257413.521214
2021-02-21,57433.8,55907.6,58335.1,55502.7,87260.0,57433.8,0.1,56421.36666666666,80.4724505339758,915.9552382601269,59244.73184219279,33302.01815780721,47475.34900760859,95.55530350476624,3248.5643190129217,67760700.0,47.82371457471643,0.0270028628291763,5.656189071614488,5.656189071614488,47936.675,43269.8,50816.8,30404.0,57433.8,0,286.0,2.988409112193885,5274954158.952159
2021-02-22,54111.8,57437.6,57480.8,48353.8,244950.0,57433.8,0.1,55823.1,68.99457668545679,633.0776486256345,59606.23044576279,34803.17955423721,48107.39195926491,70.9431288098744,3668.4525819405703,67515750.0,16.63106710320139,-0.05784050506844396,6.779394849072791,6.779394849072791,48092.05,43269.8,58335.1,30404.0,57433.8,0,287.0,2.9889598200334166,5303099807.333007
2021-02-23,48911.2,54114.1,54115.0,45093.8,315070.0,57433.8,0.1,53485.6,55.6199089662289,49.7560064348545,59380.01704870087,36155.83295129913,48183.945106001585,35.16230236814221,4050.7916832305295,67200680.0,5.165926301802244,-0.09610842736704384,8.281930689147945,8.281930689147945,48429.325,43269.8,58335.1,30404.0,57433.8,1,288.0,2.9894835688766808,5330208723.028423
2021-02-24,49697.5,48911.1,51311.8,47031.7,153750.0,57433.8,0.1,50906.833333333336,56.97784621861379,-309.3428954460169,58925.18327523474,37882.20672476526,48328.09319114429,39.57184832796978,4067.1708487140636,67354430.0,10.842849495940762,0.016076072555978982,8.183854014214123,8.183854014214123,48488.475,43269.8,57805.448,30404.0,57433.8,0,289.0,2.9900108636799745,5357613562.157902
2021-02-25,46928.5,49695.9,52013.8,46773.7,83220.0,57433.8,0.1,48512.4,51.0535492922958,-735.2646549361516,58320.249225383086,39350.230774616924,48194.7986015115,13.855890282676155,4150.951502377345,67271210.0,-2.2133455023577424,-0.05571708838472755,8.845267806082328,8.845267806082328,48488.475,43603.15,57296.982079999994,30404.0,57433.8,0,290.0,2.9905226169063894,5384468213.150067
2021-02-26,46345.6,46928.5,48413.9,44248.2,189410.0,57433.8,0.1,47657.19999999999,49.87785518508441,-1039.5545528179555,57695.714536268526,40683.665463731464,48018.6844489866,14.88901035714033,4152.004966493249,67081800.0,-2.166061171543345,-0.012421023471877457,8.958789974654012,8.958789974654012,48310.825,43603.15,56808.85479679999,30404.0,57433.8,0,291.0,2.9910305170134,5411285537.713435
2021-02-27,46136.7,46333.1,48335.1,45059.4,98750.0,57433.8,0.1,46470.26666666666,49.43845286988013,-1225.4194156082567,56786.87523533662,42320.88476466337,47839.4478347974,13.406072308314815,4089.4117546008742,66983050.0,-2.187891546724841,-0.004507439756956444,8.863684993943812,8.863684993943812,48595.2,43603.15,56055.21550899199,30404.0,57433.8,0,292.0,2.991536645492189,5438157158.279832
2021-02-28,45164.0,46136.0,46582.0,43100.6,135080.0,57433.8,0.1,45882.1,47.34688878160078,-1373.2653703417027,56851.672577343226,42132.91742265677,47584.64327910241,13.5442580983951,4045.982343557955,66847970.0,-7.15287171538174,-0.021082999000795355,8.958423398188724,8.958423398188724,48793.075,43603.15,55346.79457845247,45164.0,57433.8,0,293.0,2.9920366347401424,5464885315.2076025
2021-03-01,49595.5,45160.5,49774.0,45008.8,137520.0,57433.8,0.1,46965.399999999994,56.397436273779995,-1141.5181124373235,56877.600648046864,42415.679351953135,47776.15344299742,42.63283993567233,4097.355033303816,66985490.0,3.461260047187616,0.09812018421751834,8.261545973533517,8.261545973533517,49037.899999999994,43603.15,54367.09901217627,45164.0,57433.8,0,294.0,2.992560385872339,5492823619.43411
2021-03-02,48424.2,49595.6,50191.9,47100.6,102100.0,57433.8,0.1,47727.899999999994,53.76676378224344,-1038.9536131516597,56741.86235792314,42910.23764207686,47837.87216271195,34.94436968722307,4025.4939594964007,66883390.0,-1.5161776459892984,-0.023617062031837666,8.312979790056213,8.312979790056213,48889.125,43603.15,53465.779091202174,45164.0,57433.8,0,295.0,2.9930773131391777,5520593823.849702
2021-03-03,50395.1,48422.2,52567.9,48159.2,44930.0,57433.8,0.1,49471.6,57.370085295281285,-819.8391161236987,56813.70844766027,43078.83155233974,48081.4176710251,47.88145328038334,4052.8658195323724,66928320.0,-3.2337286287039713,0.040700724018156276,8.042182314416229,8.042182314416229,48233.075,43603.15,52636.564763906,45164.0,57433.8,0,296.0,2.9936040119558815,5548952879.437743
2021-03-04,48428.0,50388.0,51757.7,47521.8,9560.0,57433.8,0.1,49082.43333333333,52.93560119095761,-788.6050633951941,56802.45914501822,43195.71085498178,48114.42551187985,34.969313072303,4065.9396895657737,66918760.0,-6.114900101197695,-0.03903355683389853,8.395844737684344,8.395844737684344,47846.3,43603.15,52567.9,45164.0,57433.8,0,297.0,2.994119750839886,5576952854.018085
2021-03-05,48792.5,48363.6,49429.4,46370.1,113640.0,57433.8,0.1,49205.19999999999,53.650522476222456,-726.1735185452253,56784.638214765626,43375.91178523438,48179.004034557955,37.36190882536349,3994.03685459679,67032400.0,-12.72497343784097,0.007526637482448084,8.185759808570559,8.185759808570559,48015.15,43603.15,52567.9,45164.0,57433.8,0,298.0,2.9946368377510413,5605156938.468694
2021-03-06,48855.6,48798.7,49191.8,47132.8,66660.0,57433.8,0.1,48692.033333333326,53.78141019915609,-665.0403023097476,56786.78521170435,43394.98478829564,48243.44174555244,37.77610029866422,3855.819936411305,67099060.0,-12.638827545387732,0.0012932315417328866,7.892278339456081,7.892278339456081,49276.05,43603.15,51810.516,45164.0,57433.8,0,299.0,2.9951536588237695,5633491662.432663
2021-03-07,50982.3,48899.0,51434.1,48890.6,82910.0,57433.8,0.1,49543.46666666667,58.07830264337649,-474.71566508300725,56874.38212579128,43611.98787420873,48504.28538883316,54.80939068997651,3764.582798096212,67181970.0,-11.23293252405378,0.04353032201016882,7.384097614458766,7.384097614458766,49276.05,43603.15,43100.6,45164.0,57433.8,0,300.0,2.995680946768999,5662459843.478344
2021-03-08,52311.0,50988.9,52384.9,49338.1,68140.0,57433.8,0.1,50716.299999999996,60.54622634346251,-263.2380027133388,57070.99174511369,43729.50825488631,48866.829637515715,83.62144102266124,3713.312598232197,67250110.0,-3.3279247779597108,0.026061986218746558,7.098531089507364,7.098531089507364,49276.05,43603.15,43267.27,45164.0,57433.8,0,301.0,2.9962143068553218,5691863058.002677
2021-03-09,54879.0,52352.4,54880.6,51941.3,114060.0,57433.8,0.1,52724.1,64.85283967513861,30.101160927030833,57458.94452625364,43621.53547374637,49439.41729108564,99.98641765704586,3658.0259840727545,67364170.0,12.201295408822526,0.0490910133623903,6.6656207002182155,6.6656207002182155,50331.274999999994,43603.15,43631.97519999999,45164.0,57433.8,0,302.0,2.9967594953822334,5721978797.98197
2021-03-10,55851.9,54882.7,57328.7,53073.6,140960.0,57433.8,0.1,54347.299999999996,66.35139328852085,257.5080417748852,58041.50787296641,43465.94212703359,50050.12993002986,89.62053963635344,3700.6741280675574,67505130.0,12.383721515166762,0.01772809271305964,6.625869716281017,6.625869716281017,51283.625,43603.15,44306.89268799999,45164.0,57433.8,0,303.0,2.9973086222836702,5752441616.994533
2021-03-11,57799.5,55851.2,58135.0,54351.8,129630.0,57799.5,0.1,56176.799999999996,69.18392995984013,493.2849646302302,58444.03411950939,43252.7058804906,50788.16517478892,97.76845101899644,3706.5688332055884,67634760.0,23.16502764844391,0.034870792220139224,6.412804320462268,6.412804320462268,51485.2,43603.15,45348.63727295999,45164.0,57433.8,0,304.0,2.9978660179405896,5783462393.120747
2021-03-12,57265.1,57806.2,58052.3,55134.5,116960.0,57799.5,0.1,56972.166666666664,67.50476164707331,562.4285139511071,58710.25941635613,43120.620583643875,51405.01611052331,94.21393604001489,3650.228202262332,67517800.0,23.56102844714493,-0.009245754721061594,6.374263211384128,6.374263211384128,51485.2,43603.15,46627.27354566399,45164.0,57433.8,0,305.0,2.9984203720508464,5814504772.915878
2021-03-13,61195.3,57267.4,61795.8,56118.8,134640.0,61195.3,0.1,58753.299999999996,72.74416039478226,807.1433273852413,59662.42975697138,42544.60024302862,52337.42409999728,96.78794556891609,3794.997616386451,67652440.0,32.63909208937788,0.06863167967924633,6.201452752721943,6.201452752721943,53265.575,45333.5,47778.046191097594,45164.0,61195.3,0,306.0,2.998991312510805,5846515863.07292
2021-03-14,59113.7,61192.7,61673.7,59113.7,80290.0,61195.3,0.1,59191.36666666667,66.61758320807144,763.5757786422237,60520.26090420719,42186.95909579281,52982.783709521354,84.0227557038184,3706.783500930276,67572150.0,30.88676822247807,-0.034015684211042396,6.270599710270676,6.270599710270676,53456.25,45333.5,49460.176648165885,45164.0,61195.3,0,307.0,2.9995526376713673,5878236473.442628
2021-03-15,55791.3,59117.4,60565.9,55088.8,117710.0,61195.3,0.1,58700.1,58.19331485847496,460.6770122211119,60987.37690357442,42407.85309642558,53250.261451471706,61.07470001361366,3833.2346794352566,67454440.0,12.492665665231732,-0.05620355349098427,6.870667432799121,6.870667432799121,53895.7,45543.100000000006,50940.45145038598,45164.0,61195.3,0,308.0,3.000098333966963,5909366140.639614
2021-03-16,56889.7,55619.5,56889.7,53342.6,128509.99999999999,61195.3,0.1,57264.899999999994,59.99449188815313,292.18806860110135,61563.74150940041,42550.70849059959,53596.87464656964,68.19528449276204,3812.796488047024,67582950.0,17.48196149858955,0.019687657394611646,6.702085769562899,6.702085769562899,54007.575,45543.100000000006,52243.09327633966,45164.0,61195.3,0,309.0,3.000648460717762,5940878754.255842
2021-03-17,58913.5,56892.9,58933.2,54253.2,118260.0,61195.3,0.1,57198.166666666664,63.14512183525059,275.1679771861254,62304.189301506995,43008.760698493,54103.21991832492,81.3149484302171,3874.739596043665,67701210.0,16.903230671235896,0.03557410216612156,6.5769977951465535,6.5769977951465535,54658.375,45543.100000000006,53342.6,45164.0,61195.3,0,310.0,3.001207018725568,5972976264.250093
2021-03-18,57656.0,58911.8,60088.0,57099.6,102620.0,61195.3,0.1,57819.73333333333,59.98402157348871,143.9457854446564,62647.10832313318,43796.88167686681,54441.5799261035,73.16296829317308,3811.4296248976893,67598590.0,19.055092095481953,-0.02134485304726419,6.610638311533387,6.610638311533387,54941.45,45543.100000000006,53342.6,45164.0,61195.3,0,311.0,3.001759356474578,6004938890.771872
2021-03-19,58088.0,57645.0,59448.3,56305.1,83980.0,61195.3,0.1,58219.166666666664,60.711671441150045,55.514675264017114,62880.45097835321,44758.66902164678,54788.858028379356,74.71322376048556,3763.6989374049977,67682570.0,19.051083670646104,0.007492715415568174,6.479305428668567,6.479305428668567,55008.7,45543.100000000006,54253.2,45164.0,61195.3,0,312.0,3.00231300054972,6037138280.653819
2021-03-20,58093.4,58084.1,59882.1,57863.0,67830.0,61195.3,0.1,57945.799999999996,60.72128625694778,-28.81125363313822,62778.51755574424,46153.54244425577,55103.57631139085,71.31078944921427,3639.0847275903548,67750400.0,18.90837488435308,9.296240187306459e-05,6.26419649665944,6.26419649665944,55008.7,45853.850000000006,55158.312,45164.0,61195.3,0,313.0,3.002866041162242,6069480568.316993
2021-03-21,57383.8,58097.4,58583.8,55583.3,77470.0,61195.3,0.1,57855.06666666667,58.68875676722407,-151.70759285229678,62945.509094548506,46765.38090545151,55320.74047221077,64.58415277298378,3593.471532762472,67672930.0,12.556318565462915,-0.012214812698172262,6.262170739411597,6.262170739411597,55008.7,46874.55,61795.8,45164.0,61195.3,0,314.0,3.0034152740078324,6101804525.696763
2021-03-22,54158.3,57379.3,58379.9,53784.2,95530.0,61195.3,0.1,56545.166666666664,50.42610516751451,-452.5497769572826,62688.36479988496,47595.93520011504,55210.03185580974,22.49733624232584,3665.0592804222956,67577400.0,3.5313796333467207,-0.0562092437238384,6.767308575827334,6.767308575827334,54978.174999999996,46992.850000000006,61671.55,45164.0,61195.3,0,315.0,3.0039489141196047,6133510263.710614
2021-03-23,54452.5,54117.5,55813.8,52992.3,84840.0,61195.3,0.1,55331.53333333333,51.1023175397832,-623.503841021773,62581.660072741135,48108.37992725886,55137.885964780246,16.5865848810132,3604.805046106417,67662240.0,-0.777164306929791,0.005432223685012172,6.620090989589858,6.620090989589858,54613.65,46992.850000000006,61356.056000000004,45164.0,61195.3,0,316.0,3.0044833441198655,6165421489.516346
2021-03-24,52325.4,54309.1,57169.4,51725.4,137910.0,61195.3,0.1,53645.399999999994,46.195911005936544,-857.1854712956283,62208.59678074864,48871.18321925136,54870.0301586107,5.958055290753097,3736.176114241673,67524330.0,-6.314019755818514,-0.03906340388411911,7.1402724379396485,7.1402724379396485,54177.45,47060.350000000006,60854.23064,45164.0,61195.3,0,317.0,3.005006857039818,6196939739.136535
2021-03-25,51322.3,52330.0,53175.4,50441.3,143350.0,61195.3,0.1,52700.06666666667,44.048123311454624,-1044.2487944241338,61900.14370793784,49432.61629206217,54532.15109588588,7.75903826676648,3664.5992489386963,67380980.0,-11.206325314232817,-0.01917042201301855,7.140364420415095,7.140364420415095,53856.425,47629.100000000006,60123.9241888,51322.3,61195.3,0,318.0,3.005524761929738,6228330697.136188
2021-03-26,55036.1,51317.4,55074.1,51302.0,100300.0,61195.3,0.1,52894.6,52.798089174933324,-888.8849045809106,61386.49822576342,50564.311774236565,54580.14622961103,40.466775287330975,3672.2778740145036,67481280.0,-3.8924231338109947,0.0723623064437875,6.672489282515483,6.672489282515483,54333.475000000006,48598.65,59155.66176992,51322.3,61195.3,0,319.0,3.0060601266944573,6260785045.0269985
2021-03-27,55862.9,55033.8,56531.1,54010.2,73870.0,61195.3,0.1,54073.76666666666,54.503906223966155,-709.2543503378749,61124.3345199803,51314.535480019724,54702.31325536236,48.26751184074643,3590.036597299182,67555150.0,-8.713741087959372,0.01502286680923981,6.426513119260156,6.426513119260156,54622.325,49088.3,58284.225592928,51322.3,61195.3,0,320.0,3.0065987325833676,6293577686.681013
2021-03-28,55765.2,55856.9,56504.2,54711.3,58710.0,61195.3,0.1,55554.73333333333,54.25439700841119,-581.2133475189028,60966.51024360517,51817.77975639484,54803.54056437547,52.58380577998138,3461.6696974920974,67496440.0,-5.664507550703137,-0.001748924599331625,6.20758052959928,6.20758052959928,54622.325,49217.9,57499.9330336352,51322.3,61195.3,0,321.0,3.0071362717329757,6326486771.493895
2021-03-29,57616.2,55764.7,58392.6,54951.1,107910.0,61195.3,0.1,56414.76666666666,58.16213152356242,-366.5336127544804,61077.81092176705,51980.19907823296,55071.412891577806,74.37672986617181,3460.2290048140903,67604350.0,3.2709400928101586,0.033192743861763185,6.0056529323594585,6.0056529323594585,54297.75,49588.7,50441.3,51322.3,61195.3,0,322.0,3.0076816313316845,6359979792.809523
2021-03-30,58771.3,57614.6,59366.9,57077.1,86210.0,61195.3,0.1,57384.23333333333,60.43356718604797,-152.37957372071742,61313.97160352354,52035.97839647646,55423.78309237992,86.35077280313477,3376.6269330416553,67690560.0,3.307452842957523,0.02004818089356819,5.745367097616787,5.745367097616787,54493.525,49588.7,50600.326,51322.3,61195.3,0,323.0,3.008231497150614,6393888957.607646
2021-03-31,58763.7,58771.4,59795.6,56991.6,98060.0,61195.3,0.1,58383.73333333333,60.41032800735448,-23.63483303450562,61427.50597130956,52018.864028690434,55741.87041691517,86.271989384971,3335.7250092529657,67592500.0,-0.25427109236423384,-0.00012931481862754612,5.676506090074256,5.676506090074256,54791.375,49926.4,50950.98896,51322.3,61195.3,0,324.0,3.008780706912659,6427944576.076227
2021-04-01,58718.3,58763.2,59406.5,58040.7,69040.0,61195.3,0.1,58751.1,60.26125203864321,42.469562926178924,61575.686032702135,52016.00396729788,56025.33990101848,87.67265485975769,3195.0160800206113,67523460.0,1.8424795337866013,-0.0007725857970140027,5.441261208210406,5.441261208210406,55230.825,52448.2,51481.6656224,51322.3,61195.3,0,325.0,3.009329095213259,6462138218.960029
2021-04-02,58977.3,58718.2,60134.9,58466.5,72370.0,61195.3,0.1,58819.76666666666,60.8547296468211,85.17620283092992,61143.4641916042,52226.42580839581,56306.47895806434,88.05810018981597,3085.9720743048533,67595830.0,1.5309530367717994,0.00441089064226996,5.232474315210857,5.232474315210857,55427.525,52448.2,51980.501685056006,51322.3,61195.3,0,326.0,3.0098779979185597,6496541942.744449
2021-04-03,57059.9,58976.8,59770.5,56906.7,68740.0,61195.3,0.1,58251.833333333336,54.37992853278063,-28.108067431895734,60904.81911379901,52259.690886201,56378.233343010594,68.27803911859371,3070.1026404259355,67527090.0,-1.7790316972323879,-0.03251081348247553,5.380490748189071,5.380490748189071,55918.5,52448.2,52632.85355025152,51322.3,61195.3,0,327.0,3.0104177536344303,6530635220.945814
2021-04-04,58199.9,57059.7,58464.8,56470.6,57210.0,61195.3,0.1,58079.03333333333,57.28959115937878,-38.045680173586334,61064.42548805095,52340.94451194905,56551.72540558102,80.03837583560288,2993.252451824083,67584300.0,1.422178384840318,0.019979004519811605,5.1430542867325935,5.1430542867325935,56595.55,52448.2,53233.0172662314,51322.3,61195.3,0,328.0,3.0109619966716905,6565151635.472611
2021-04-05,58993.4,58202.3,59205.1,56842.7,54130.0,61195.3,0.1,58084.4,59.23838038325091,-4.712770769320969,61282.57721594196,52333.16278405806,56784.265843144734,88.22418915573162,2948.191562408077,67638430.0,8.927717450510814,0.013634044044749327,4.997493893228865,4.997493893228865,56770.825000000004,52448.2,53785.16788493289,51322.3,61195.3,0,329.0,3.011509113613974,6600007928.676218
2021-04-06,57996.3,59169.0,59487.0,57403.3,77150.0,61195.3,0.1,58396.53333333333,55.79337247799311,-60.26727003830547,61167.725576793746,52356.29442320627,56899.69766760714,77.93802096228441,2886.442165093214,67561280.0,6.508057481291039,-0.01690189071997883,4.9769419171450835,4.9769419171450835,56830.775,52448.2,54293.14645413826,51322.3,61195.3,0,330.0,3.0120512172965013,6634774659.671382
2021-04-07,55948.7,57996.3,58627.7,55489.3,110690.0,61195.3,0.1,57646.13333333333,49.43543186295902,-235.52551091850114,61075.9213061557,52277.368693844306,56809.126461168365,56.814805644961574,2904.439153300841,67450590.0,6.92455289400558,-0.03530570053606874,5.1912540475486315,5.1912540475486315,56965.325000000004,52448.2,54760.4867378072,51322.3,61195.3,0,331.0,3.0125834432048215,6669180042.074844
2021-04-08,58077.4,55948.0,58136.7,55721.6,64780.0,61195.3,0.1,57340.799999999996,55.15661983977703,-209.5658917232936,61074.71355193708,52277.51644806293,56929.914417247564,76.7064044651247,2869.486356636495,67515370.0,13.162114714266504,0.03804735409401827,4.9407968618369535,4.9407968618369535,56934.8,52448.2,55190.43979878262,51322.3,61195.3,0,332.0,3.013124681326254,6704264201.488844
2021-04-09,58118.7,58076.8,58890.9,57686.0,59220.0,61195.3,0.1,57381.6,55.262382664201596,-191.58301059995392,61077.62246631965,52277.13753368033,57043.132091795414,67.08083661240546,2750.58733116246,67574590.0,5.601050946560528,0.0007111199881537633,4.7327062222012195,4.7327062222012195,56657.850000000006,52448.2,55489.3,51322.3,61195.3,0,333.0,3.013665488071139,6739509411.624133
2021-04-10,59748.4,58127.4,61229.0,57900.0,103720.0,61195.3,0.1,58648.166666666664,59.33776400856034,-77.73785306637137,61388.28322543232,52202.93677456768,57300.77665448157,77.28339751752921,2791.902521793713,67678310.0,6.95542121873372,0.02804088873288646,4.672765332282895,4.672765332282895,57097.15,52448.2,55721.6,51322.3,61195.3,0,334.0,3.014212801677456,6775305201.739521
2021-04-11,59978.7,59772.4,60667.1,59250.3,58200.0,61195.3,0.1,59281.93333333333,59.8937683925008,1.0947124275892293,61711.47684896732,52461.78315103269,57555.816973102366,80.08410455725637,2693.6809130941615,67736510.0,7.555787480364098,0.0038544965220825844,4.491062515683337,4.491062515683337,57097.15,52448.2,56272.34,51322.3,61195.3,0,335.0,3.0147604868177797,6811312619.890455
2021-04-12,59863.8,59982.1,61259.9,59569.2,81880.0,61195.3,0.1,59863.63333333333,59.45695055486067,31.817177568991156,61967.096644276484,52747.29335572353,57775.62488042595,75.80667521574881,2622.0394193017214,67654630.0,3.900986180969946,-0.0019156800664235085,4.3800083177174205,4.3800083177174205,57112.600000000006,52448.2,56768.005999999994,51322.3,61195.3,0,336.0,3.0153070595700346,6847448943.72028
2021-04-13,63540.9,59863.6,63659.0,59839.4,126560.0,63540.9,0.1,61127.799999999996,67.60070067481374,272.6987048807025,62669.51375844345,53166.42624155654,58324.698701337766,98.55441448278397,2707.5794607801695,67781190.0,8.115525775335918,0.06142443346396309,4.2611600729296715,4.2611600729296715,58312.15,53379.8,57307.033279999996,51322.3,63540.9,0,337.0,3.0158683519620966,6884616042.654858
2021-04-14,62980.4,63544.2,64778.0,61366.3,130430.0,63540.9,0.1,62128.36666666666,65.44283218147311,361.6211855001952,62701.2466601633,54300.5033398367,58768.09882501988,80.64745335730512,2757.873785010157,67650760.0,7.175688392664187,-0.008821090038069967,4.378939773342432,4.378939773342432,58871.65,53939.3,58196.308620799995,51322.3,63540.9,0,338.0,3.0164267362785937,6921818936.041719
2021-04-15,63216.0,62978.6,63729.1,62067.5,76970.0,63540.9,0.1,63245.76666666666,65.93505955651928,400.6182505524764,63271.01228573238,54548.72771426764,59191.70846073227,83.1838685714901,2679.5685146522887,67727730.0,7.659792602987479,0.0037408463585495433,4.238750497741535,4.238750497741535,58871.65,53939.3,59249.379241471994,51322.3,63540.9,0,339.0,3.0169854541827754,6959242693.464594
2021-04-16,61379.7,63211.6,63518.5,60027.3,136850.0,63540.9,0.1,62525.36666666666,58.8938017944035,273.141834060061,63437.582296248205,54933.83770375179,59400.08860732919,63.414686662288545,2737.5421921771253,67590880.0,4.0734316423437384,-0.0290480258162491,4.460012336614753,4.460012336614753,58929.725000000006,53939.3,64778.0,51322.3,63540.9,0,340.0,3.0175359667755215,6996394323.697459
2021-04-17,60041.9,61358.3,62509.1,59672.1,84080.0,63540.9,0.1,61545.86666666667,54.34085526010381,79.19614878240077,63362.13896429952,55436.95103570048,59461.213501869264,49.01224067953535,2744.6463213073307,67506800.0,5.226086971761254,-0.021795479612966462,4.5712183013984085,4.5712183013984085,59420.825,53939.3,64682.986,51322.3,63540.9,0,341.0,3.0180801952010734,7033379098.387002
2021-04-18,56207.1,60043.2,60362.1,51817.6,216810.0,63540.9,0.1,59209.56666666667,43.87107733651306,-305.77744373933547,63462.43881610578,55195.74118389423,59151.29793026267,33.86855343970865,3158.9215840710926,67289990.0,-3.4240608660839675,-0.06386873166905116,5.620146892600922,5.620146892600922,57953.725000000006,53939.3,64482.550559999996,51322.3,63540.9,1,342.0,3.0186068491599616,7069531662.592964
2021-04-19,55646.1,56208.1,57517.0,54272.3,117510.0,63540.9,0.1,57298.36666666666,42.57864544052351,-580.6794793844433,63604.25875565014,54741.40124434985,58817.46955595194,29.53998333384772,3165.0486137803005,67172480.0,-5.674024551899031,-0.009980945467743418,5.687817499843296,5.687817499843296,57953.725000000006,53939.3,63722.6535264,51322.3,63540.9,0,343.0,3.0191303246350296,7105683649.778509
2021-04-20,56483.2,55645.1,57054.9,53422.5,115490.0,63540.9,0.1,56112.13333333333,45.17410497510909,-681.6330148807358,63641.26050441061,54476.349495589406,58595.1581696708,35.99888892318137,3198.4308556531364,67287970.0,-2.6089595370739267,0.015043282458249596,5.662623321010737,5.662623321010737,58168.9,53939.3,63008.350314815994,51322.3,63540.9,0,344.0,3.0196570359319863,7142212288.949087
2021-04-21,53820.2,56479.5,56764.4,53657.6,100260.0,63540.9,0.1,55316.49999999999,39.11676115622864,-890.0814748847888,63934.87572265316,53692.92427734684,58140.40024874977,15.45168359001264,3191.885794535055,67187710.0,-3.8043779390763324,-0.047146762223103544,5.930646475737837,5.930646475737837,58297.8,54893.4,62336.905295927034,51322.3,63540.9,0,345.0,3.0201707457796796,7178156762.17003
2021-04-22,51729.5,53821.3,55408.4,50590.9,168130.0,63540.9,0.1,54010.96666666667,35.13366030666842,-1116.426933600315,64429.0923761453,52473.92762385469,57529.83832029741,8.025600721782455,3308.001094925408,67019580.0,-10.930069183537833,-0.038846009490860256,6.394805855315454,6.394805855315454,57684.45,55574.05,61705.74697817141,51322.3,63540.9,0,346.0,3.0206736940164824,7213640040.156076
2021-04-23,51143.6,51707.1,52099.9,47659.4,214460.0,63540.9,0.1,52231.1,34.08616281761668,-1243.5470980972536,64914.04236025775,51397.347639742235,56921.62514693575,20.353299919385915,3388.893873859307,66805120.0,-12.00147284780974,-0.011326225847920424,6.626232556682179,6.626232556682179,55956.475,55574.05,60816.5592199177,51322.3,63540.9,0,347.0,3.021173136304564,7249088791.850789
2021-04-24,50088.9,51140.8,51183.0,48775.2,82250.0,63540.9,0.1,50987.333333333336,32.22366951880905,-1328.8943468297775,65367.99386499483,50132.29613500518,56270.88941865616,14.192165247158064,3318.815740012214,66722870.0,-16.166960119434158,-0.020622326156156334,6.625850717448804,6.625850717448804,55903.825,55574.05,59500.84329792593,51322.3,63540.9,0,348.0,3.021666652452621,7284354841.634248
2021-04-25,48963.6,50088.2,50532.4,47098.5,59200.0,63540.9,0.1,50065.36666666666,30.320089490312014,-1385.061805470239,65743.1938608154,48754.11613918459,55574.957093069854,10.549506490568165,3327.036044297056,66663670.0,-18.365019581951593,-0.02246605535358137,6.794917130883056,6.794917130883056,55371.025,55574.05,58316.698968133336,48963.6,63540.9,0,349.0,3.0221537652068062,7319404887.906244
2021-04-26,54020.5,48963.5,54320.9,48815.9,129759.99999999999,63540.9,0.1,51024.333333333336,45.811861782902625,-1022.305148715785,65650.53491187912,48449.195088120854,55426.91356039654,39.15269096976724,3482.6048982758375,66793430.0,-9.760990782409406,0.1032787621825193,6.4468209259000515,6.4468209259000515,54834.275,55938.25,56970.515091957335,48963.6,63540.9,0,350.0,3.022665511878035,7356123859.685684
2021-04-27,55036.5,54011.1,55427.8,53345.0,84080.0,63540.9,0.1,52673.533333333326,48.298926612905944,-671.5420332104247,65637.4129794362,48371.097020563786,55389.73131654925,44.899459826352555,3382.618834113278,66877510.0,-13.384135257763113,0.018807674864171897,6.146137261841283,6.146137261841283,54123.0,55938.25,55785.87328092245,48963.6,63540.9,0,351.0,3.023181446687023,7393283839.77566
2021-04-28,54841.4,55036.0,56419.9,53876.4,86960.0,63540.9,0.1,54632.799999999996,47.844811486005774,-422.44281164673646,65510.32440660178,48174.585593398224,55337.509286401706,46.55815184058303,3322.681774533758,66790550.0,-12.923068129132236,-0.0035449201893288373,6.058710708577385,6.058710708577385,54007.475,55938.25,47098.5,48963.6,63540.9,0,352.0,3.0236958794939506,7430539640.854026
2021-04-29,53560.8,54838.6,55173.7,52400.0,83900.0,63540.9,0.1,54479.56666666666,44.863144662098534,-318.4339835150264,65375.39941033068,47853.72058966934,55168.29887817297,39.35627283800245,3283.4687906384893,66706650.0,-15.273348519362182,-0.02335097207584047,6.130358005553481,6.130358005553481,53934.85,55938.25,47284.928,48963.6,63540.9,0,353.0,3.024203667446578,7467572866.970438
2021-04-30,57720.3,53562.3,57925.6,53088.7,103740.0,63540.9,0.1,55374.166666666664,54.731274357371504,37.08293063991982,65172.91924840208,47853.3907515979,55411.34660406126,68.92528519330853,3394.4281627357404,66810390.0,-5.961905972169943,0.07765940762647316,5.880822107188875,5.880822107188875,54225.15,55938.25,47467.62744,48963.6,63540.9,0,354.0,3.024730029623927,7505945272.556849
2021-05-01,57807.1,57719.1,58449.4,57029.5,63410.0,63540.9,0.1,56362.73333333334,54.91262166783046,271.6087375588212,64941.39037082202,47867.75962917798,55639.51359415067,80.73675321933712,3253.3904368260446,66873800.0,-3.722067422916335,0.0015038036877839112,5.628011847724665,5.628011847724665,54356.1,55938.25,47885.9463424,48963.6,63540.9,0,355.0,3.025256177355168,7544502007.16106
2021-05-02,56603.8,57807.2,57868.4,56110.5,53610.0,63540.9,0.1,57377.06666666667,51.813796058589,335.0552127703587,64631.189489087265,47851.96051091273,55731.35039470775,83.74049634830719,3146.56969133847,66820190.0,0.7057827213999733,-0.020815782144407824,5.558937193860606,5.558937193860606,54356.1,55938.25,48519.753561856,48963.6,63540.9,0,356.0,3.0257763401829667,7582881594.985482
2021-05-03,57169.8,56605.8,58925.1,56562.4,89240.0,63540.9,0.1,57193.56666666667,53.152961691668374,400.0954421422059,63636.38589060853,48209.65410939148,55868.345595211766,85.15803358530772,3090.578999100008,66909430.0,2.738197286063182,0.009999328666979945,5.405964336240476,5.405964336240476,54475.025,55938.25,49115.53234814464,48963.6,63540.9,0,357.0,3.026298455669187,7621580170.997247
2021-05-04,53741.5,57170.6,57201.3,53741.5,132330.0,63540.9,0.1,55838.36666666666,44.99593421576989,206.9062964175182,62506.13880663107,48416.011193368926,55665.78887185826,56.16998968427106,3116.9519277357217,66777100.0,-4.8540096878363785,-0.059966975571018266,5.799897523767892,5.799897523767892,54904.375,55938.25,49900.29776029307,48963.6,63540.9,0,358.0,3.0268041500617824,7659435287.033658
2021-05-05,57441.3,53872.5,57936.4,53872.5,119820.0,63540.9,0.1,56117.53333333333,53.32136504206461,316.41838352177365,61341.28952950688,49003.39047049313,55834.88516977652,87.45370605245805,3193.9482186117416,66896920.0,6.728142964909098,0.06884437538959665,5.560368965555691,5.560368965555691,55800.4,55938.25,50622.28193946963,48963.6,63540.9,0,359.0,3.0273262952845292,7698527492.212074
2021-05-06,56405.4,57441.0,58364.9,55294.5,109020.0,63540.9,0.1,55862.73333333333,50.9940473285004,306.974442457463,60437.818091604895,49409.431908395105,55889.21991551209,78.69463751204913,3185.1233458537604,66787900.0,9.039136276206037,-0.018034062599558198,5.646841163884593,5.646841163884593,55800.4,55938.25,51286.507384312055,48963.6,63540.9,0,360.0,3.027843190437757,7737483380.454472
2021-05-07,57337.2,56411.4,58639.3,55300.1,110010.0,63540.9,0.1,57061.299999999996,52.98200915006604,348.3405947394052,59912.733127816784,49664.046872183215,56027.122780701415,86.5734868854954,3196.1288211499204,66897910.0,12.110215158885957,0.016519694922826567,5.574267353742283,5.574267353742283,55800.4,55938.25,51897.59479356709,48963.6,63540.9,0,361.0,3.0283636843538293,7776868667.104166
2021-05-08,58840.1,57330.3,59471.1,56972.2,101270.0,63540.9,0.1,57527.56666666667,56.07689275804227,455.0373762475381,60311.72700627208,49528.35299372792,56295.02537301557,94.90002101417647,3146.326762496355,66999180.0,17.471335964654838,0.02621160433366132,5.347249176150882,5.347249176150882,56109.075,55938.25,52459.79521008173,48963.6,58840.1,0,362.0,3.0288901992968458,7816844712.018572
2021-05-09,58238.3,58840.6,59227.0,56414.4,103590.0,63540.9,0.1,58138.533333333326,54.52909114411049,461.73474963321553,60626.372247521664,49472.92775247834,56480.09914701409,88.4300623169908,3122.489136603758,66895590.0,18.942030406260987,-0.010227718851599454,5.361573288718521,5.361573288718521,56272.275,55938.25,53160.925689073556,48963.6,58840.1,0,363.0,3.029413488681262,7856816947.178213
2021-05-10,55848.9,58251.2,59523.9,53678.3,142610.0,63540.9,0.1,57642.43333333333,48.772946406341795,290.2705012042254,60568.84075069538,49467.029249304614,56419.984942536554,48.41308833644493,3316.9970554177753,66752980.0,3.384641015910629,-0.0410279833030841,5.939234354513294,5.939234354513294,56007.450000000004,55938.25,59471.1,48963.6,58840.1,0,364.0,3.029925478093722,7896255174.066961
2021-05-11,56695.7,55846.1,56871.1,54550.4,96470.0,63540.9,0.1,56927.63333333333,50.756873633411814,221.99157747867667,60730.00730740045,49593.41269259955,56446.243519437834,60.299835764117915,3245.832980030791,66849450.0,3.014726590535367,0.015162339813317605,5.725007328652422,5.725007328652422,55954.8,55938.25,59523.9,48963.6,58840.1,0,365.0,3.0304407250717214,7936105981.409684
2021-05-12,49384.2,56694.5,57938.5,49187.0,160740.0,63540.9,0.1,53976.26666666666,37.31817817080332,-299.1831001804284,60983.37098420817,49105.51901579181,55773.667946158035,1.9077286227011683,3639.0949100285916,66688710.0,-9.950876527586832,-0.12896039734935805,7.368945755987931,7.368945755987931,54579.625,55938.25,59523.9,48963.6,58840.1,0,366.0,3.03092012215918,7973790606.174163
2021-05-13,49704.6,49398.2,51337.3,46331.1,236710.0,63540.9,0.1,51928.166666666664,38.09171628818978,-589.171297259225,61129.572652417846,48815.41734758217,55195.66147509536,25.570765872293972,3736.745273597978,66925420.0,-7.199668414213388,0.006487905038453645,7.517906337839915,7.517906337839915,53137.05,55554.55,59110.424,48963.6,58840.1,1,367.0,3.031400608964799,8011726873.333023
2021-05-14,49839.8,49704.9,51459.2,48874.0,118840.0,63540.9,0.1,49642.86666666666,38.436962574083736,-729.5308174385136,61157.45851722176,48762.62148277824,54685.57942984818,26.595567279121976,3654.492039769551,67044260.0,-13.652908941914715,0.0027200701745915268,7.3324773369266145,7.3324773369266145,52927.5,55554.55,58343.66456,48963.6,58840.1,0,368.0,3.0318812270334234,8049852773.794751
2021-05-15,46708.8,49839.1,50640.9,46650.2,131910.0,63540.9,0.1,48751.06666666667,33.7438028459505,-975.5266090048592,61539.25702466798,48155.34297533202,53925.88615081502,2.8629252319447294,3678.506894071726,66912350.0,-19.198852736082586,-0.06282127937913073,7.875404407888291,7.875404407888291,52927.5,55554.55,57622.9106864,48963.6,58840.1,0,369.0,3.03234472577609,8087013725.850524
2021-05-16,46426.4,46729.3,49764.3,43920.8,180070.0,63540.9,0.1,47658.333333333336,33.34829399742854,-1090.823243457619,62099.84086775761,46835.34913224238,53211.64937454693,16.058347379687362,3833.1492587808884,66732280.0,-17.98006494263636,-0.006045969924296957,8.25639993361727,8.25639993361727,51722.350000000006,54349.4,56945.402045216,48963.6,58840.1,0,370.0,3.032806128494318,8124205506.818294
2021-05-17,43541.3,46424.2,46545.4,42201.5,274760.0,63540.9,0.1,45558.833333333336,29.539043993899654,-1281.7681649938913,62878.48103471021,44907.18896528979,52290.663719828175,7.734494065487477,3869.631454582254,66457520.0,-23.838635083558103,-0.062143521789326694,8.8872666975544,8.8872666975544,50862.7,53489.75,55903.433881598714,48963.6,58840.1,1,371.0,3.0332506196731592,8160425441.407301
2021-05-18,42897.3,43538.5,45770.9,42293.9,154960.0,63540.9,0.1,44288.333333333336,28.749624738655513,-1364.1751437099606,63460.059265256525,43131.200734743456,51396.05765127311,4.016764420634571,3841.5863506835217,66302560.0,-20.178446824148928,-0.014790555174053144,8.95531035912172,8.95531035912172,50862.7,53489.75,54533.24049343884,48963.6,58840.1,0,372.0,3.033690777066193,8196512857.010154
2021-05-19,36720.5,42898.3,43516.6,30261.7,607100.0,63540.9,0.1,41053.03333333333,22.530329449297085,-1724.213871873928,64920.07356388669,39987.15643611332,49998.385494009,22.072161354922045,4513.965897063271,65695460.0,-36.07299974060476,-0.14399041431512016,12.29276806433265,12.29276806433265,44496.45,47519.85,53300.066444094955,48963.6,58840.1,1,373.0,3.0340907683829945,8230021302.4602585
2021-05-20,40717.2,36706.8,42425.9,35010.4,269750.0,63540.9,0.1,40111.666666666664,32.67845366392055,-1586.2141418693045,64814.16127819124,38392.75872180876,49114.463066008146,35.73039621081121,4721.218332987322,65965210.0,-27.8132944718059,0.10884111055132695,11.595144884685888,11.595144884685888,44496.45,47519.85,50535.46247080356,48963.6,58840.1,0,374.0,3.0345165917375962,8265435357.707009
2021-05-21,37297.4,40611.2,42108.3,33592.3,315500.0,63540.9,0.1,38245.03333333333,29.15874487796708,-1612.9761295897406,64845.1327763584,36310.8172236416,47989.02848829308,24.04364675246564,4992.274166345371,65649710.0,-34.950782389094684,-0.08398907586965698,13.385046052393385,13.385046052393385,42876.625,47519.85,48102.610974307136,48963.6,58840.1,0,375.0,3.0349195425355924,8299429238.131983
2021-05-22,37448.3,37291.0,38776.0,35314.9,185830.0,63540.9,0.1,38487.63333333333,29.519479273660934,-1510.0546313323603,64689.97169528471,34550.428304715286,46985.14958464612,24.559329100341063,4882.904583034987,65835540.0,-36.35581856590998,0.0040458584244478235,13.039055399136906,13.039055399136906,42876.625,47519.85,45961.70165739028,48963.6,58840.1,0,376.0,3.0353230200918553,8333599378.458823
2021-05-23,34679.7,37446.8,38248.7,31192.4,325730.0,63540.9,0.1,36475.13333333333,26.820927486746967,-1514.1193010172883,64473.31650590333,32518.073494096672,45813.20200515602,15.097976228718267,5038.147112818202,65509810.0,-40.45207363539115,-0.07393125989697813,14.527654832130043,14.527654832130043,42672.05,47519.85,44077.70145850345,48963.6,58840.1,0,377.0,3.035706434854103,8366519529.5690365
2021-05-24,38750.6,34720.3,39851.7,34474.6,244880.0,63540.9,0.1,36959.53333333333,36.07453105997861,-1145.0958555577508,64071.79851544969,31420.50148455031,45140.573242760205,30.671537171927383,5062.358033331188,65754690.0,-30.61528517123883,0.1173856751932687,13.063947482958168,13.063947482958168,42452.9,47519.85,42419.78128348303,48963.6,58840.1,0,378.0,3.0361176225682036,8401502682.879873
2021-05-25,38378.3,38753.6,39740.8,36540.7,163010.0,63540.9,0.1,37269.533333333326,35.630782824762605,-842.5175650276287,62968.442985587906,30617.557014412094,44496.54721964018,29.3263672100821,4929.339602378961,65591680.0,-32.30827029210327,-0.009607593172750728,12.844080124390503,12.844080124390503,41648.175,47519.85,40960.81152946507,48963.6,58840.1,0,379.0,3.0365258452789106,8436424982.034912
2021-05-26,39249.2,38375.7,40750.0,37847.0,153800.0,63540.9,0.1,38792.700000000004,37.5655131065928,-516.1890767146133,61797.21196227218,30073.16803772781,43996.79986538873,42.39886779101308,4784.601059351892,65745480.0,-20.52275829111335,0.022692511132593074,12.19031485826945,12.19031485826945,41454.55,47519.85,30261.7,48963.6,58840.1,0,380.0,3.036939273037649,8471857903.562089
2021-05-27,38417.3,39249.0,40322.2,37190.8,122930.0,63540.9,0.1,38681.6,36.438849225384125,-299.5733217672696,60264.22960467129,29714.160395328712,43465.41892582791,38.474348390140364,4666.515269398185,65622550.0,-22.708763374013667,-0.02119533646545646,12.146911077556686,12.146911077556686,40890.975000000006,47519.85,30471.466,48963.6,58840.1,0,381.0,3.0373467413841326,8507019701.710124
2021-05-28,35662.5,38543.2,38844.1,34772.4,199580.0,63540.9,0.1,37776.333333333336,32.91803886400312,-285.11093597681156,58217.2050328426,29443.424967157407,42722.28379003477,26.50153097275653,4624.028464441172,65422970.0,-28.445740151445236,-0.07170727771082308,12.9660805171852,12.9660805171852,40850.975000000006,47519.85,30677.03668,48963.6,58840.1,0,382.0,3.0377347795787495,8540952350.455425
2021-05-29,34584.6,35664.5,37227.1,33664.2,160430.0,63540.9,0.1,36221.46666666667,31.630224297316275,-290.4468418224733,55950.49707444699,29344.762925553,41947.266286221944,22.165762513716107,4548.233574123946,65262540.0,-25.956993114787803,-0.03022502628811785,13.151037092011894,13.151037092011894,40771.575000000004,47519.85,30878.495946400002,34584.6,58840.1,0,383.0,3.038114523979161,8574431077.164659
2021-05-30,35652.8,34589.3,36388.6,33441.0,104180.0,63540.9,0.1,35299.96666666667,34.37039703731928,-170.2911408844475,53795.87876166376,29479.771238336238,41347.793306581756,33.10734046930367,4433.902604543664,65366720.0,-23.205762238726237,0.030886579575880813,12.436337691692275,12.436337691692275,40432.0,47519.85,31075.926027472004,34584.6,58840.1,0,384.0,3.038501518643915,8608558202.530802
2021-05-31,37298.6,35644.0,37480.7,34213.2,131700.0,63540.9,0.1,35845.333333333336,38.46264357241028,59.470718195619156,50790.89700775851,30545.04299224149,40962.155848812065,45.37242410956076,4350.588132790545,65498420.0,-14.337422171593417,0.04616187227931601,11.664212953812061,11.664212953812061,40432.0,47519.85,31269.407506922562,34584.6,58840.1,0,385.0,3.038899494640752,8643607707.03165
2021-06-01,36687.6,37294.3,37850.3,35742.7,113480.0,63540.9,0.1,36546.33333333333,37.52711716385934,201.7278479583747,49458.4119151018,30607.868084898197,40555.055291782344,48.479430248436415,4190.374694734079,65384940.0,-14.475736235147677,-0.016381311899106188,11.421773827489613,11.421773827489613,40994.15,47519.85,31459.019356784112,34584.6,58840.1,0,386.0,3.039292777264108,8678462434.081728
2021-06-02,37555.8,36687.7,38199.9,35981.1,96890.0,63540.9,0.1,37180.666666666664,39.76893698083049,375.6206645706661,47785.11578389345,31066.284216106542,40269.41193066022,56.64663729024793,4049.5479308245017,65481830.0,2.274751160795749,0.023664671442122254,10.782749750569822,10.782749750569822,40994.15,47519.85,31644.83896964843,34584.6,58840.1,0,387.0,3.039691508564169,8713851219.611746
2021-06-03,39187.3,37555.7,39462.3,37193.6,106440.0,63540.9,0.1,37810.23333333333,43.846826384609244,608.0822753412858,45753.52293257023,32032.627067429763,40166.353651549725,73.24086882437545,3922.34450719418,65588270.0,-3.757380173489322,0.043442024933565415,10.009223669898615,10.009223669898615,40994.15,47519.85,31826.94219025546,34584.6,58840.1,0,388.0,3.040100542887492,8750131495.879631
2021-06-04,36851.3,39191.4,39255.4,35659.9,127710.0,63540.9,0.1,37864.8,39.70207431868629,610.4851261585891,44291.77876532321,32508.621234676786,39850.634256164034,59.2083786724701,3898.9984709660243,65460560.0,-1.196061923887452,-0.05961114953058766,10.58035529537906,10.58035529537906,40887.2,47519.85,32005.40334645035,34584.6,58840.1,0,389.0,3.040493467574973,8785389899.964397
2021-06-05,35520.0,36841.2,37887.6,34832.0,101480.0,63540.9,0.1,37186.200000000004,37.52502077621791,531.2918295522418,42576.779814524605,33132.98018547539,39438.19289843413,45.279149577299734,3838.7557230398793,65359080.0,-5.149232408413741,-0.03612626962956533,10.807307778828488,10.807307778828488,40275.875,46995.4,32180.295279521346,34584.6,58840.1,0,390.0,3.040876560278557,8820071665.799047
2021-06-06,35815.4,35518.7,36434.0,35265.3,62200.0,63540.9,0.1,36062.23333333333,38.33305102031666,507.7083641730037,41476.60992521038,33460.56007478963,39093.165003345166,32.48597619373377,3648.037457108459,65421280.0,3.2748264835047722,0.008316441441441391,10.18566721887361,10.18566721887361,40275.875,46890.1,32351.68937393092,34584.6,58840.1,0,391.0,3.041261270240798,8855009041.033592
2021-06-07,33578.0,35815.4,36754.6,33410.1,119500.0,63540.9,0.1,34971.13333333333,34.674954029262,357.4217989122826,40513.87494580041,33491.365054199596,38567.91119350277,2.287497104865208,3626.3562101721404,65301780.0,-13.348438475791339,-0.06247033399040636,10.799798112371613,10.799798112371613,38648.325,46385.4,32519.6555864523,34584.6,58840.1,0,392.0,3.041629128755411,8888843192.724003
2021-06-08,33382.9,33574.6,34047.8,31158.1,193540.0,63540.9,0.1,34258.76666666667,34.36697478263339,265.1186336166502,40685.684388378606,32985.795611621405,38074.10060364536,23.19457041879088,3573.7379094455596,65108240.0,-13.016209680991606,-0.005810352016201059,10.705294954738982,10.705294954738982,38085.325,45311.9,40750.0,34584.6,58840.1,0,393.0,3.0419950365614734,8922662284.951963
2021-06-09,37332.2,33385.5,37517.6,32428.6,209820.0,63540.9,0.1,34764.36666666666,45.01352643785614,477.8786914744769,40093.389138230945,33239.590861769066,38003.44340329819,67.3726825329274,3681.970915913734,65318060.0,-4.884175983204753,0.11830308331511019,9.862721500243046,9.862721500243046,37880.75,44892.8,40558.162,34584.6,58840.1,0,394.0,3.0423888266301478,8958680239.012041
2021-06-10,36649.4,37375.2,38340.8,35824.0,154320.0,63540.9,0.1,35788.166666666664,43.69385747926299,573.9942509733191,40048.74775614599,33219.43224385402,37874.48688869836,66.12677922015365,3598.744421919896,65163740.0,-4.601833028349211,-0.01828984094159991,9.819381550366161,9.819381550366161,37661.6,44892.8,40370.16076,34584.6,58840.1,0,395.0,3.042777445018668,8994458041.843014
2021-06-11,37314.6,36654.3,37641.1,36003.3,109150.0,63540.9,0.1,37098.73333333333,45.37407000852746,676.6787240489884,40036.17897635982,33218.63102364018,37821.16432786995,74.13718359384404,3458.676963211332,65272890.0,4.632597266035748,0.018150365353866604,9.268964328202184,9.268964328202184,36856.875,44892.8,40185.919544799995,34584.6,58840.1,0,396.0,3.0431701344411315,9030683511.166868
2021-06-12,35467.5,37334.4,37437.3,34703.3,87730.0,63540.9,0.1,36477.166666666664,41.656854282009114,616.226170637693,40002.04592038184,33331.54407961816,37597.00582045376,51.894222200814035,3406.9143229819506,65185160.0,2.552870352700339,-0.04950073161711499,9.605735738301123,9.605735738301123,36611.525,44892.8,40005.36315390399,34584.6,58840.1,0,397.0,3.043549469078022,9066051184.526333
2021-06-13,39022.9,35467.5,39321.6,34827.0,123320.0,63540.9,0.1,37268.333333333336,50.126456236819564,800.0619369389879,40051.60485162278,33309.215148377225,37732.80526612484,94.70870162086653,3484.6061570546685,65308480.0,9.45255351613337,0.1002438852470573,8.929644278243464,8.929644278243464,36064.5,44892.8,39828.41789082591,34584.6,58840.1,0,398.0,3.0439525234831573,9103347245.767708
2021-06-14,40529.4,39024.1,40970.4,38769.9,157350.0,63540.9,0.1,38339.93333333333,53.22496434752561,994.7964003550342,40489.999728241746,33085.93027175826,37999.147621731994,95.50564087930454,3392.884288693621,65465830.0,8.66198731319675,0.03860553674893463,8.371415043631588,8.371415043631588,36428.125,44892.8,31158.1,34584.6,40529.4,0,399.0,3.0443646726457443,9141486058.246532
2021-06-15,40156.1,40522.5,41318.0,39589.9,117550.0,63540.9,0.1,39902.799999999996,52.356943350711376,1063.9218669565666,40674.425408785304,32992.194591214706,38204.57165775752,88.56386381755725,3273.9711252155053,65348280.0,9.45414799550802,-0.009210597738925408,8.153110300092651,8.153110300092651,36435.625,44892.8,31354.345999999998,34584.6,40529.4,0,400.0,3.044773973772949,9179568045.37722
2021-06-16,38336.0,40148.1,40494.4,38156.4,123520.0,63540.9,0.1,39673.833333333336,48.22714937199725,955.9380874662832,40663.81304215389,32994.67695784612,38217.088642733,70.64931741454149,3207.116044842969,65224760.0,2.0774420994892853,-0.045325616780514055,8.365807712966845,8.365807712966845,36238.05,44892.8,31752.89216,34584.6,40529.4,0,401.0,3.0451710305910766,9216873103.816465
2021-06-17,38052.0,38337.8,39529.9,37425.3,109580.0,63540.9,0.1,38848.03333333333,47.596286531965895,838.4578889801294,40779.33119749941,33118.108802500596,38201.36591485366,67.85401431116448,3128.3648987827573,65115180.0,-2.897112074575188,-0.007408180300500833,8.221289022345099,8.221289022345099,36555.675,44892.8,32135.4964736,34584.6,40529.4,0,402.0,3.0455657122216517,9254147595.80967
2021-06-18,35749.4,38045.5,38166.0,35198.5,102840.0,63540.9,0.1,37379.13333333333,42.717276067405926,590.4506738611226,40725.81406726425,33288.105932735765,37967.84535153426,45.190405417376176,3116.874548869703,65012340.0,-2.9901251787589618,-0.06051193104173236,8.718676534066875,8.718676534066875,37124.350000000006,44892.8,32502.796614656,34584.6,40529.4,0,403.0,3.045944109868298,9290318471.494295
2021-06-19,35513.4,35770.0,36357.3,34845.5,105460.0,63540.9,0.1,36438.26666666666,42.239357211216706,404.17242899816415,40729.477321818886,33270.50267818111,37734.08865138814,42.86754790893613,3002.226366807582,64906880.0,-0.018581081081076985,-0.006601509395961935,8.453784675101742,8.453784675101742,37124.350000000006,44892.8,32855.404750069756,34584.6,40529.4,0,404.0,3.046320353151194,9326464109.04988
2021-06-20,35595.8,35510.9,36097.9,33378.0,137480.0,63540.9,0.1,35619.53333333333,42.4813260119208,285.7480736469263,40690.64087477152,33139.05912522848,37530.4421131607,43.67857951357793,2982.0601977498977,65044360.0,-0.6131440665188677,0.002320250947529745,8.377561953235768,8.377561953235768,36793.025,44892.8,33193.908560066964,34584.6,40529.4,0,405.0,3.0466967052129146,9362758796.766245
2021-06-21,31692.0,35597.9,35708.4,31284.1,256870.0,63540.9,0.1,34267.06666666667,35.000541438333855,-38.980027082890956,41075.55075025931,32254.589249740686,36974.4000071454,5.254972982017553,3085.077326482048,64787490.0,-5.616772887009351,-0.10967024199484221,9.734561802606487,9.734561802606487,36269.55,44892.8,41318.0,34584.6,40529.4,0,406.0,3.0470432126318303,9396868942.022661
2021-06-22,32496.4,31682.7,33272.5,28901.8,309650.0,63540.9,0.1,33261.4,37.444987099853485,-175.43736686737816,41156.91265088602,31667.287349113976,36547.923815988695,28.95088674473673,3176.9075174476166,65097140.0,-2.6555511953724813,0.025381799823299245,9.776182953950642,9.776182953950642,35109.9,44212.85,41117.322,34584.6,40529.4,1,407.0,3.0473956006475382,9431563096.741085
2021-06-23,33674.3,32498.3,34784.3,31736.5,173340.0,63540.9,0.1,32620.899999999998,40.94712115662242,-162.50116718320487,40844.74886073602,31428.151139263973,36274.2453573231,38.43768624861071,3167.6855519156443,65270480.0,-9.798243875260484,0.03624709198557374,9.406834149234413,9.406834149234413,35109.9,44212.85,40628.70112,34584.6,40529.4,0,408.0,3.0477565268020625,9467055478.724764
2021-06-24,34665.8,33678.1,35249.9,32356.7,119250.0,63540.9,0.1,33612.166666666664,43.79932874599043,-68.13136766238131,40765.38924584286,31288.960754157146,36121.060085197096,46.423221275430514,3148.079441064527,65389730.0,-5.412366914601599,0.02944381917367256,9.081225418321594,9.081225418321594,34904.0,44212.85,40159.6250752,34584.6,40529.4,0,409.0,3.0481243185286035,9503222374.485352
2021-06-25,31594.0,34660.5,35490.9,31337.9,193430.0,63540.9,0.1,33311.36666666667,37.720711070347086,-186.82261444637993,40947.09453198925,30714.65546801075,35689.91150565451,21.682962581143993,3219.8594809884894,65196300.0,-15.33072845481393,-0.08861183068038248,10.191363806382506,10.191363806382506,34662.875,44212.85,39709.312072192,31594.0,40529.4,0,410.0,3.0484682062708037,9537636473.774525
2021-06-26,32243.4,31592.1,32643.0,30206.9,156670.0,63540.9,0.1,32834.399999999994,39.628257495869825,-194.93030896449568,41002.23368577584,30302.31631422416,35361.6723146398,26.91322626890677,3163.876660917883,65352970.0,-9.090293931063647,0.020554535671330143,9.812478401526771,9.812478401526771,34321.9,44212.85,39277.01158930432,31594.0,40529.4,0,411.0,3.048816779275098,9572546963.57293
2021-06-27,34678.5,32247.1,34685.5,32041.7,148800.0,63540.9,0.1,32838.63333333333,46.273478024422595,-18.897868654131116,40993.042249865044,30421.55775013496,35296.608284674105,46.52550699892077,3126.7283279951766,65501770.0,-11.132950139533456,0.07552243249781343,9.016330948556531,9.016330948556531,33869.725000000006,44212.85,38862.003125732146,31594.0,40529.4,0,412.0,3.049183275395969,9609013315.726765
2021-06-28,34475.9,34682.2,35231.2,33944.9,112000.0,63540.9,0.1,33799.26666666666,45.82156698801399,95.0333495920695,40972.49956429821,30551.400435701784,35218.445590895615,44.89376781946169,2995.2691617098067,65389770.0,-14.936071099004671,-0.005842236544256529,8.688008613871737,8.688008613871737,33804.875,44212.85,38463.59500070286,31594.0,40529.4,0,413.0,3.0495478240499416,9645462720.010124
2021-06-29,35834.7,34477.3,36590.3,34247.6,97270.0,63540.9,0.1,34996.36666666667,49.39138469702734,263.4965622840841,40848.017084494684,30526.13291550531,35277.1364870008,59.80453047633832,2948.657078730535,65487040.0,-10.76150323363076,0.039413039253507476,8.228496621237333,8.228496621237333,33927.975000000006,44212.85,38081.123200674745,31594.0,40529.4,0,414.0,3.049921658591095,9682796022.074844
2021-06-30,35026.9,35832.6,36089.5,34126.6,107070.0,63540.9,0.1,35112.5,47.39217109256052,318.4403402602079,40754.82856353287,30457.07143646712,35253.304440619766,57.63118525418467,2878.245858821211,65379970.0,-8.631834307178627,-0.022542396057452563,8.21724405762774,8.21724405762774,33927.975000000006,44212.85,37713.95027264776,31594.0,40529.4,0,415.0,3.050289267990404,9719771912.975601
2021-07-01,33543.6,35030.7,35032.7,32839.2,27410.0,63540.9,0.1,34801.73333333333,43.879934236663004,255.51747030337333,40578.359851811336,30256.440148188667,35090.47544627503,50.10470412987629,2829.335440333982,65352560.0,-11.847997477136554,-0.04234745295758413,8.43479960509302,8.43479960509302,34254.25,43420.15,37361.46426174185,31594.0,40529.4,0,416.0,3.0506454965276575,9755967939.930315
2021-07-02,33813.4,33542.2,33925.9,32734.6,78930.0,63540.9,0.1,34127.96666666667,44.682967795815486,233.3129601348976,40542.5935514225,30126.796448577505,34968.84921329645,63.8824217987904,2712.3329088815553,65431490.0,-5.415475504483991,0.008043263096388031,8.021473465790354,8.021473465790354,34254.25,43420.15,37023.07769127218,31594.0,40529.4,0,417.0,3.05100328429685,9792425287.147364
2021-07-03,34742.8,33814.2,34909.8,33363.3,55690.0,63540.9,0.1,34033.26666666667,47.47137967379072,279.3562897739105,40049.02759756864,30192.352402431363,34947.320716792026,75.97060544969762,2629.0591296757298,65487180.0,-2.169885170104801,0.027486144546245095,7.567205664700973,7.567205664700973,34254.25,40180.5,36698.22658362129,31594.0,40529.4,0,418.0,3.05136744491418,9829538364.427296
2021-07-04,35298.2,34742.8,35957.6,34740.1,56130.0,63540.9,0.1,34618.13333333333,49.12188509314991,341.25786004104907,39121.79702058802,30596.462979411976,34980.73779138326,83.19438121870319,2528.233477556035,65543310.0,-0.836053691727692,0.01598604602968079,7.162499723940696,7.162499723940696,34254.25,40180.5,36386.369520276436,31594.0,35298.2,0,419.0,3.0517351357695723,9867080963.38326
2021-07-05,33687.8,35297.0,35300.5,33164.1,88360.0,63540.9,0.1,34576.26666666667,44.73293240722934,270.8599937191234,38059.174328147405,31012.255671852607,34857.600858870566,62.24881316251546,2500.245372016318,65454950.0,6.29748832512938,-0.04562272297170944,7.421812561272382,7.421812561272382,34712.95,39771.35,36086.98673946538,31594.0,35298.2,0,420.0,3.052090594170337,9903761851.018278
2021-07-06,34225.6,33688.5,35062.0,33581.7,83630.0,63540.9,0.1,34403.86666666667,46.453565039064685,257.70553678680926,37392.32053660182,31268.069463398173,34797.4103008829,62.95547827176733,2427.3921311580098,65538580.0,5.321204810378986,0.015964236311067914,7.092328932606032,7.092328932606032,34886.175,39333.05,35957.6,31594.0,35298.2,0,421.0,3.0524495822257594,9940870050.8058
2021-07-07,33867.8,34228.7,35036.6,33801.3,72030.0,63540.9,0.1,33927.06666666666,45.43997110851119,223.37725547797208,36665.37743064216,31576.592569357843,34708.8759865131,57.350314879217976,2342.2426932181515,65466550.0,0.5746221896223529,-0.010454162965733094,6.915839508967666,6.915839508967666,34886.175,37723.6,35675.368,31594.0,35298.2,0,422.0,3.0528054622871705,9977859908.34057
2021-07-08,32866.3,33859.4,33923.2,32146.9,108090.0,63540.9,0.1,33653.23333333334,42.63573845359674,135.9886243368387,36461.847101029525,31491.81289897048,34533.39255922614,41.66118369520946,2301.8182151311403,65358460.0,-5.1909951594943715,-0.029570860817649813,7.003581830419427,7.003581830419427,34614.05,37336.35,35404.42528,31594.0,35298.2,0,423.0,3.0531533267873248,10014321310.676952
2021-07-09,33797.4,32866.3,34079.2,32367.0,67140.0,63540.9,0.1,33510.5,45.97391679629372,142.9479218293975,36274.324565178475,31507.735434821538,34463.29802977603,56.24745433468056,2259.7026283360588,65425600.0,6.974109008039505,0.028329930658455682,6.686025044340862,6.686025044340862,34581.075,36209.2,35144.3202688,31594.0,35298.2,0,424.0,3.0535077687337977,10051464280.647255
2021-07-10,33510.6,33797.7,34221.0,33056.8,50940.0,63540.9,0.1,33391.43333333333,45.1032667452293,130.6285152993961,36041.61137810385,31531.928621896153,34372.564884083076,32.29345293057198,2181.4524405977686,65374660.0,3.930106626472385,-0.008485859859042488,6.509738532278648,6.509738532278648,34581.075,35663.85,34894.619458048,31594.0,35298.2,0,425.0,3.0538596084913814,10088527069.099909
2021-07-11,34227.7,33510.8,34580.6,33319.8,35720.0,63540.9,0.1,33845.23333333333,47.76683438811878,170.64021812253725,35958.37369071788,31868.736309282114,34358.768228456116,46.82900481613168,2115.691551983642,65410380.0,-1.2999408855631094,0.02139919905940202,6.181226176411626,6.181226176411626,34375.175,35505.05,34654.90667972608,31594.0,35298.2,0,426.0,3.0542163183745124,10126135538.709475
2021-07-12,33113.0,34228.3,34598.0,32662.8,63240.0,63540.9,0.1,33617.1,44.17851337439524,124.06444673270073,35920.23760713171,31968.53239286828,34240.12363526982,21.74235945447176,2102.7992982705246,65347140.0,-3.9531962907422327,-0.03256718973229278,6.350373866066272,6.350373866066272,34134.05,35109.9,28901.8,31594.0,35298.2,0,427.0,3.054564242543592,10163143189.339834
2021-07-13,32728.1,33106.1,33307.7,32259.5,60040.0,63540.9,0.1,33356.26666666666,42.97794992675579,71.95026596774164,35940.67996170596,31853.470038294035,34096.12138429174,14.741541115000185,2027.470776965487,65287100.0,-8.66925075415728,-0.011623833539697426,6.194893003154742,6.194893003154742,33628.8,35109.9,29015.724,31594.0,35298.2,0,428.0,3.054908774503023,10199998821.090298
2021-07-14,32820.7,32727.8,33051.9,31611.2,69560.0,63540.9,0.1,32887.26666666666,43.37662358435663,49.405574236335724,35867.7805673423,31741.8594326577,33974.652681025866,27.827627461807403,1985.5585786108093,65356660.0,-6.298587656915126,0.0028293729241843923,6.049714291927988,6.049714291927988,33041.325,35109.9,29127.36952,31594.0,35298.2,0,429.0,3.0552535666434655,10237010023.459896
2021-07-15,31840.5,32820.5,33157.0,31175.8,76950.0,63540.9,0.1,32463.099999999995,40.174667307426795,-21.99989967214526,35829.448227127876,31804.84177287213,33771.40004473769,13.900623196285935,1985.24725156718,65279710.0,-5.077272564662107,-0.029865298424469833,6.234975115237449,6.234975115237449,32926.125,35109.9,29236.7821296,31594.0,35298.2,0,430.0,3.0555902895395217,10273467416.793354
2021-07-16,31394.0,31842.3,32239.8,31062.2,70480.0,63540.9,0.1,32018.399999999994,38.77070702198956,-86.17754292336542,35947.493710226256,31601.85628977375,33544.98099285791,6.7777913960044005,1927.5581621695242,65209230.0,-7.155151507982047,-0.014023020995273305,6.139893489741747,6.139893489741747,32788.075,35109.9,29344.006487008,31594.0,35298.2,0,431.0,3.055923020691439,10309712911.297691
2021-07-17,31518.6,31384.4,31914.8,31207.8,58060.0,63540.9,0.1,31584.366666666665,39.407071224274425,-105.81793997869067,35956.7412005692,31276.618799430802,33351.99232687145,9.32303795399759,1840.3754363002724,65267290.0,-9.28019618453321,0.003968911256928109,5.839013903854462,5.839013903854462,32788.075,35109.9,29449.08635726784,31594.0,35298.2,0,432.0,3.056256306003717,10346133615.846306
2021-07-18,31785.4,31517.9,32408.2,31220.6,57010.0,63540.9,0.1,31566.0,40.825264073561215,-87.19761959556001,35916.60853332312,31047.70146667688,33202.7930576456,17.063445249274494,1793.7486194216817,65324300.0,-9.951782243853783,0.008464842981604548,5.643309882592893,5.643309882592893,33114.350000000006,35109.9,29552.06463012248,31594.0,35298.2,0,433.0,3.05659126690862,10382827115.500372
2021-07-19,30837.2,31782.9,31887.0,30478.2,77480.0,63540.9,0.1,31380.399999999998,37.46880044720495,-122.91205124352018,35675.44960901398,30789.110390986018,32977.49848072697,7.831929839870851,1766.2522894629903,65246820.0,-8.461817037621934,-0.02983130619718488,5.727667523195978,5.727667523195978,32968.350000000006,35109.9,29652.983337520032,31594.0,35298.2,0,434.0,3.056918182929328,10418954874.46103
2021-07-20,29793.8,30835.4,31040.8,29310.2,97460.0,63540.9,0.1,30805.466666666664,34.14234400421306,-196.6055434713212,35693.80717082693,30247.442829173073,32674.289101610117,8.445096395641219,1763.705697358491,65149360.0,-12.948786872983964,-0.033835756813199724,5.9197071114073765,5.9197071114073765,32452.175,35109.9,34598.0,29793.8,35298.2,0,435.0,3.057236024074274,10454420660.98015
2021-07-21,32131.4,29794.7,32794.6,29519.3,118340.0,63540.9,0.1,30920.8,45.76038047831129,-74.02481528828912,35633.32392822412,30166.70607177588,32622.58537764725,53.353001248156154,1871.6767189757416,65267700.0,-5.12699378170416,0.07845927676227937,5.825070550849765,5.825070550849765,32129.6,35109.9,34492.244,29793.8,35298.2,0,436.0,3.057572388497553,10491619647.602924
2021-07-22,32298.9,32131.7,32585.4,31729.4,64870.00000000001,63540.9,0.1,31408.033333333336,46.48883123573667,26.82891273534301,35536.01528321173,30112.564716788274,32591.758198823703,56.52067022202052,1799.128381906046,65332570.0,-1.7263884282684736,0.0052129692450375575,5.570246608726754,5.570246608726754,32091.925,35109.9,34388.60312,29793.8,35298.2,0,437.0,3.0579096144435547,10529026053.905832
2021-07-23,33603.3,32297.9,33605.6,32041.1,66150.0,63540.9,0.1,32677.86666666667,51.90580673383319,181.27081238035566,35360.711344778356,30173.918655221638,32688.095513221444,81.18877415938582,1782.3692117698997,65398720.0,-0.574304532301297,0.04038527627875865,5.304149329886944,5.304149329886944,32204.075,35109.9,34287.0350576,29793.8,35298.2,0,438.0,3.058256326060027,10567397555.447184
2021-07-24,33824.8,33600.5,33955.0,33412.9,67140.0,63540.9,0.1,33242.333333333336,52.77995767658214,291.68333924284286,35069.89722859649,30317.39277140351,32796.35308339083,85.37766178751093,1693.7785537863354,65465860.0,0.9376137699713059,0.00659161451405077,5.007505007528012,5.007505007528012,32291.425,35109.9,34187.498356448,29793.8,35298.2,0,439.0,3.058604234700892,10606014097.842764
2021-07-25,35391.1,34392.5,35391.1,33881.3,65099.99999999999,63540.9,0.1,34273.066666666666,58.52119991404255,453.8682901001458,35400.860000974375,30156.759999025617,33043.47183735361,100.0,1684.6729428015967,65530960.0,3.3990013936081054,0.04630626049525777,4.760159878618062,4.760159878618062,32525.25,35109.9,29310.2,29793.8,35298.2,0,440.0,3.058963038825205,10645734325.84061
2021-07-26,37276.6,35392.3,40522.9,35236.7,177630.0,63540.9,0.1,35497.5,64.16894815273116,659.3373308463497,36157.72682874246,29704.99317125754,33446.62690046279,71.04800806228648,1941.9248754586258,65708590.0,12.57391356868903,0.05327610613967915,5.209501068924274,5.209501068924274,34916.55,35109.9,29431.818,29793.8,35298.2,1,441.0,3.0593343913749123,10686716285.099392
2021-07-27,39452.0,37294.3,39455.9,36427.4,100240.0,63540.9,0.1,37373.23333333333,69.35366414752062,898.1629515388522,37503.11880512843,28918.021194871566,34018.56719565681,90.44922275633878,2019.5373843544382,65808830.0,20.5447306748635,0.05835832667142404,5.118973396417008,5.118973396417008,34916.55,35109.9,29875.46128,29793.8,35298.2,0,442.0,3.059719485813168,10729079779.012495
2021-07-28,40003.2,39450.4,40862.2,38883.8,148920.0,63540.9,0.1,38910.6,70.51773915951352,1039.6764520211407,38775.18630115267,28359.643698847332,34588.53222464188,92.56405817174515,2016.5989997576924,65957750.0,21.884054879999514,0.013971408293622645,5.041094211857282,5.041094211857282,35086.2,35109.9,30301.3588288,29793.8,35298.2,0,443.0,3.0601075770942843,10771879210.752241
2021-07-29,40001.4,40009.0,40630.7,39340.8,75300.0,63540.9,0.1,39818.86666666666,70.50832046395473,1075.1174282392055,39794.08689979883,27961.143100201163,35104.043441342656,92.54847645429366,1964.6919283464283,65882450.0,25.63056484665756,-4.499640028787777e-05,4.911557916338999,4.911557916338999,35138.475,35109.9,30935.009299072,29793.8,35298.2,0,444.0,3.060495176603712,10814805267.640625
2021-07-30,42203.4,40001.1,42264.4,38358.4,98450.0,63540.9,0.1,40736.0,74.92125661436576,1180.407284106474,41246.64691233874,27377.86308766125,35780.17263740526,99.52911024995754,2103.3567906073977,65980900.0,34.43142001656368,0.05504807331743389,4.983856254726865,4.983856254726865,36392.100000000006,35583.1,31530.64074112768,29793.8,35298.2,0,445.0,3.0608957113722908,10859068472.186275
2021-07-31,41553.7,42201.4,42285.3,41066.4,44650.0,63540.9,0.1,41252.833333333336,71.52077384910257,1139.2783774312327,42296.64949021926,27060.460509780758,36330.03238622381,94.36150781111509,2040.1813055640123,65936250.0,31.83866034658899,-0.015394494282451321,4.909746437896054,4.909746437896054,36480.475,35593.55,32389.341481837466,29793.8,35298.2,0,446.0,3.061291873627489,10903117153.771542
2021-08-01,39878.3,41510.0,42565.0,39556.5,80330.0,63540.9,0.1,41211.799999999996,63.51501903170431,940.4786485951093,42922.19462378658,27111.44537621342,36667.96263515487,79.7303618311857,2109.3469265951544,65855920.0,25.461060738578094,-0.04031891263593845,5.289460500059316,5.289460500059316,36963.274999999994,35733.4,33378.93733365372,29793.8,35298.2,0,447.0,3.061677252017105,10946364526.492222
2021-08-02,39168.4,39869.8,40449.0,38692.5,74810.0,63540.9,0.1,40200.13333333333,60.42845751139643,712.747726643066,43368.75708885669,27308.912911143307,36906.099527044884,74.3745661948879,2084.1435746955003,65781110.0,27.016720065375587,-0.017801661555281956,5.320982155756937,5.320982155756937,37080.375,35733.4,34481.26485361527,29793.8,35298.2,0,448.0,3.0620576591057382,10989329885.956663
2021-08-03,38130.3,39167.4,39766.6,37688.2,260.0,63540.9,0.1,39059.0,56.1326873428422,456.25187106453313,43634.75613514996,27573.873864850048,37022.6900482787,66.00642357251817,2083.7333193601075,65780850.0,27.980653693050243,-0.02650350792986178,5.464770325332104,5.464770325332104,37419.225,35733.4,35451.31307118144,29793.8,35298.2,0,449.0,3.0624308742352255,11031805129.502035
2021-08-04,39736.9,38188.4,39956.5,37556.0,79220.0,63540.9,0.1,39011.86666666667,60.77960280396415,362.911334141171,44027.01420817873,27971.255791821266,37281.18623415692,73.89992247775851,2106.3595108343857,65860070.0,23.66999259291534,0.042134470486725695,5.300764555952743,5.300764555952743,37716.899999999994,35733.4,36304.95550263966,29793.8,35298.2,0,450.0,3.0628139400648857,11075350332.099401
2021-08-05,40867.2,39734.4,41366.3,37365.4,130600.0,63540.9,0.1,39578.13333333333,63.693528252359414,345.502953674265,44475.768640710565,28469.82135928943,37622.71135471341,83.86719752183124,2241.6838314890724,65990670.0,26.52814801742473,0.028444594319134042,5.485288523532497,5.485288523532497,37951.399999999994,35733.4,37056.160842322905,29793.8,35298.2,0,451.0,3.063203541294879,11119670831.919203
2021-08-06,42795.4,40868.4,43253.4,39905.4,111930.0,63540.9,0.1,41133.166666666664,68.0539336835685,426.7325967346253,45152.186865961296,28921.083134038705,38115.34836855023,95.34576495096793,2320.706414954139,66102600.0,27.354753848580344,0.047182092240231954,5.422794073554959,5.422794073554959,38295.600000000006,36077.6,37556.0,29793.8,35298.2,0,452.0,3.0636041836574806,11165192325.6373
2021-08-07,44614.2,42784.7,44697.3,42611.0,112840.0,63540.9,0.1,42758.93333333333,71.52757401500045,557.5741875622241,46055.73609695943,29300.41390304056,38734.28661916449,99.2316937869822,2303.963099600272,66215440.0,31.897897400723707,0.04249989484851158,5.164192341452434,5.164192341452434,39017.55,36799.55,37365.4,29793.8,35298.2,0,453.0,3.064014736541472,11211822926.191511
2021-08-08,43792.8,44584.9,45284.1,43314.4,105250.0,63540.9,0.1,43734.13333333333,67.93492338437434,542.8904333400114,46488.280372026835,30163.42962797317,39216.049798291686,85.15735414136995,2280.087163914538,66110190.0,23.739584245756713,-0.018411178503704995,5.206534325082064,5.206534325082064,39310.95,37092.95,38538.504,29793.8,35298.2,0,454.0,3.0644201518515235,11258168139.34233
2021-08-09,46284.3,43794.9,46460.7,42824.1,117080.0,63540.9,0.1,44897.1,72.45436835334725,647.9481401435955,47025.276755539526,31275.48324446047,39889.21648416867,98.24185462410179,2376.980937920642,66227270.0,24.164489250629092,0.05689291390365536,5.1356095650590845,5.1356095650590845,39899.25,37681.25,39752.71128,29793.8,35298.2,0,455.0,3.0648388934027473,11305956169.211668
2021-08-10,45593.8,46281.8,46663.4,44681.2,80550.0,63540.9,0.1,45223.63333333333,69.52948010591419,618.0055652046667,47481.956305549225,32165.043694450775,40432.51015234308,88.4964508496451,2348.7822994977396,66146720.0,15.567778566359127,-0.014918665724662605,5.151538804613214,5.151538804613214,40000.600000000006,37782.6,41094.309024,29793.8,35298.2,0,456.0,3.065253380601432,11353546138.384743
2021-08-11,45564.3,45593.2,46736.5,45367.9,75430.0,63540.9,0.1,45814.13333333334,69.40058072730602,545.7919844063654,47708.93591531975,33264.60408468024,40921.25204259612,87.49132972649959,2278.7692781050437,66071290.0,13.901637868970498,-0.0006470177962792922,5.001216474531692,5.001216474531692,40037.149999999994,37819.15,42208.1272192,29793.8,35298.2,0,457.0,3.0656672079094864,11401274144.735722
2021-08-12,44403.4,45562.3,46213.8,43814.7,81070.0,63540.9,0.1,45187.166666666664,64.34518265698574,377.42203611546984,47703.96192051572,34349.58807948428,41252.885181396494,75.10324294906682,2287.3643296689693,65990220.0,11.004614838480652,-0.0254782801447625,5.151326992232507,5.151326992232507,40037.149999999994,37819.15,43113.80177536,44403.4,35298.2,0,458.0,3.0660740973176073,11448543311.691315
2021-08-13,47809.1,44404.0,47836.0,44242.4,75270.0,63540.9,0.1,45925.6,71.01559778911661,448.1788928709725,48164.585841300024,35287.394158699986,41877.286592692064,99.74309017630317,2380.666877549757,66065490.0,13.282579128695785,0.07669908160185934,4.979526654025608,4.979526654025608,40586.899999999994,38573.1,43814.7,44403.4,47809.1,0,459.0,3.066498930592225,11497721968.069279
2021-08-14,47081.5,47809.6,48090.9,46117.2,64290.00000000001,63540.9,0.1,46431.333333333336,68.08499446438648,400.30756681056846,48458.59857252444,36162.42142747555,42372.92596481663,90.58878373968578,2351.5978148676318,66001200.0,13.302786514798932,-0.015218860007822799,4.994738516970852,4.994738516970852,41349.350000000006,38700.55,43814.7,44403.4,47809.1,0,460.0,3.0669194332759977,11546696823.893805
2021-08-15,46991.3,47082.6,47344.1,45564.1,58110.0,63540.9,0.1,47293.96666666667,67.71194441100272,320.35688498537183,48810.32416159286,36782.16583840715,42812.77111102457,89.74779730548694,2310.769399519944,65943090.0,17.836768367758904,-0.0019158268109553678,4.917440886972575,4.917440886972575,42078.024999999994,38700.55,44242.4,44403.4,47809.1,0,461.0,3.0673389555421737,11595786101.435217
2021-08-16,45996.3,46991.6,48002.4,45672.1,2410.0,63540.9,0.1,46689.69999999999,63.5738943314659,166.0182509360916,49086.02195050461,37160.8980494954,43115.964338546044,80.47084052025548,2312.1644424113765,65940680.0,17.43216470420033,-0.021174132232987808,5.026848773513035,5.026848773513035,42683.825,38700.55,45012.1,44403.4,47809.1,0,462.0,3.067752641261053,11644519789.606241
2021-08-17,44691.6,45907.5,47140.6,44441.3,84140.0,63540.9,0.1,45893.06666666666,58.52341730743092,-46.99734386402815,49178.27020911873,37537.48979088126,43266.02487773214,68.30637266327908,2339.816982239135,65856540.0,17.20757507808749,-0.028365325037013944,5.235473740566762,5.235473740566762,42761.75,38700.55,48090.9,44403.4,47809.1,0,463.0,3.0681586584772305,11692713685.577639
2021-08-18,44723.8,44691.1,46004.9,44230.0,22360.0,63540.9,0.1,45137.23333333334,58.61080905295151,-200.19894021905338,49230.83310556603,37957.16689443398,43404.86060366241,68.60659176728359,2299.465769222054,65878900.0,12.549796285065018,0.0007204933365554389,5.141481200662855,5.141481200662855,43352.350000000006,38700.55,48017.908,44403.4,47809.1,0,464.0,3.068564364126862,11741076815.837679
2021-08-19,46755.9,44725.9,47012.3,43986.7,77920.0,63540.9,0.1,45390.43333333333,63.79530174308903,-179.7939605540496,49581.78155581556,38061.46844418444,43724.00721283742,83.69067253069453,2351.332499991908,65956820.0,14.409355179704027,0.04543665788685214,5.0289535652012,5.0289535652012,43469.450000000004,38700.55,47866.39168,44403.4,47809.1,0,465.0,3.068980647968189,11790676142.971394
2021-08-20,49324.0,46756.7,49343.3,46646.8,83190.0,63540.9,0.1,46934.56666666667,69.06847665103588,-17.029350498689382,50342.19979207679,38078.08020792321,44257.339859233856,99.71332234154742,2375.9873214210575,66040010.0,15.255377914448745,0.05492568852273183,4.817101859989169,4.817101859989169,44434.5,39326.75,43986.7,44403.4,47809.1,0,466.0,3.069409749784036,11841746041.97924
2021-08-21,48875.8,49330.0,49719.1,48293.5,18200.0,63540.9,0.1,48318.56666666667,67.22811661424859,33.976722067374794,50775.02246697047,38545.00753302953,44697.19320597349,87.76939811457585,2308.102512748125,66021810.0,9.552115694106375,-0.009086854269726663,4.722383086820317,4.722383086820317,44963.075,39514.65,43986.7,44403.4,47809.1,0,467.0,3.069836071045227,11892762729.647732
2021-08-22,49254.5,48870.4,49480.3,48151.0,49320.0,63540.9,0.1,49151.43333333333,68.00387841600757,64.95427223880506,51043.632341626726,39285.00765837327,45131.22242445221,93.26178390137783,2238.1880475518306,66071130.0,12.471684843170559,0.00774821077097454,4.544129059379002,4.544129059379002,45197.575,39514.65,44215.996,44403.4,47809.1,0,468.0,3.0702638079897557,11944139959.350296
2021-08-23,49539.7,49255.4,50498.8,49038.6,75370.0,63540.9,0.1,49223.333333333336,68.60658297839248,75.63944273000106,50949.94791550017,40519.63208449982,45551.07743164724,85.65102257596378,2182.6174727267003,66146500.0,7.033486517026279,0.0057903338781226665,4.405794691382265,4.405794691382265,45587.425,39904.5,44436.12016,44403.4,47809.1,0,469.0,3.0706924752792677,11995832147.012922
2021-08-24,47714.7,49532.5,49847.4,47623.6,74260.0,63540.9,0.1,48836.29999999999,60.72404832306586,-61.794823305509,50622.60982640674,41644.750173593275,45757.136723871314,58.347421492796286,2185.5590818176506,66072240.0,4.651728963148486,-0.03683914113327291,4.5804732751492745,4.5804732751492745,45587.425,39904.5,44799.8809504,44403.4,47809.1,0,470.0,3.0711112970973033,12046762933.093348
2021-08-25,48994.5,47707.4,49230.2,47163.3,63540.0,63540.9,0.1,48749.633333333324,63.8598857617731,-86.58102575747944,50487.152400350766,42592.93759964923,46065.45703588357,77.49435226881702,2177.083433116389,66135780.0,7.528262257951942,0.026821922803664355,4.443526177665634,4.443526177665634,45587.425,39904.5,45141.816093376,44403.4,47809.1,0,471.0,3.0715362029612217,12098521730.506039
2021-08-26,46831.6,48994.4,49347.8,46360.4,73790.0,63540.9,0.1,47846.93333333333,55.75756159692063,-258.97000617497406,50295.62417566458,43188.08582433541,46138.42303246608,43.68636845257288,2234.96318789379,66061990.0,5.468500159897658,-0.044145771464144,4.772340018051465,4.772340018051465,45587.425,39904.5,45463.23512777344,44403.4,47809.1,0,472.0,3.0719493774404047,12149318940.14128
2021-08-27,49064.3,46830.2,49142.0,46371.5,62470.0,63540.9,0.1,48296.799999999996,61.226412443915365,-233.72946496225677,50514.6569523131,43414.063047686905,46417.07798175503,77.97177561769631,2273.2158173299476,66124460.0,2.625441600030129,0.047675074095269165,4.633136144467459,4.633136144467459,45587.425,39904.5,45765.369020107035,44403.4,47809.1,0,473.0,3.072373635467848,12201453214.403532
2021-08-28,48897.1,49062.8,49289.4,48428.5,36730.0,63540.9,0.1,48264.333333333336,60.622076512452644,-238.56501385693582,50548.14945154882,43891.00054845117,46653.27055492122,75.4042474777721,2172.3361160920945,66087730.0,3.8562917494132485,-0.003407773065141173,4.442668616527554,4.442668616527554,46180.850000000006,39904.5,46049.37487890061,44403.4,47809.1,0,474.0,3.072796541906589,12253673867.16606
2021-08-29,48777.4,48899.7,49621.7,47870.1,47620.0,63540.9,0.1,48912.93333333333,60.16422935459254,-258.42310894215143,50709.89015580949,43978.56984419052,46855.56859730968,73.56613074123555,2142.2835363712306,66040110.0,3.8009163398331145,-0.0024479979385280126,4.391959260582218,4.391959260582218,46180.850000000006,39904.5,46316.34038616658,44403.4,47809.1,0,475.0,3.0732183373064905,12306004679.851433
2021-08-30,46992.7,48777.1,48886.0,46876.9,61680.0,63540.9,0.1,48222.399999999994,53.65732412319358,-392.32346250371165,50688.31804872337,44140.03195127664,46868.62873089923,46.160224812272496,2132.7704266304286,65978430.0,2.1662611992703633,-0.036588666062561837,4.538514336546801,4.538514336546801,46180.850000000006,39904.5,46567.28796299658,44403.4,47809.1,0,476.0,3.0736303716967344,12357556899.172302
2021-08-31,47130.4,46989.1,48217.0,46709.3,71480.0,63540.9,0.1,47633.5,54.070072414528006,-467.10675506601456,50659.0529359046,44325.907064095394,46893.55932795645,48.274750080619185,2088.1225390139693,66049910.0,5.45695387947624,0.0029302423567916236,4.4305215720935305,4.4305215720935305,46815.850000000006,39904.5,50498.8,44403.4,47809.1,0,477.0,3.0740426391439306,12409349318.79422
2021-09-01,48819.4,47129.2,49121.0,46533.1,74380.0,63540.9,0.1,47647.5,58.904836452854525,-400.85138265101637,50590.054910625346,44836.50508937467,47076.972725293934,74.21108398212559,2123.8209290844,66124290.0,9.157540280566495,0.03583674231493905,4.350362620360759,4.350362620360759,47329.4,39904.5,50423.01,44403.4,47809.1,0,478.0,3.0744631554990534,12462213244.674065
2021-09-02,49274.3,48817.8,50355.3,48612.9,80210.0,63540.9,0.1,48408.03333333333,60.12236699722961,-327.51268103744906,50742.8698479032,44830.210152096784,47286.24198955166,70.41127005606032,2096.5765770069434,66204500.0,5.386272106835718,0.009318017017824864,4.254908901814827,4.254908901814827,47509.65,39904.5,46533.1,44403.4,47809.1,0,479.0,3.074885474600051,12515490126.273481
2021-09-03,49999.0,49269.5,51008.8,48377.3,88080.0,63540.9,0.1,49364.23333333334,62.05128275201766,-235.61434848706676,51020.188903170914,44844.64109682909,47544.599895308646,78.27639617933048,2134.785392935019,66292580.0,1.3685021490552265,0.014707464134447346,4.269656178993618,4.269656178993618,47800.525,40159.5,46533.1,44403.4,47809.1,0,480.0,3.075310916354722,12569321219.756868
2021-09-04,49918.4,49999.3,50534.6,49461.4,48140.0,63540.9,0.1,49730.56666666667,61.693855825930136,-187.75601318464965,51250.57647713623,44906.96352286378,47770.676095755436,76.54246622493758,2058.957864868232,66244440.0,2.1331620147393973,-0.0016120322406447674,4.1246471538916145,4.1246471538916145,48050.95,40159.5,46712.128,44403.4,47809.1,0,481.0,3.0757354548029716,12623289378.430294
2021-09-05,51768.6,49918.7,51878.2,49492.4,57300.0,63540.9,0.1,50562.0,66.46866158757467,-46.36282874710923,51770.73550811743,44964.03449188256,48151.43075330254,98.01370111276236,2082.3037316633577,66301740.0,5.1043051903886925,0.03706448924645023,4.0223296200078,4.0223296200078,48526.049999999996,40594.2,46883.99488,44403.4,47809.1,0,482.0,3.0761685188169356,12678387843.981691
2021-09-06,52672.1,51769.4,52726.2,51002.8,69460.0,63540.9,0.1,51453.033333333326,68.53146552541071,85.93361061656469,52223.250472397165,45309.56952760283,48581.97068155945,99.1501460931855,2056.6677508302605,66371200.0,6.323009626622691,0.017452664356385927,3.904662526898036,3.904662526898036,48950.049999999996,41018.2,47183.6471872,44403.4,52672.1,0,483.0,3.076605365284691,12734127459.652935
2021-09-07,46779.6,52674.2,52885.3,43072.4,187560.0,63540.9,0.1,50406.76666666666,47.85452792685175,-228.30751494578453,51939.77430914854,45798.625690851455,48410.31633093474,37.77884213637147,2610.684340056671,66183640.0,-1.9597734031650593,-0.11187137023205829,5.580818006260573,5.580818006260573,47978.850000000006,41097.75,52726.2,44403.4,52672.1,1,484.0,3.0770122862993166,12786931708.741533
2021-09-08,46061.4,46774.1,47316.9,44493.7,100480.0,63540.9,0.1,48504.36666666666,46.031546448085514,-475.224599372576,52013.64848936843,45655.301510631565,48186.61001370286,30.459904819166603,2625.8640300526235,66083160.0,-5.986590331567826,-0.015352846112407947,5.700790748984233,5.700790748984233,47978.850000000006,41097.75,52726.2,44403.4,52672.1,0,485.0,3.07741488354726,12839493673.138803
2021-09-09,46385.6,46057.6,47305.7,45609.0,73630.0,63540.9,0.1,46408.86666666666,47.01280275504267,-599.3938117686796,52030.05001688531,45345.059983114705,48015.085250493066,33.76371918596946,2559.4951707631503,66156790.0,-0.952348414318537,0.007038431311249704,5.517865826383943,5.517865826383943,47978.850000000006,41097.75,52885.3,44403.4,52672.1,0,486.0,3.0778187335056777,12892406094.829687
2021-09-10,44842.8,46385.9,47021.6,44283.6,75620.0,63540.9,0.1,45763.26666666666,43.005536827442825,-757.8993193093588,52222.074564393886,44749.73543560611,47712.962845684204,18.04155754160341,2572.2455157086397,66081170.0,-8.604015546945538,-0.03326032216894892,5.736139392965291,5.736139392965291,47978.850000000006,41202.3,52689.042,44403.4,52672.1,0,487.0,3.078213716941017,12944582689.52383
2021-09-11,45161.9,44844.9,45975.6,44766.6,41580.0,63540.9,0.1,45463.43333333333,44.06747277083372,-809.0675167007748,52266.63865461212,44295.91134538788,47470.004479428564,21.29339950473356,2474.8708360151654,66122750.0,-7.638898830400979,0.0071159695647906585,5.479997156929104,5.479997156929104,47978.850000000006,42307.350000000006,52496.70916,44403.4,52672.1,0,488.0,3.078609977214986,12997108501.177032
2021-09-12,46062.3,45162.6,46386.4,44755.2,44520.0,63540.9,0.1,45355.666666666664,47.06460025173704,-751.3352095958974,52160.828696815246,44053.981303184766,47335.93738614966,30.46907641981474,2414.608633442654,66167270.0,-5.566307347255078,0.019937159419776362,5.242049644595806,5.242049644595806,47978.850000000006,42463.2,52308.222976799996,44403.4,52672.1,0,489.0,3.0790106456252824,13050325763.984005
2021-09-13,44949.5,46060.8,46807.7,43463.2,96150.0,63540.9,0.1,45391.23333333334,43.93144055408683,-755.1378748382205,52249.029310341044,43689.260689658964,47108.65763508779,19.128901751775707,2481.0294453396077,66071120.0,-4.347909356134032,-0.024158585220451445,5.519592977318118,5.519592977318118,47978.850000000006,43149.100000000006,52123.506517263995,44403.4,52672.1,0,490.0,3.0794047763953296,13103048949.43822
2021-09-14,47077.5,44950.2,47247.6,44718.7,65330.0,63540.9,0.1,46029.76666666666,50.69148115550049,-588.768729755912,52142.884723369614,43603.70527663038,47105.690241269906,40.81464195090135,2484.448770672493,66136450.0,-0.11224178025223944,0.04734201715258224,5.277359185752203,5.277359185752203,47978.850000000006,43383.3,51942.48438691872,44403.4,52672.1,0,491.0,3.0798098771978646,13157185058.67882
2021-09-15,48130.6,47070.8,48436.5,46743.9,63400.0,63540.9,0.1,46719.19999999999,53.668547380105046,-391.7162200419543,52181.91533049263,43694.574669507376,47203.3006944823,51.546433775947946,2427.8881441958865,66199850.0,-1.410914513492593,0.022369497105836134,5.04437539568567,5.04437539568567,47978.850000000006,44061.0,51765.08269918034,44403.4,52672.1,0,492.0,3.0802199657974842,13212092845.229279
2021-09-16,47748.0,48132.3,48480.6,47040.3,60910.0,63540.9,0.1,47652.033333333326,52.43001725258599,-276.4920094269786,52084.91739777385,43659.942602226154,47255.17681881732,47.64748443375555,2357.3461338961797,66138940.0,-3.0975579561759434,-0.007949204871744775,4.937057329932521,4.937057329932521,46975.375,44656.350000000006,51591.229045196735,44403.4,52672.1,0,493.0,3.0806275901253133,13266958182.07343
2021-09-17,47282.8,47748.2,48155.9,46788.8,50160.0,63540.9,0.1,47720.46666666667,50.892156503559924,-223.2375927423319,51984.39116411087,43599.03883588912,47257.807597977575,42.90678596541288,2286.6142671893094,66088780.0,-5.4325086501729976,-0.009742816453045089,4.836038193992972,4.836038193992972,46975.375,45125.350000000006,51420.8524642928,44403.4,52672.1,0,494.0,3.0810323050743436,13321729320.199308
2021-09-18,48306.7,47283.9,48761.0,47070.5,43640.0,63540.9,0.1,47779.166666666664,54.084426014180735,-116.07664003911572,51943.709278834416,43592.650721165584,47357.702112455896,53.34101030276467,2244.0346766757875,66132420.0,-3.2286691881150125,0.02165480893686489,4.645390135686743,4.645390135686743,47045.475000000006,45125.350000000006,51253.883415006945,44403.4,52672.1,0,495.0,3.0814418315682994,13377261881.364553
2021-09-19,47238.7,48299.9,48341.9,46866.6,41980.0,63540.9,0.1,47609.399999999994,50.40388949949149,-113.9812779160107,51948.24145747372,43612.71854252627,47346.368577936286,42.45737753365462,2189.125056913231,66090440.0,-8.750284921747935,-0.022108734399162056,4.634177182931011,4.634177182931011,47045.475000000006,45125.350000000006,51090.2537467068,44403.4,52672.1,0,496.0,3.081845342402862,13432354291.689915
2021-09-20,42870.6,47240.8,47323.9,42547.1,77960.0,63540.9,0.1,46138.666666666664,38.77997445248626,-388.1937208309577,52249.972261322895,42885.0077386771,46920.10490384712,3.1291714224913414,2373.958981419429,66012480.0,-18.60852329791294,-0.09246867504821255,5.537498848673518,5.537498848673518,46685.125,45125.350000000006,50929.896671772665,44403.4,52672.1,0,497.0,3.082224389634794,13484930586.418184
2021-09-21,40651.3,43012.3,43619.3,39646.8,142550.0,63540.9,0.1,43586.86666666666,34.43491683978651,-683.1997055751712,52682.82853542086,41635.34146457914,46323.07586538549,11.02126352285445,2488.1404827466126,65869930.0,-13.100368536712576,-0.05176741169939292,6.120691054767283,6.120691054767283,45234.975000000006,45125.350000000006,50594.58480490176,40651.3,52672.1,0,498.0,3.082589837074249,13536181925.552254
2021-09-22,43551.6,40660.8,43976.7,40585.7,93980.0,63540.9,0.1,42357.833333333336,43.365515368608,-647.4959162985384,52520.269045175664,41225.63095482433,46059.12578296782,42.84303614140568,2552.6304482647115,65963910.0,-5.448813974390711,0.07134581181905619,5.861163420551051,5.861163420551051,45234.975000000006,45125.350000000006,49937.71771660765,40651.3,52672.1,0,499.0,3.08297185165888,13589499893.942787
2021-09-23,44869.2,43550.7,44949.8,43090.1,74540.0,63540.9,0.1,43024.033333333326,46.903830333563086,-505.9097415662652,52137.114762761754,41095.80523723826,45945.79951792327,57.299598428825306,2503.1354162458038,66038450.0,-3.2691180021385975,0.030253767944231624,5.578738680978943,5.578738680978943,45234.975000000006,45125.350000000006,49320.26265361119,40651.3,52672.1,0,500.0,3.08336075856731,13643809838.92917
2021-09-24,42819.9,44867.4,45112.0,40908.5,128880.0,63540.9,0.1,43746.9,42.46051226138239,-519.0953418242423,51800.122726226255,40722.94727377374,45648.09480193057,34.81490421540014,2624.5900293711034,65909570.0,-4.511092081671977,-0.04567275547591654,6.129369824243175,6.129369824243175,45234.975000000006,45125.350000000006,48739.85489439452,40651.3,52672.1,0,501.0,3.083737650337159,13696968340.185282
2021-09-25,42686.8,42818.7,42959.3,41714.5,46350.0,63540.9,0.1,43458.63333333333,42.181017710281346,-505.12715057124126,50939.82808877117,40675.061911228826,45366.06672555624,33.354545654034375,2526.033598701739,65863220.0,-5.480504584616676,-0.003108367838318138,5.917598879985706,5.917598879985706,45234.975000000006,45125.350000000006,48194.27160073085,40651.3,52672.1,0,502.0,3.08411330950166,13750193011.356676
2021-09-26,43203.4,42685.8,43907.3,40786.6,69910.0,63540.9,0.1,42903.36666666667,43.72923518091935,-432.2581013871343,49502.499629542646,41165.52037045736,45160.09846597945,39.02262403721665,2568.5097702230437,65933130.0,-6.206594112755988,0.01210210182070326,5.945156562268348,5.945156562268348,45234.975000000006,46266.05,47681.423304687,40651.3,52672.1,0,503.0,3.0844914740937734,13803912101.615835
2021-09-27,42172.6,43200.9,44293.2,42143.9,54120.0,63540.9,0.1,42687.6,41.3499774494375,-424.0573008612578,49433.21169152704,40774.108308472954,44875.57480255284,27.712799806894697,2538.566215207112,65879010.0,-6.177821777772837,-0.02385923330108286,6.019468126715241,6.019468126715241,45130.200000000004,46266.05,47199.34590640578,40651.3,52672.1,0,504.0,3.08486321614085,13857100915.074722
2021-09-28,41022.3,42169.9,42758.8,40906.4,60010.0,63540.9,0.1,42132.76666666667,38.812168585145066,-463.47890373650773,49503.49382473236,40199.916175267645,44508.596249928756,15.091834719448777,2489.554342692318,65819000.0,-12.862195316233862,-0.02727600385084139,6.0687829368229425,6.0687829368229425,44875.700000000004,46266.05,46746.193152021435,40651.3,52672.1,0,505.0,3.0852276771150304,13909652335.64573
2021-09-29,41536.8,41023.1,42571.2,40815.0,48210.0,63540.9,0.1,41577.23333333333,40.56910029240754,-423.3827520030809,49418.75384114569,39799.77615885431,44225.56803564983,20.73687213359374,2437.171889642867,65867210.0,-13.699808437875271,0.012541958885776694,5.8675003602657565,5.8675003602657565,44322.725000000006,46266.05,46320.229562900146,40651.3,52672.1,0,506.0,3.085594757130345,13962707097.730644
2021-09-30,43823.3,41534.5,44101.2,41416.7,64319.99999999999,63540.9,0.1,42127.46666666667,47.749531387069965,-221.49844350720957,49378.396802510186,39738.183197489816,44187.256794159366,45.824098659235055,2454.838183239805,65931530.0,-8.21961129261958,0.05504757227326129,5.60167350071721,5.60167350071721,44557.45,46266.05,45919.82378912614,40651.3,52672.1,0,507.0,3.085974591416599,14017451015.380547
2021-10-01,48146.0,43824.4,48435.2,43292.9,94660.0,63540.9,0.1,44502.03333333333,58.064894641239086,201.65880506335066,49771.667653248005,39643.322346752,44564.27995662038,93.25228763906871,2646.7997415798186,66026190.0,1.8256110044244358,0.09863930831315759,5.497444733892366,5.497444733892366,45438.475,46266.05,39646.8,40651.3,52672.1,0,508.0,3.086377146163517,14075069136.47061
2021-10-02,47666.9,48147.2,48306.9,47451.7,39820.0,63540.9,0.1,46545.399999999994,56.72814920762854,434.42376417147443,49984.32134025049,39591.128659749505,44859.767579799394,91.25779436529976,2518.8283314669748,65986370.0,-1.3244539577325622,-0.00995098242844683,5.284229373982732,5.284229373982732,45438.475,46266.05,39822.568,40651.3,52672.1,0,509.0,3.0867767545226017,14132577924.868042
2021-10-03,48200.1,47665.4,49165.2,47123.0,42410.0,63540.9,0.1,48004.333333333336,57.89004843263361,599.265082423007,50356.04596135845,39544.46403864154,45177.89447696136,89.86069087241553,2484.783450647905,66028780.0,2.035195718764491,0.01118595922957022,5.155141691921604,5.155141691921604,44690.95,46266.05,39994.82064,40651.3,52672.1,0,510.0,3.0871786234345384,14190588663.225082
2021-10-04,49227.3,48200.4,49481.7,46958.6,66920.0,63540.9,0.1,48364.76666666666,60.11209798092981,743.0520037793433,50708.40408066525,39407.08591933474,45563.552145822185,97.41329347527687,2487.520347030197,66095700.0,14.827644119746411,0.021311159105479094,5.053131792786111,5.053131792786111,44849.2,46266.05,40361.6358144,40651.3,52672.1,0,511.0,3.087585204561471,14249396207.358381
2021-10-05,51469.3,49229.5,51872.4,49060.1,76630.0,63540.9,0.1,49632.23333333334,64.51355776660196,941.9370212242096,51401.378050123916,39047.981949876084,46126.004322410554,96.42853978576555,2510.718893670898,66172330.0,26.611695074942247,0.04554383441708154,4.8780902279045915,4.8780902279045915,46051.65,46266.05,40908.839665536,40651.3,52672.1,0,512.0,3.0880022673037306,14309695255.06785
2021-10-06,55323.2,51470.0,55676.1,50439.5,116260.0,63540.9,0.1,52006.6,70.53282428604194,1265.6514039155527,53133.40379311378,38073.476206886226,47001.92772027622,97.62987340071861,2705.42468698012,66288590.0,27.029087335482505,0.07487764550907028,4.890217281321616,4.890217281321616,47953.5,47661.45,41785.92449229312,40651.3,52672.1,0,513.0,3.0884366127466163,14372315855.838322
2021-10-07,53783.9,55325.2,55325.6,53476.4,75680.0,63540.9,0.1,53525.46666666667,65.73663727784168,1303.5706714774665,54240.994436024295,37615.99556397571,47647.82984215468,87.29171563853724,2644.265780767254,66212910.0,19.868194663599986,-0.027823770136217618,4.916463441229167,4.916463441229167,47953.5,47661.45,43174.942043063806,40651.3,52672.1,0,514.0,3.088863508741283,14434316373.295757
2021-10-08,53914.7,53785.5,55977.9,53659.3,64050.0,63540.9,0.1,54340.6,65.94852700190535,1263.9820860798488,55175.938687297625,37241.85131270238,48244.67461909232,86.41854219191245,2621.0039392838785,66276960.0,25.910382789310564,0.002431954544017678,4.861390194666535,4.861390194666535,48254.825000000004,47812.350000000006,44425.05783875743,40651.3,52672.1,0,515.0,3.089290503221544,14496596585.942318
2021-10-09,54942.5,53924.1,55430.8,53711.7,64650.00000000001,63540.9,0.1,54213.700000000004,67.64188461121151,1232.2519526803915,56333.56438737508,36854.60561262493,48882.562750607336,93.18425677855087,2556.5822293350307,66341610.0,28.710748990320184,0.019063446518296612,4.653196031005198,4.653196031005198,48723.875,47812.350000000006,45811.398898106534,40651.3,52672.1,0,516.0,3.0897216438021102,14559648066.48251
2021-10-10,54687.7,54942.5,56432.2,54100.8,104430.0,63540.9,0.1,54514.96666666667,66.75559442303968,1122.4496037025963,57372.65185583906,36997.228144160945,49435.432964835214,88.8296237481751,2540.497784382528,66237180.0,26.58193568098806,-0.004637575647267633,4.645464673742959,4.645464673742959,49867.45,48039.5,47031.37903033375,40651.3,52672.1,0,517.0,3.090151139238943,14622774032.50407
2021-10-11,57477.3,54686.9,57814.1,54457.8,73840.0,63540.9,0.1,55702.5,71.20413507798958,1161.1973291150932,58684.90664464198,37367.57335535803,50201.32506342234,98.01871863804557,2598.7693712123473,66311020.0,36.29062471841908,0.05100964202188063,4.5213838701754385,4.5213838701754385,50558.399999999994,48730.45,48347.49396608703,40651.3,52672.1,0,518.0,3.090592366107538,14687607544.145824
2021-10-12,56015.9,57480.6,57635.7,54155.4,74850.0,63540.9,0.1,56060.299999999996,66.20599781096402,1017.0866509805373,59641.08998547433,37657.82001452567,50755.09410500117,89.42179291844865,2661.735844697179,66236170.0,36.549876530569954,-0.025425689794057904,4.751750564923849,4.751750564923849,50558.399999999994,48730.45,49862.150931513104,56015.9,52672.1,0,519.0,3.0910267532879936,14751889481.526157
2021-10-13,57380.1,56014.5,57697.4,54314.4,73620.0,63540.9,0.1,56957.76666666666,68.43352338560373,943.9234326081955,60748.342159806925,37801.657840193075,51386.047047382,97.35323892812276,2713.2547129330947,66309790.0,38.14280348991736,0.024353799546200205,4.728563932326877,4.728563932326877,51083.774999999994,48730.45,51134.462782471004,56015.9,52672.1,0,520.0,3.0914665496018303,14817120004.723362
2021-10-14,57345.8,57370.4,58506.5,56866.8,59840.0,63540.9,0.1,56913.93333333333,68.3116024456026,827.6636490496821,61586.69365235128,38415.89634764872,51953.64256667896,92.37064205710682,2636.5722334378734,66249950.0,30.856872942019425,-0.000597768215809924,4.597672773660622,4.597672773660622,51774.825,49076.65,52203.20473727564,56015.9,52672.1,0,521.0,3.0919056912279523,14882558356.231936
2021-10-15,61672.5,57348.2,62892.8,56874.8,121480.0,63540.9,0.1,58799.46666666667,74.4864660234734,966.9087223495121,63081.52933211752,38819.630667882484,52879.24803651906,92.34162995318245,2878.102788192311,66371430.0,28.094753458231214,0.07544929184003002,4.666752261043919,4.666752261043919,54727.200000000004,51269.8,53337.797884566025,56015.9,61672.5,0,522.0,3.0923621919907345,14950445453.084671
2021-10-16,60861.1,61669.2,62329.2,60161.9,49930.0,63540.9,0.1,59959.799999999996,71.66611068861525,928.8945141172708,64149.38598663767,39517.544013362334,53639.42441399343,87.2494383150707,2827.331160464288,66321500.0,27.680004363614998,-0.013156593295228891,4.645547255084591,4.645547255084591,54772.925,51269.8,55248.79830765282,56015.9,61672.5,0,523.0,3.0928149207820193,15018171431.468367
2021-10-17,61527.5,60865.5,61651.4,59143.4,53390.0,63540.9,0.1,61353.69999999999,72.58425547254504,873.9629950107169,64969.372910464415,40633.04708953558,54390.66970789882,91.43163760966975,2804.5217918596964,66374890.0,27.650150103423027,0.010949522765773212,4.558159833992437,4.558159833992437,55020.75,51269.8,56777.59864612226,56015.9,61672.5,0,524.0,3.0932698062650723,15086475514.226522
2021-10-18,62056.3,61525.8,62623.6,60026.9,80150.0,63540.9,0.1,61481.63333333333,73.32298151489226,800.5343852010537,65386.45633578074,42319.36366421925,55120.72973571798,93.95273518546632,2789.677378155432,66455040.0,26.060742717963404,0.008594530900816855,4.495397531202202,4.495397531202202,55168.25,51269.8,58000.638916897806,56015.9,61672.5,0,525.0,3.0937262739246103,15155290362.566635
2021-10-19,64278.5,62030.2,64454.0,61451.0,80160.0,64278.5,0.1,62620.76666666666,76.22250031948752,825.6056584616235,65910.25663394913,44069.73336605089,55992.89833231627,98.74772556994542,2804.914708287187,66535200.0,24.887068602059863,0.03580941822184047,4.363690360364954,4.363690360364954,55962.5,52050.4,58979.07113351824,56015.9,61672.5,0,526.0,3.0941908556409787,15225447719.17586
2021-10-20,65979.1,64276.9,66967.1,63543.7,79870.0,65979.1,0.1,64104.63333333333,78.17729412493676,875.9314568523487,66754.06904806764,45441.50095193236,56943.96515780996,92.67643635986272,2849.092229123817,66615070.0,19.26117795066086,0.02645674681269794,4.318173829476026,4.318173829476026,57219.05,53306.950000000004,60026.9,56015.9,61672.5,0,527.0,3.0946613183332676,15296679123.252111
2021-10-21,62210.2,66004.6,66616.9,62092.1,105380.0,65979.1,0.1,64155.93333333333,65.3538898415843,588.401003598533,67116.2516127024,46485.73838729759,57445.511333256625,64.25479793805131,2968.7856413292584,66509690.0,15.666956096527018,-0.057122634288736984,4.772184692107176,4.772184692107176,57258.8,53306.950000000004,61414.94,56015.9,61672.5,0,528.0,3.0951168256340913,15366331855.384201
2021-10-22,60690.3,62200.8,63699.7,60055.7,75690.0,65979.1,0.1,62959.86666666667,61.007851862487925,246.36645967575532,66994.04269221029,47910.28730778971,57754.53882532742,52.64722301854339,3017.0152383771683,66434000.0,12.567259022121993,-0.02443168483624858,4.971165471874695,4.971165471874695,57904.0,53306.950000000004,66967.1,56015.9,61672.5,0,529.0,3.0955657496615054,15435456633.276918
2021-10-23,61312.5,60693.2,61728.7,59738.3,37050.0,65979.1,0.1,61404.333333333336,62.11843149257563,24.24212228649094,66778.90807980346,49436.66192019654,58093.39227053433,56.051079175831404,2943.6855784930844,66471050.0,11.593939118168993,0.010252050162876003,4.801118170834797,4.801118170834797,57906.0,53306.950000000004,66828.872,56015.9,61672.5,0,530.0,3.0960166609184534,15505149351.926619
2021-10-24,60866.5,61308.2,61469.9,59523.7,42670.0,65979.1,0.1,60956.43333333333,60.782029019694356,-179.30597707568904,66408.75818964413,50970.731810355865,58357.49776857868,52.3825877908474,2872.4366086007217,66428380.0,11.298335823228996,-0.007274209989806324,4.719240647319497,4.719240647319497,58473.15,53306.950000000004,66545.24912000001,56015.9,61672.5,0,531.0,3.096465268370868,15574858667.08409
2021-10-25,63067.0,60864.3,63694.8,60655.8,51060.0,65979.1,0.1,61748.666666666664,64.80518336168475,-191.2384007230994,66455.95070230655,52083.30929769343,58806.021790618805,69.55829437155097,2884.3339937006704,66479440.0,9.725056674548034,0.03615289198491789,4.573444105000508,4.573444105000508,58623.575,53306.950000000004,66123.95617280001,56015.9,61672.5,0,532.0,3.096922065070606,15645948331.693783
2021-10-26,60310.8,63067.5,63275.1,59907.3,57130.0,65979.1,0.1,61414.76666666666,56.92783137040258,-398.33345692623243,66482.94486066604,52555.07513933395,58949.33400103606,47.392256198281785,2918.867279864908,66422310.0,7.667287323777716,-0.043702728843927785,4.839709106602645,4.839709106602645,59187.7,53306.950000000004,65727.94080243201,56015.9,61672.5,0,533.0,3.0973673967112108,15715863290.477165
2021-10-27,58438.1,60312.5,61452.9,58112.6,88110.0,65979.1,0.1,60605.299999999996,52.27805471673589,-659.605616726461,66227.4553953354,53275.98460466461,58900.645048556435,15.556963654544866,2948.9696170174147,66334200.0,1.8438448172798585,-0.03105082340144727,5.046313307615091,5.046313307615091,59751.350000000006,53306.950000000004,65355.686354286096,56015.9,61672.5,0,534.0,3.0978044933490336,15785009180.865738
2021-10-28,60582.5,58437.2,62251.3,58128.1,88470.0,65979.1,0.1,59777.13333333333,56.64491928521931,-683.2733051809887,65985.48557513076,54184.73442486925,59060.821710598684,36.73790909901604,3032.8432158018854,66422670.0,5.644179695810324,0.03669523820931886,5.00613744200369,5.00613744200369,59751.350000000006,53306.950000000004,64776.23944594321,56015.9,61672.5,0,535.0,3.098249909828865,15855557775.529383
2021-10-29,62242.8,60579.9,62952.2,60322.2,63390.0,65979.1,0.1,60421.13333333333,59.718355667310014,-586.1112278014284,65920.346735131,54979.90326486901,59363.86726197024,46.64520865096845,3004.068700387465,66486060.0,0.9247233369816416,0.02740560392852731,4.8263714042226,4.8263714042226,59663.8,53306.950000000004,64243.14829026775,56015.9,61672.5,0,536.0,3.0987014347044353,15927232042.320616
2021-10-30,61840.1,62245.0,62338.5,60786.0,40510.0,65979.1,0.1,61555.13333333333,58.632671126933246,-548.628765117146,65619.92281237345,55995.56718762654,59599.69895130641,42.09723869219038,2900.3852217883605,66445550.0,1.6085808504939938,-0.006469824622285736,4.690136694132708,4.690136694132708,59459.875,53306.950000000004,63752.70442704633,56015.9,61672.5,0,537.0,3.099150857023828,15998950874.124397
2021-10-31,61309.6,61842.2,62393.7,60005.7,50060.0,65979.1,0.1,61797.5,57.158443159163184,-557.4226828723581,65564.68462959638,56434.03537040363,59762.54667022961,36.1059348353944,2863.786277374906,66395490.0,-0.3541505830726122,-0.008578576037231556,4.671024239882345,4.671024239882345,59803.5,53306.950000000004,63301.496072882626,56015.9,61672.5,0,538.0,3.0995976590077228,16070642666.959057
2021-11-01,60915.3,61310.1,62430.1,59612.7,61210.0,65979.1,0.1,61355.0,56.03078429015833,-584.7983028033309,65198.642364039944,57290.017635960045,59872.33270163632,31.65283189338757,2860.4729718481276,66334280.0,-1.8386529651300512,-0.006431292978587244,4.695820215689864,4.695820215689864,60562.725,53306.950000000004,62886.384387052014,60915.3,61672.5,0,539.0,3.100042372435139,16142375601.12493
2021-11-02,63221.7,60912.2,64256.4,60651.5,65260.00000000001,65979.1,0.1,61815.53333333333,60.89111000178771,-448.7002601408317,65154.543094787856,57918.276905212166,60191.32006338524,57.70060421254723,2913.646331001833,66399540.0,-1.6440956151745962,0.03786240895144566,4.608617501588589,4.608617501588589,60748.850000000006,53306.950000000004,58112.6,60915.3,61672.5,0,540.0,3.1004956652442197,16215587403.64892
2021-11-03,62918.5,63223.5,63508.6,60883.0,61050.0,65979.1,0.1,62351.833333333336,59.95288714633579,-382.7904739065857,64921.510734222575,58708.57926577744,60451.051485919976,56.5114118739932,2893.0715930731308,66338490.0,-4.638741662132411,-0.004795821687806567,4.598125500565224,4.598125500565224,60761.95,53306.950000000004,58235.475999999995,60915.3,61672.5,0,541.0,3.100947267915456,16288902660.572897
2021-11-04,61412.6,62915.4,63077.6,60742.9,49910.0,65979.1,0.1,62517.6,55.38810317320925,-440.20947428715954,64912.96344431165,58691.136555688354,60542.62753487998,53.71268595982939,2853.1879078536213,66288580.0,-1.2821048638326167,-0.023934137018523982,4.645932443592391,4.645932443592391,60859.225000000006,53306.950000000004,58355.894479999995,60915.3,61672.5,0,542.0,3.101392435897104,16361673442.189112
2021-11-05,60974.3,61411.5,62560.3,60742.4,44460.0,65979.1,0.1,61768.46666666667,54.09705115690481,-502.78350563304593,64912.160184428634,58703.259815571364,60583.73919822474,46.57866467007395,2779.2387715783625,66244120.0,0.46794957349032706,-0.0071369718917615455,4.558049492291609,4.558049492291609,60876.75,53306.950000000004,58473.904590399994,60915.3,61672.5,0,543.0,3.1018353450015175,16434460796.473818
2021-11-06,61483.9,60973.2,61543.2,60093.6,34890.0,65979.1,0.1,61290.26666666666,55.398768613740636,-503.66966755187786,64910.825314845104,58700.23468515488,60669.46879839381,54.87320550799182,2684.264573608479,66279010.0,0.27955147808359054,0.008357619521667248,4.365800760212802,4.365800760212802,61247.9,53306.950000000004,58589.55449859199,60915.3,61672.5,0,544.0,3.1022797806372404,16507782306.022242
2021-11-07,63273.2,61483.8,63273.2,61347.2,34340.0,65979.1,0.1,61910.46666666667,59.71817177958748,-383.02918449263234,65035.96242796266,58696.78757203734,60917.44319854678,83.99687489827137,2630.1028183507306,66313350.0,3.9540634010498334,0.029101927496466562,4.156740639561032,4.156740639561032,61287.65,53306.950000000004,58702.891408620155,60915.3,61672.5,0,545.0,3.1027307150813126,16582328748.515512
2021-11-08,67527.9,63276.4,67763.3,63276.4,81080.0,67527.9,0.1,64095.0,67.72283020746701,-34.33325882803206,65925.97241925368,58131.717580746306,61547.0105129709,97.56079869853991,2762.9597598971077,66394430.0,7.073271282921328,0.06724331944646389,4.091582530919973,4.091582530919973,63001.525,53705.05,58813.96158044775,60915.3,67527.9,0,546.0,3.103197028600815,16659345599.969666
2021-11-09,66904.4,67528.7,68493.3,66334.9,66130.0,67527.9,0.1,65901.83333333333,65.66357417098412,127.78710828389148,66175.39593144416,57974.82406855585,62057.23808316415,84.69371044341895,2719.7769199044574,66328300.0,10.932701937298114,-0.009233220639172868,4.06516898724816,4.06516898724816,63368.525,54070.05,59171.93511722984,60915.3,67527.9,0,547.0,3.1036605541149025,16736332353.57716
2021-11-10,64932.6,66942.6,68990.6,62951.3,96210.0,67527.9,0.1,66454.96666666666,59.50166291336777,78.1303035352039,66496.97731644305,57925.482683556955,62331.08207524375,62.64211737629455,2956.885711339853,66232090.0,11.113468781497003,-0.02947190319321291,4.553776856832859,4.553776856832859,64046.850000000006,54318.700000000004,59731.21701019605,60915.3,67527.9,0,548.0,3.1041162570747596,16812580416.991537
2021-11-11,64806.7,64922.8,65583.3,64121.9,50370.0,67527.9,0.1,65547.9,59.12018075995417,15.961712903937496,66785.4398477584,58048.660152241595,62566.855210934824,55.385534074792815,2850.0653033870067,66181720.0,6.972640614038703,-0.0019389336019195458,4.397794214775643,4.397794214775643,64046.850000000006,54318.700000000004,60471.96764938037,60915.3,67527.9,0,549.0,3.104570971032482,16889037417.317842
2021-11-12,64134.5,64782.6,65449.7,62309.7,63270.0,67527.9,0.1,64624.6,57.018259047557386,-85.69001219136044,66956.91275582107,58159.38724417892,62716.15471465531,48.21761801682678,2870.774924573649,66118450.0,3.03922702706176,-0.010372384336804652,4.476178850031807,4.476178850031807,64046.850000000006,54788.15,61153.45823742994,60915.3,67527.9,0,550.0,3.105022626877117,16965410711.580849
2021-11-13,64398.6,64133.3,64906.0,63381.4,30340.0,67527.9,0.1,64446.6,57.655252411563374,-146.81246614871498,67131.28451473075,58338.22548526926,62876.38759897385,51.033813540344816,2774.6195728183884,66148790.0,4.137283089775081,0.004117908458006303,4.308509148985208,4.308509148985208,64046.850000000006,54888.600000000006,61780.42957843555,60915.3,67527.9,0,551.0,3.1054747727845156,17042199550.329449
2021-11-14,65508.2,64397.2,65508.2,63608.3,33980.0,67527.9,0.1,64680.43333333333,60.31626067982106,-125.03536803746147,67416.0034458858,58297.626554114206,63127.036399071585,62.8658868190106,2712.1396033313604,66182770.0,6.848193431371268,0.017230188233905652,4.140152840913596,4.140152840913596,64046.850000000006,54888.600000000006,62309.7,60915.3,67527.9,0,552.0,3.1059305717489765,17119857408.110567
2021-11-15,63597.9,65514.9,66311.2,63439.5,53530.0,67527.9,0.1,64501.56666666666,54.02209839713952,-244.87801025590193,67436.09377515156,58606.24622484844,63171.88055154096,39.38743396650556,2723.5367745219773,66129240.0,4.403819730018564,-0.02916123477671495,4.282431927032146,4.282431927032146,64360.25,54888.600000000006,62844.172,60915.3,67527.9,0,553.0,3.106378641406824,17196762792.878716
2021-11-16,60089.1,63605.1,63605.6,58655.9,115360.0,67527.9,0.1,63065.06666666666,44.778963604298184,-548.6572218404608,67224.73864863512,58982.70135136487,62878.282403775156,13.867843285242886,2882.548433484693,66013880.0,-4.954944267553702,-0.05517163302561878,4.797123660505305,4.797123660505305,63687.425,54888.600000000006,68990.6,60915.3,67527.9,0,554.0,3.1068123707682807,17271951303.041348
2021-11-17,60367.8,60074.2,60814.5,58531.9,73930.0,67527.9,0.1,61351.6,45.57549945377958,-708.8398009176651,67241.24672427663,58944.72327572338,62639.188841510855,17.553806878483947,2839.6949739500715,66087810.0,-4.053974586170995,0.004638112403081429,4.703989500942674,4.703989500942674,63656.425,54902.8,68783.906,60915.3,67527.9,0,555.0,3.1072467290330734,17347559911.636868
2021-11-18,56955.3,60368.2,60936.9,56524.4,100370.0,67527.9,0.1,59137.4,38.292153496579466,-1004.5699285778608,67759.9557894979,57897.26421050212,62097.8660947003,3.4565465017407173,2952.0381900964953,65987440.0,-7.25795683621927,-0.05652848041505576,5.183078993695925,5.183078993695925,62757.5,54902.8,68373.82576,60915.3,67527.9,0,556.0,3.1076664139185386,17421370739.01762
2021-11-19,58083.4,56908.3,58335.9,55626.3,74440.0,67527.9,0.1,58468.833333333336,41.613915236671886,-1077.6958693333434,67977.91061112126,57303.63938887875,61715.535990443124,18.385549561144227,2934.721176518174,66061880.0,-4.741177840500016,0.019806760740440188,5.052598808813145,5.052598808813145,61638.600000000006,54902.8,67662.8602144,60915.3,67527.9,0,557.0,3.1080903872077172,17496120925.289253
2021-11-20,59717.6,58080.8,59854.6,57435.3,44530.0,67527.9,0.1,58252.1,46.13725164274176,-972.7100291076115,68021.41830332438,57100.93169667563,61525.25637230569,30.613649798343307,2897.905378195447,66106410.0,-2.8727845826305796,0.02813540529652192,4.8526822548050275,4.8526822548050275,61638.600000000006,55203.65,66699.935397248,60915.3,67527.9,0,558.0,3.1085206251158564,17572109157.736023
2021-11-21,58714.3,59724.0,60002.6,58528.3,40980.0,67527.9,0.1,58838.43333333333,43.88914482480456,-927.6927917907235,68124.19484546274,56778.05515453725,61257.54624160991,23.10633553571829,2796.2192797529146,66065430.0,-7.205104214738617,-0.016800742159765236,4.762416106047274,4.762416106047274,61638.600000000006,56141.75,65814.04456546817,60915.3,67527.9,0,559.0,3.1089462432364754,17647748767.730976
2021-11-22,56308.8,58719.7,59288.3,55656.8,76450.0,67527.9,0.1,58246.9,38.98441111936515,-1009.9933196394823,68361.09457591489,55849.8654240851,60786.237075742305,5.10688924971753,2855.882188341992,65988980.0,-16.614021759894786,-0.040969576406429065,5.071822145636191,5.071822145636191,61638.600000000006,57974.600000000006,64999.025000230715,60915.3,67527.9,0,560.0,3.1093611891583035,17722138864.332592
2021-11-23,57573.2,56304.8,57855.1,55542.5,72480.0,67527.9,0.1,57532.1,42.61455530448324,-931.2734029535183,68382.1513915841,55294.27860841587,60480.23354471922,15.100274388203509,2817.076317746135,66061460.0,-13.947064767040729,0.02245474952405302,4.893034116127183,4.893034116127183,61596.7,57974.600000000006,64249.20700021226,60915.3,67527.9,0,561.0,3.1097810537581285,17797572088.596977
2021-11-24,57171.7,57559.4,57697.4,55910.6,56680.0,67527.9,0.1,57017.899999999994,41.76482812049974,-859.9469049200457,68479.07405539135,54773.26594460866,60165.13511188882,15.12903135940269,2743.48515219284,66004780.0,-11.952239707019281,-0.006973730833095937,4.79867688418018,4.79867688418018,60920.3,57974.600000000006,63378.53630019103,60915.3,67527.9,0,562.0,3.110198728616672,17873000745.90493
2021-11-25,58935.1,57167.1,59387.3,57029.8,56790.0,67527.9,0.1,57893.33333333332,46.78380653599008,-656.8746580074342,68472.88579295503,54575.53420704498,60047.988910756554,31.50426699601623,2715.9147841790655,66061570.0,-9.060174333826593,0.030843931525562418,4.608314542910873,4.608314542910873,60253.125,59025.350000000006,62594.932670171926,60915.3,67527.9,0,563.0,3.1106233049560594,17949781419.276665
2021-11-26,53730.9,58937.3,59151.1,53533.5,104030.0,67527.9,0.1,56612.56666666666,36.72439743966349,-825.0309149790884,68871.53358480295,53401.58641519707,59446.3613954464,1.5448789688285176,2923.178013880561,65957540.0,-16.2215344315462,-0.08830391396637993,5.440403964721531,5.440403964721531,59248.625,59715.05,61889.689403154734,53730.9,67527.9,0,564.0,3.111024914462779,18023443547.56712
2021-11-27,54765.9,53747.2,55280.3,53654.3,40710.0,67527.9,0.1,55810.63333333333,39.51007604502255,-816.9993970056619,68854.295791093,52568.094208906994,59000.603167308655,9.644928273476461,2830.5224414605213,65998250.0,-14.957933868127563,0.019262658916936015,5.168403041784251,5.168403041784251,59015.05,61233.5,60886.94667477617,53730.9,67527.9,0,565.0,3.1114306876150777,18098035972.930286
2021-11-28,57291.5,54758.0,57392.3,53448.3,49280.0,67527.9,0.1,55262.76666666666,45.782599743447534,-601.9691038903327,67835.31770614308,52563.432293856924,58837.83143708878,29.878176771956547,2910.05655278477,66047530.0,-12.543009882732234,0.04611628768996767,5.079386213984221,5.079386213984221,58972.45,61219.450000000004,60004.53307380303,53730.9,67527.9,0,566.0,3.1118469397008375,18174524012.737465
2021-11-29,57794.8,57288.1,58855.2,56726.7,58650.0,67527.9,0.1,56617.399999999994,46.962882945414144,-396.1546842194102,66789.65237773448,52698.13762226552,58738.49510974699,42.79188366987292,2854.231084728715,66106180.0,-9.12467235553375,0.008784898283340503,4.938560363092726,4.938560363092726,58972.45,61219.450000000004,59086.66044347061,53730.9,57794.8,0,567.0,3.1122648324973063,18251585172.61418
2021-11-30,56882.9,57795.2,59174.4,55936.9,73660.0,67527.9,0.1,57323.06666666667,45.04932848296045,-296.31756862923135,66068.01738319102,52614.80261680897,58561.77176596157,45.86438052506476,2881.607435819521,66032520.0,-5.335743088180714,-0.015778236104286192,5.0658588711537575,5.0658588711537575,58818.625,61219.450000000004,53448.3,53730.9,57794.8,0,568.0,3.1126783771802895,18328309452.991226
2021-12-01,57210.3,56891.7,59064.3,56496.5,66750.0,67527.9,0.1,57296.0,45.90161674447406,-188.37400224053476,65254.811827299614,52668.36817270039,58433.06016920332,50.236359266084456,2859.19261897527,66099270.0,-5.230437418623836,0.005755684045644749,4.997688561282269,4.997688561282269,58818.625,61219.450000000004,53562.822,53730.9,57794.8,0,569.0,3.1130928335178485,18405496411.209652
2021-12-02,56496.0,57207.8,57377.5,55807.9,54940.0,67527.9,0.1,56863.06666666666,44.28769225338795,-147.0575676013616,64486.03456015287,52673.295439847134,58248.57824832681,46.49924477060859,2767.078860477036,66044330.0,-0.806421878209759,-0.012485513972134488,4.897831457938679,4.897831457938679,58818.625,61219.450000000004,53675.05356,53730.9,57794.8,0,570.0,3.113503757204638,18482464743.41234
2021-12-03,53631.5,56495.2,57543.6,52008.9,89200.0,67527.9,0.1,55779.26666666666,38.44926198594868,-286.5531709342031,63684.958059863464,52397.66194013653,57808.85651039092,20.29848505698236,2964.766084728676,65955130.0,-7.664668390624518,-0.050702704616256034,5.528031259108316,5.528031259108316,58098.925,60499.75,59174.4,53730.9,57794.8,0,571.0,3.113901572179242,18557728114.817276
2021-12-04,49195.2,53620.7,53847.2,42587.8,168000.0,67527.9,0.1,53107.56666666666,31.519096952589933,-631.7211580726607,63029.92282189229,51421.397178107705,56988.50827130607,37.94129131543283,3557.239935819485,65787130.0,-17.620266052219115,-0.08271817868230424,7.2308679217067615,7.2308679217067615,53335.15000000001,55789.200000000004,59031.090000000004,53730.9,57794.8,1,572.0,3.114277966489525,18629972545.660942
2021-12-05,49405.5,49196.4,49689.3,47797.8,72030.0,67527.9,0.1,50744.06666666666,32.143478714798675,-789.7313575969506,62498.106255868566,50533.973744131436,56266.317007372156,40.58275543914996,3438.258511832379,65859160.0,-15.854400035425787,0.004274807298273009,6.9592626566523546,6.9592626566523546,53335.15000000001,55789.200000000004,58373.358400000005,53730.9,57794.8,0,573.0,3.114654941124869,18702588681.047386
2021-12-06,50562.1,49412.1,50913.3,47237.9,89680.0,67527.9,0.1,49720.93333333333,35.62011702889808,-759.9609131541843,62317.74767348481,49761.632326515195,55723.058244765285,47.467484151314,3455.197189558638,65948840.0,-10.205687210524827,0.02341034905020689,6.833571369778229,6.833571369778229,52665.3,55789.200000000004,57741.936064,53730.9,57794.8,0,574.0,3.1150370733027652,18776294856.0366
2021-12-07,50595.2,50547.4,51918.6,50070.9,56290.0,67527.9,0.1,50187.6,35.72161616793021,-684.0208555332649,61926.086123993664,49176.03387600633,55234.69079288287,47.66451382481618,3340.375961733021,66005130.0,-12.120222603572497,0.0006546405311487202,6.602159813051478,6.602159813051478,52665.3,55789.200000000004,57135.77062144,53730.9,57794.8,0,575.0,3.1154189057728505,18850244493.4652
2021-12-08,50473.9,50596.6,51204.7,48700.7,55590.0,67527.9,0.1,50543.73333333333,35.50073079428715,-591.4179075323104,61933.85255708298,48520.127442917,54781.282145941645,46.94246852584898,3280.6348216092338,65949540.0,-11.715236734258376,-0.0023974606286761846,6.499665810664984,6.499665810664984,52665.3,55789.200000000004,56553.8517965824,53730.9,57794.8,0,576.0,3.1157996983249894,18924321439.59033
2021-12-09,47596.6,50477.6,50790.2,47341.9,58690.0,67527.9,0.1,49555.23333333333,30.658015598181294,-667.7589026469727,62043.97347128241,47361.3265287176,54097.02670347101,30.197870570219308,3292.610905780002,65890850.0,-19.238959465581633,-0.057005699975630986,6.917743926625016,6.917743926625016,52637.775,55789.200000000004,55995.209724719105,53730.9,57794.8,0,577.0,3.116165808607024,18996364975.77897
2021-12-10,47137.2,47591.7,49974.8,47007.1,68060.0,67527.9,0.1,48402.56666666666,29.955400790247637,-690.1620802493999,61737.155801379035,46410.104198620975,53434.1860650452,27.428164904199743,3269.402983938574,65822790.0,-12.271709574937335,-0.009651949929196602,6.935929550203605,6.935929550203605,52257.6,55789.200000000004,55458.91333573034,53730.9,57794.8,0,578.0,3.11652912249102,19068238295.53629
2021-12-11,49314.5,47138.4,49487.0,46834.0,45230.0,67527.9,0.1,48016.1,37.29069005177551,-507.7426140205698,61223.92643619138,45983.35356380862,53041.83501123137,40.55502634656891,3225.374199371533,65868020.0,-9.95400422525696,0.04619069439847934,6.540417522983165,6.540417522983165,51581.2,55789.200000000004,54944.06880230113,53730.9,57794.8,0,579.0,3.116902930604898,19142057614.916206
2021-12-12,50081.0,49332.5,50779.2,48670.5,40300.0,67527.9,0.1,48844.23333333333,39.68535064414192,-295.38372455673925,60953.78580099985,45630.71419900015,52759.85072444743,45.176226592550606,3145.6117565592804,65908320.0,-12.585636612761055,0.01554309584402147,6.2810482150102445,6.2810482150102445,49989.925,55789.200000000004,54449.81805020908,53730.9,57794.8,0,580.0,3.117280022297486,19216688618.369637
2021-12-13,46703.6,50075.9,50196.1,45848.2,80370.0,67527.9,0.1,48699.69999999999,33.597382011382564,-339.1723663601251,60656.63974933216,44840.90025066784,52183.064941166725,24.814006487164313,3231.489488233618,65827950.0,-19.19065383044842,-0.06743874922625348,6.919144323421787,6.919144323421787,50322.875,55789.200000000004,53975.33732820072,53730.9,57794.8,0,581.0,3.117639754968185,19288819584.596653
2021-12-14,48366.5,46709.8,48635.0,46338.3,62540.0,67527.9,0.1,48383.69999999999,38.59235287516072,-218.7806320282184,60162.64805682092,44454.37194317907,51819.582565817516,35.07237580796891,3164.718810502645,65890490.0,-14.971810508957878,0.03560539230380533,6.543204098916905,6.543204098916905,50089.299999999996,55789.200000000004,53519.83583507269,53730.9,57794.8,0,582.0,3.1180075152576605,19362516701.590076
2021-12-15,48871.5,48366.2,49477.9,46572.6,80280.0,67527.9,0.1,47980.533333333326,40.06678657645392,-75.19077990804817,59171.12885066128,44439.53114933873,51538.81279764442,42.01513793979593,3146.1888954667415,65970770.0,-14.575697033576127,0.010441111099624756,6.437676141445918,6.437676141445918,50089.299999999996,55789.200000000004,53082.55440166978,53730.9,57794.8,0,583.0,3.1183773423119545,19436830178.52488
2021-12-16,47628.2,48876.6,49387.8,47543.9,48200.0,67527.9,0.1,48288.73333333333,37.66876330826431,-35.98906095503253,59025.531024251875,43974.858975748124,51166.37348358305,33.701975153452146,3053.16826007626,65922570.0,-15.696332483715667,-0.025440184974883207,6.410421263193361,6.410421263193361,49910.825,55789.200000000004,52662.764225602994,53730.9,57794.8,0,584.0,3.1187404862464447,19510341914.0312
2021-12-17,46172.2,47630.4,47997.2,45523.8,67500.0,67527.9,0.1,47557.29999999999,35.02503069048102,-77.76281116652945,58780.03046469838,43360.98953530161,50690.737913717996,31.834733644776772,3011.756241499384,65855070.0,-13.908430679731135,-0.030570124422086065,6.522877925460308,6.522877925460308,49572.275,55789.200000000004,52259.76565657887,46172.2,57794.8,0,585.0,3.119095676899054,19582833232.849426
2021-12-18,46856.2,46171.8,47330.2,45513.4,36930.0,67527.9,0.1,46885.533333333326,37.252996728462406,-31.35352993463448,57908.071692972895,43189.41830702711,50325.543826697234,20.96421657403354,2926.402224249428,65892000.0,-4.754528897128176,0.014814108922684976,6.245496272103645,6.245496272103645,49566.925,55789.200000000004,51872.88703031572,46172.2,57794.8,0,586.0,3.1194539863048627,19656104739.767403
2021-12-19,46704.5,46855.7,48270.2,46438.4,44050.0,67527.9,0.1,46577.633333333324,36.950378187153774,14.633355191366718,56731.018785794266,43257.441214205726,49980.68250986892,18.59582838943357,2848.2163510887544,65847950.0,-5.4670026616469825,-0.00323756514612783,6.0983767112135965,6.0983767112135965,49566.925,55789.200000000004,51501.48354910309,46172.2,57794.8,0,587.0,3.1198110720989725,19729449002.361263
2021-12-20,46895.2,46703.4,47488.9,45577.3,57530.0,67527.9,0.1,46818.633333333324,37.636208420838386,79.7625978279948,55562.53188594786,43427.158114052145,49686.82703273855,21.573096858802163,2781.315183153843,65905480.0,-7.252269980875006,0.0040831183290688244,5.930916561084809,5.930916561084809,49566.925,55789.200000000004,51144.93620713897,46172.2,57794.8,0,588.0,3.120168704249225,19803156979.65078
2021-12-21,48902.0,46900.1,49306.1,46654.0,57880.0,67527.9,0.1,47500.56666666666,44.48034940926139,269.1931809476964,54008.0392890798,44150.8207109202,49612.08160104916,59.539999648586466,2772.0855272142826,65963360.0,-3.3465625197647153,0.04279329227724804,5.668654711901932,5.668654711901932,49367.925,55789.200000000004,50802.65075885341,46172.2,57794.8,0,589.0,3.120536023616994,19878745535.591072
2021-12-22,48599.7,48898.7,49540.3,48449.7,40890.0,67527.9,0.1,48132.29999999999,43.70229596779384,378.6282587457981,52250.08832749858,45119.14167250141,49515.66430571114,58.488098847786496,2651.979418127549,65922470.0,-3.7132062313393743,-0.0061817512576173295,5.456781457761157,5.456781457761157,49203.975000000006,55789.200000000004,50474.05672849927,46172.2,57794.8,0,590.0,3.120901399148567,19954299170.051357
2021-12-23,50801.0,48599.6,51355.6,48053.4,56240.0,67527.9,0.1,49434.23333333333,50.49325871497052,591.0978687113216,51481.45103969608,45604.72896030391,49638.07722897675,90.50700078737465,2698.4237454041527,65978710.0,6.732413659799233,0.045294518278919504,5.311753204472653,5.311753204472653,49657.8,55789.200000000004,42587.8,46172.2,50801.0,0,591.0,3.1212770303394164,20031852633.935966
2021-12-24,50786.1,50807.4,51795.3,50428.4,45970.0,67527.9,0.1,50062.26666666666,50.44889947674714,714.2295811227041,51709.67650492083,45535.59349507917,49747.41273097896,83.9347967971473,2603.3149064467134,65932740.0,7.741019831470688,-0.0002933013129663431,5.126038239689036,5.126038239689036,49767.725000000006,55789.200000000004,42763.156,46172.2,50801.0,0,592.0,3.1216521392442718,20109619963.206863
2021-12-25,50406.4,50789.6,51140.2,50196.8,26670.0,67527.9,0.1,50664.5,49.2612317412573,750.002704829888,51840.26507989981,45505.09492010019,49810.17342326668,77.89044715770704,2484.749555986233,65906070.0,2.2141560798548126,-0.007476455171789076,4.929432683124034,4.929432683124034,49767.725000000006,55789.200000000004,43124.44176,46172.2,50801.0,0,593.0,3.1220249854439426,20187308356.020718
2021-12-26,50779.9,50404.0,51247.0,49527.0,32340.000000000004,67527.9,0.1,50657.46666666667,50.49581357332902,775.5039278105664,51878.44315998676,45488.696840013225,49902.528335336516,83.83610054282939,2430.1245877015026,65938410.0,1.3955392264531488,0.007409773362112793,4.785603334590069,4.785603334590069,49740.200000000004,55789.200000000004,43471.2760896,46172.2,50801.0,0,594.0,3.122399164321937,20265522059.87209
2021-12-27,50678.2,50783.6,52016.3,50459.0,43900.0,67527.9,0.1,50621.49999999999,50.13807755445452,761.1364220022906,51892.71446714091,45482.72553285909,49976.40182720923,79.42302664964853,2367.7799742942525,65894510.0,8.51026473333961,-0.002002760934936898,4.672186412094851,4.672186412094851,49431.25,55789.200000000004,43804.237046016,46172.2,50801.0,0,595.0,3.122772409425545,20343880401.533585
2021-12-28,47545.2,50703.4,50703.8,47345.7,74390.0,67527.9,0.1,49667.76666666666,40.59650303757758,527.3478695720748,51673.24912640756,45409.320873592435,49744.85879604644,31.244521674944952,2438.5171189875205,65820120.0,-1.698076147746897,-0.06182145380064796,5.128839754565173,5.128839754565173,49431.25,55789.200000000004,44296.960823255045,46172.2,50801.0,0,596.0,3.1231298100948215,20419843682.004402
2021-12-29,46461.7,47548.4,48121.7,46127.8,63920.0,67527.9,0.1,48228.36666666666,37.90958393635413,297.8784077750038,51722.25031959375,45246.829680406234,49432.17700594678,14.582724630549377,2406.7587533455544,65756200.0,-4.930890191624981,-0.02278884093452127,5.180091889331545,5.180091889331545,48644.775,55789.200000000004,44760.12117385974,46172.2,50801.0,0,597.0,3.123481213073589,20495065395.1839
2021-12-30,47123.3,46470.7,47901.4,46003.0,60960.0,67527.9,0.1,47043.399999999994,40.49922659522073,193.8345166620868,51722.71764860845,45244.97235139155,49212.28395776138,24.756647034400054,2370.447413820872,65817160.0,-1.0600862514224645,0.014239685590497153,5.030308602794949,5.030308602794949,48887.25,55789.200000000004,45195.491903428156,46172.2,50801.0,0,598.0,3.1238355922624934,20571074531.551334
2021-12-31,46219.5,47123.3,48553.9,45693.6,58180.0,67527.9,0.1,46601.5,38.15790375105687,73.5171370410776,51687.95788703543,44970.23211296457,48927.25691416506,10.858232480893115,2405.4368842622384,65758980.0,0.1024425953279309,-0.01917947172630108,5.204376690059907,5.204376690059907,48809.9,55789.200000000004,45604.74038922247,46172.2,50801.0,0,599.0,3.1241848676429824,20646486598.433144
2022-01-01,47738.0,46217.5,47917.6,46217.5,31240.0,67527.9,0.1,47026.93333333333,44.014158077406826,103.72505258706133,51480.447384564526,44943.44261543547,48813.99435091125,33.556452865351716,2355.0556782435065,65790220.0,1.881928111968113,0.03285409837839004,4.933293557005962,4.933293557005962,48809.9,54449.5,45693.6,46172.2,50801.0,0,600.0,3.1245415026551395,20723446759.04733
2022-01-02,47311.8,47738.7,47944.9,46718.2,27020.0,67527.9,0.1,47089.76666666666,42.78938644627382,102.3531369325467,51465.15503132431,45019.55496867569,48670.92822225304,26.937412641714552,2274.4588440832563,65763200.0,1.3003029686646959,-0.00892789811051986,4.807381761174287,4.807381761174287,48809.9,54449.5,45693.6,46172.2,50801.0,0,601.0,3.124895540162557,20800243034.89761
2022-01-03,46430.2,47293.9,47556.0,45704.0,41060.0,67527.9,0.1,47160.0,40.29179090430327,51.96366536459254,51462.56369867989,44828.51630132011,48457.525534419416,11.650086197352366,2244.2832123630237,65722140.0,-0.9915726982718914,-0.018633829192717388,4.83367121477621,4.83367121477621,48809.9,54449.5,52016.3,46172.2,50801.0,0,602.0,3.1252446118339217,20876459093.37722
2022-01-04,45837.3,46435.7,47505.4,45602.1,55590.0,67527.9,0.1,46526.43333333333,38.6575541399253,-8.20183741817118,51439.22886172908,44548.43113827092,48207.98024542709,3.6668641451779522,2219.927268622808,65666550.0,-6.267023843605572,-0.012769705924161268,4.843058532293149,4.843058532293149,48787.025,54449.5,51890.054000000004,46172.2,50801.0,0,603.0,3.125590157319314,20952337981.747776
2022-01-05,43425.9,45833.1,47019.4,42535.1,83740.0,67527.9,0.1,45231.133333333324,32.82594814743918,-187.3745201044012,51763.74513821555,43803.684861784444,47752.544031576894,9.395435176981843,2381.6681780068934,65582810.0,-10.645744726819293,-0.05260781066947662,5.4844417225823605,5.4844417225823605,46947.575,54423.149999999994,51638.535840000004,46172.2,50801.0,0,604.0,3.125922262086211,21026135189.864395
2022-01-06,43097.5,43431.6,43772.3,42481.1,63080.0,67527.9,0.1,44120.23333333334,32.11541248506502,-298.38681134121225,52059.294640709566,43200.665359290426,47309.20650476005,6.46446849567918,2303.777593863544,65519730.0,-15.164071573394224,-0.007562307286665404,5.345501696997608,5.345501696997608,46383.1,53043.35,51092.3296896,46172.2,50801.0,0,605.0,3.1262521210460554,21099796674.0106
2022-01-07,41546.7,43097.9,43127.7,40810.0,88360.0,67527.9,0.1,42690.033333333326,28.930735407886175,-438.18867030821457,52523.81040847353,42205.19959152646,46760.39636144957,6.573980707280699,2304.7720514447196,65431370.0,-18.192773219443907,-0.03598352572655028,5.547425069728089,5.547425069728089,45547.55,50873.45,50403.431314432004,46172.2,50801.0,0,606.0,3.1265727435540174,21172084609.456375
2022-01-08,41672.0,41551.3,42304.4,40574.3,52540.0,67527.9,0.1,42105.399999999994,29.538705863212613,-480.74312118235525,52836.42549649117,41389.33450350883,46275.78718416866,9.59360251704245,2263.7240477700966,65483910.0,-17.32795835449467,0.003015883331287439,5.432242387622616,5.432242387622616,45429.700000000004,50755.600000000006,49444.0881829888,46172.2,50801.0,0,607.0,3.1268936806834504,21244675425.96594
2022-01-09,41848.3,41681.2,42764.4,41260.9,37510.0,67527.9,0.1,41688.99999999999,30.44036804314375,-455.76359435432096,53028.025952819014,40693.04404718098,45854.12173805736,11.134417059954554,2209.4223300722324,65521420.0,-17.588849131250747,0.004230658475715243,5.279598765235941,5.279598765235941,45277.450000000004,50288.45,48379.71360103015,46172.2,50801.0,0,608.0,3.1272152233194994,21317622270.319847
2022-01-10,41832.2,41848.9,42243.8,39697.0,85500.0,67527.9,0.1,41784.166666666664,30.402107144117792,-401.0042878216598,52969.35407941616,40044.73592058384,45471.081572528085,19.398917033106777,2233.520735067073,65435920.0,-17.45523716311945,-0.000384722915865332,5.33923803927853,5.33923803927853,44838.8,49849.8,47443.06396890653,46172.2,50801.0,0,609.0,3.127536263057862,21390729331.55475
2022-01-11,42733.2,41829.1,43090.2,41287.6,61780.0,67527.9,0.1,42137.899999999994,35.30297697151924,-271.0090162602926,52800.81500784714,39626.624992152865,45210.330946573034,34.28061737176661,2202.740682562282,65497700.0,-10.120895484717702,0.021538432116886108,5.154635465076994,5.154635465076994,44741.575,49849.8,46358.615013259616,46172.2,50801.0,0,610.0,3.127862016585993,21464930603.473915
2022-01-12,43901.0,42735.0,44243.6,42476.7,53950.0,67527.9,0.1,42822.133333333324,41.09290354680658,-83.02762924994363,52175.448775078636,39561.99122492137,45085.63276118512,47.46581761112804,2171.6092052364047,65551650.0,-5.511421235124839,0.02732769837035387,4.9466053284353535,4.9466053284353535,44728.925,49542.15,45425.98891140327,46172.2,43901.0,0,611.0,3.128193837846315,21540479090.113544
2022-01-13,42560.0,43900.0,44404.7,42337.5,53420.0,67527.9,0.1,43064.73333333333,36.99826892821475,-28.472481609435363,51494.92616148906,39419.90383851093,44845.096307738924,32.32507988122254,2164.1514048623753,65498230.0,-9.68374455948544,-0.030546001230040365,5.0849422106728746,5.0849422106728746,44607.425,49542.15,44623.93046380681,46172.2,43901.0,0,612.0,3.1285177864057236,21614873413.041763
2022-01-14,43073.3,42562.2,43435.1,41848.7,50500.0,67527.9,0.1,43178.1,39.48395364348072,57.99580166451324,50761.042870334175,39420.47712966583,44676.35380223997,40.935268371343035,2122.883447372206,65548730.0,-6.807083590259516,0.012060620300752056,4.928536813692486,4.928536813692486,43953.75,49542.15,44243.6,46172.2,43901.0,0,613.0,3.128844203773747,21689970896.86816
2022-01-15,43097.0,43073.6,43777.9,42586.1,31440.0,67527.9,0.1,42910.1,39.60244173539426,128.55649743357435,49794.20689647768,39619.02310352233,44525.9391544076,41.22261424120078,2056.37748684562,65580170.0,-9.721814906363903,0.0005502248492685879,4.771509587316101,4.771509587316101,43953.75,49542.15,39697.0,46172.2,43901.0,0,614.0,3.1291703400295336,21765277771.04094
2022-01-16,43079.1,43079.2,43462.0,42643.3,28660.0,67527.9,0.1,43083.13333333333,39.53947308216604,182.49989619074813,48651.46330530828,40001.85669469171,44388.14494922593,43.03473724392415,1967.9719520709325,65551510.0,-8.946393922869145,-0.00041534213518346075,4.568275456244287,4.568275456244287,43953.75,49435.7,39778.618,46172.2,43901.0,0,615.0,3.1294959636013737,21840752204.816196
2022-01-17,42209.3,43080.5,43179.6,41559.4,41440.0,67527.9,0.1,42795.13333333333,36.502272982858265,168.4178710257056,48212.46034136251,39907.2696586375,44180.635906442505,32.17432508580506,1943.13109835158,65510070.0,-9.090850351710728,-0.020190765359536234,4.6035615334809625,4.6035615334809625,43953.75,49435.7,39858.60364,46172.2,43901.0,0,616.0,3.1298162775016616,21915516984.193317
2022-01-18,42364.6,42209.9,42674.2,41300.7,47320.0,67527.9,0.1,42550.99999999999,37.42648123413916,177.47265983025,47916.68554041502,39793.334459584985,44007.68010582893,36.43067846607667,1902.4431627550387,65557390.0,-7.576144319146207,0.003679283949271639,4.490643515470555,4.490643515470555,43953.75,49435.7,39936.9895672,46172.2,43901.0,0,617.0,3.1301370644375868,21990623943.716717
2022-01-19,41677.8,42365.3,42558.0,41160.9,53770.0,67527.9,0.1,42083.9,35.00028064972658,146.40913761326692,47457.31604381696,39708.15395618304,43785.786762416654,42.075748242241524,1866.34722255825,65503620.0,-4.025477883014511,-0.016211648404564127,4.478036802706117,4.478036802706117,44319.725000000006,49435.7,40013.807775855996,46172.2,43901.0,0,618.0,3.130453520360435,22065190375.916565
2022-01-20,40715.9,41683.6,43487.1,40568.3,65280.0,67527.9,0.1,41586.1,31.88289994235373,73.93870107709336,47175.723143437644,39439.386856562356,43493.41659456745,21.643265288782253,1941.5224209469463,65438340.0,-5.526074598294562,-0.023079433175455577,4.76846249486551,4.76846249486551,44171.575,49435.7,40089.08962033888,46172.2,43901.0,0,619.0,3.130763968696603,22138899266.636024
2022-01-21,36475.5,40698.1,41104.6,35503.9,155800.0,67527.9,0.1,39623.06666666666,22.407871744246492,-230.08049921640327,47115.2322431135,38373.6277568865,42825.04358556103,10.915872730541064,2202.892248022164,65282540.0,-12.206023583100457,-0.10414604613922329,6.039375054549394,6.039375054549394,41857.200000000004,47284.100000000006,43777.9,46172.2,43901.0,1,620.0,3.1310476364775877,22207890508.131733
2022-01-22,35075.2,36467.7,36749.8,34116.0,138090.0,67527.9,0.1,37422.19999999999,20.26601686959087,-481.51984293392024,47152.3422710739,37112.857728926094,42086.96324407902,9.322849339566684,2233.671373163438,65144450.0,-15.83029372240354,-0.038390152294005664,6.368235599977871,6.368235599977871,40678.425,45829.8,43612.42,35075.2,43901.0,1,621.0,3.1313215350110473,22275279863.940975
2022-01-23,36269.5,35072.9,36513.0,34655.2,70430.0,67527.9,0.1,35940.06666666666,26.701232857654304,-520.1434936444266,46853.97504254844,36395.15495745157,41532.919125595305,20.930729829813295,2206.8234179374786,65214880.0,-13.331007472227075,0.03404969893257914,6.08451568931879,6.08451568931879,40140.95,45829.8,43232.5632,35075.2,43901.0,0,622.0,3.131603086322917,22344299539.447876
2022-01-24,36686.3,36268.6,37424.0,32985.6,153770.0,67527.9,0.1,36010.333333333336,28.85916405375582,-471.78639669244785,46443.11075245812,35890.91924754188,41071.336351729085,32.407983116007436,2366.221745227659,65368650.0,-12.301289437323389,0.011491749265912121,6.449878415723741,6.449878415723741,39503.05,43416.399999999994,42867.900671999996,35075.2,43901.0,1,623.0,3.1318869963836384,22413973292.815884
2022-01-25,36950.6,36691.3,37501.8,35729.3,79680.0,67527.9,0.1,36635.46666666666,30.2612328539429,-380.1033082328263,46316.18432173333,35370.31567826667,40678.88527061203,34.72252629366588,2323.8130491399693,65448330.0,-13.531867494126345,0.007204324230025705,6.288972436550338,6.288972436550338,39503.05,42500.95,42274.96263168,35075.2,43901.0,0,624.0,3.132172245074165,22484114532.685783
2022-01-26,36800.4,36962.3,38862.6,36280.0,107870.0,67527.9,0.1,36812.43333333333,29.90058159720229,-291.6565959822833,46168.34837018905,34888.44162981096,40309.505721029935,33.407186205567896,2342.2978313442572,65340460.0,-16.17411904056855,-0.00406488663242266,6.364870575711833,6.364870575711833,39350.8,42500.95,41717.6008737792,35075.2,43901.0,0,625.0,3.1324561355228155,22554218683.00823
2022-01-27,37164.3,36800.1,37215.4,35543.2,83520.0,67527.9,0.1,36971.76666666666,32.014621396921484,-176.40149910103582,46112.12410535392,34506.42589464608,40009.96231902709,38.71927207360807,2294.4337005339535,65423980.0,-12.677866541353378,0.009888479473049161,6.173757343832531,6.173757343832531,39350.8,42500.95,41193.68082135245,35075.2,43901.0,0,626.0,3.132742001482777,22624913481.971184
2022-01-28,37745.1,37195.6,37995.9,36176.5,69450.0,67527.9,0.1,37236.6,35.3650135443187,-36.14118274565726,45983.402477101554,34242.45752289845,39794.26114578641,44.10088674332625,2260.5027219243852,65493430.0,-12.37007612604561,0.015627900969478636,5.98886404307946,5.98886404307946,39253.575,42500.95,40701.195972071306,35075.2,43901.0,0,627.0,3.13303119814972,22696459846.387974
2022-01-29,38170.8,37736.5,38663.7,37350.2,42770.0,67527.9,0.1,37693.4,37.78512882448554,102.62349659994698,45800.960910512105,34057.14908948791,39639.64579856866,49.375803456649095,2192.8596703583576,65536200.0,-11.430494001902677,0.011278285128400789,5.7448617015057515,5.7448617015057515,38645.3,42500.95,40238.260213747024,35075.2,43901.0,0,628.0,3.1333226948796185,22768668646.827316
2022-01-30,37917.7,38167.5,38313.3,37390.6,34100.0,67527.9,0.1,37944.53333333333,36.90047466736965,189.62313594729085,45599.39883086168,33867.26116913832,39475.65096060973,46.96567157072798,2102.133979618475,65502100.0,-11.981215949265426,-0.006630722961006974,5.543938529020682,5.543938529020682,37963.3,42500.95,39803.100600922204,35075.2,43901.0,0,629.0,3.133612212874641,22840729084.221123
2022-01-31,38498.6,37923.8,38701.4,36672.8,61270.0,67527.9,0.1,38195.69999999999,40.3522355399354,292.40852836480735,45243.18306660028,33800.01693339972,39382.59848817071,52.4972622958625,2096.88155250287,65563370.0,-8.791190567007755,0.015320022047750737,5.446643650685661,5.446643650685661,37309.625,42500.95,39394.05056486687,35075.2,43901.0,0,630.0,3.13390498410673,22913638871.041393
2022-02-01,38709.7,38475.6,39230.0,38037.9,55200.0,67527.9,0.1,38375.33333333332,41.60243945627705,375.43371460643675,44625.152030338526,33898.91796966148,39318.512917868735,54.50745131647859,2032.254298752665,65618570.0,-8.627250109761455,0.005483316276436057,5.249987209285179,5.249987209285179,37401.475,42500.95,32985.6,35075.2,43901.0,0,631.0,3.1341986764525935,22986957265.352604
2022-02-02,36890.2,38711.2,38853.8,36682.3,53740.0,67527.9,0.1,38032.83333333332,34.8268198889905,311.2774314542603,44212.22091525375,33744.86908474625,39087.24502092886,37.18135504451744,2042.2004202703317,65564830.0,-11.48717062800821,-0.04700372258116181,5.535888719145822,5.535888719145822,38040.875,42500.95,33110.488,35075.2,43901.0,0,632.0,3.1344804662713175,23058218420.668934
2022-02-03,37287.8,36890.2,37304.3,36297.3,50350.0,67527.9,0.1,37629.23333333333,37.232532910967365,299.0145112599232,43616.23290958307,33762.307090416936,38915.86930464992,52.98928439462994,1968.257533108165,65615180.0,-8.419560908637653,0.010777930181999684,5.27855634579719,5.27855634579719,38040.875,42500.95,33232.87824,35075.2,43901.0,0,633.0,3.1347644404898602,23130121255.76392
2022-02-04,41567.6,37287.8,41689.0,37041.1,95490.0,67527.9,0.1,38581.86666666666,56.04194302696505,566.9916080835126,43305.65764071395,33919.942359286055,39168.41508515945,98.60514281774937,2159.660566457582,65710670.0,13.960329536264062,0.11477748754284223,5.19553827129202,5.19553827129202,38655.625,42500.95,33352.8206752,35075.2,43901.0,0,634.0,3.135074009356269,23207205118.07795
2022-02-05,41412.1,41566.5,41899.8,40963.3,46320.0,67527.9,0.1,40089.166666666664,55.39243779579342,712.2271433000417,42953.56266877407,34105.33733122592,39382.099362763314,94.52895380404294,2072.2919545677546,65664350.0,18.066611166864345,-0.0037408943504074754,5.00407357890026,5.00407357890026,38866.649999999994,42500.95,33686.267848191994,35075.2,43901.0,0,635.0,3.1353822838465324,23284293595.071945
2022-02-06,42392.2,41411.9,42614.8,41176.3,31200.0,67527.9,0.1,41790.633333333324,58.64567051685374,843.7651881570864,42993.74333534275,34083.44666465724,39668.775613928716,97.68828147717355,2027.0211006700579,65695550.0,16.881126014971247,0.02366699587801624,4.7815897751710414,4.7815897751710414,39075.6,42500.95,34179.079777300474,35075.2,43901.0,0,636.0,3.1356957500356537,23362649971.8992
2022-02-07,43833.9,42385.2,44468.3,41695.4,76600.0,67527.9,0.1,42546.06666666666,62.928546057166265,987.3575918318536,43356.22972942656,33867.890270573436,40065.45412688788,92.89195639264545,2080.298164907911,65772150.0,19.483022272619476,0.03400861479234396,4.745866019012479,4.745866019012479,39554.875,42500.95,34853.93739511644,35075.2,43901.0,0,637.0,3.1360168042837797,23442754381.59146
2022-02-08,44038.2,43833.9,45399.8,42705.0,92880.0,67527.9,0.1,43421.43333333333,63.505341638135526,1049.7597181243364,43874.0355062624,33586.1244937376,40443.810876708085,86.18590589046929,2124.1911531287747,65865030.0,19.18128528359485,0.0046607762485197934,4.823519474294533,4.823519474294533,40020.625,42500.95,35815.373655604795,35075.2,43901.0,0,638.0,3.1363385626407876,23523271164.50564
2022-02-09,44388.9,44038.2,44800.4,43163.0,50920.0,67527.9,0.1,44086.99999999999,64.5256897099099,1064.9524201365157,44565.37768049169,33262.0823195083,40819.53365035493,89.7439279264655,2089.4203564767195,65915950.0,20.620699775002443,0.00796354074417227,4.707078473394743,4.707078473394743,40020.625,42500.95,36965.50481693222,35075.2,43901.0,0,639.0,3.136661808134625,23604357002.68748
2022-02-10,43521.0,44388.9,45755.2,43242.5,89690.0,67527.9,0.1,43982.69999999999,60.05104823007272,969.5632959526812,45139.77083342467,33392.239166575324,41076.816159844944,76.67533172559953,2119.6546167283823,65826260.0,17.104317853423844,-0.019552185343633233,4.870417997583655,4.870417997583655,40198.325,42500.95,37977.62023890035,35075.2,43901.0,0,640.0,3.1369799321438663,23684709045.923794
2022-02-11,42388.4,43519.3,43915.1,42023.4,69950.0,67527.9,0.1,43432.76666666666,54.71831502568728,790.7617144614488,45324.08073684731,33939.24926315268,41201.728906526376,64.40224574165515,2103.372144104926,65756310.0,12.301729231079008,-0.026024218193515747,4.962140925595036,4.962140925595036,40198.325,42500.95,39066.4814054543,35075.2,43901.0,0,641.0,3.1372913589092692,23764005172.863907
2022-02-12,42205.2,42388.4,43006.4,41776.8,37880.0,67527.9,0.1,42704.86666666666,53.88477032393216,627.8380791817152,45506.53724904934,34350.362750950655,41297.29758209529,62.46524069825223,2040.9598480974312,65718430.0,10.569335722594218,-0.004321937133744291,4.835801863508362,4.835801863508362,40384.274999999994,42500.95,40002.9020086907,35075.2,43901.0,0,642.0,3.1376013530975086,23843280911.201138
2022-02-13,42061.1,42205.5,42725.1,41880.1,25880.0,67527.9,0.1,42218.23333333333,53.198307238326805,484.4714598345606,45640.85645631479,34753.523543685216,41370.04066951479,60.94164666575031,1955.5341446619004,65692550.0,10.927350551325638,-0.0034142712272421383,4.649270096744737,4.649270096744737,41364.825,42500.95,40808.223727474,35075.2,43901.0,0,643.0,3.1379101334580786,23922577959.709248
2022-02-14,42550.3,42061.1,42799.7,41591.3,53600.0,67527.9,0.1,42272.19999999999,55.281115375981166,400.18983232012886,45798.762554058165,35155.58744594184,41482.44632003719,66.11404222924754,1902.1674200431928,65746150.0,10.524278804943568,0.011630699149570711,4.470397200591282,4.470397200591282,41418.075,42500.95,41500.80040562763,35075.2,43901.0,0,644.0,3.1382212746564644,24002611181.260895
2022-02-15,44544.4,42550.3,44722.6,42460.1,56340.0,67527.9,0.1,43051.93333333333,62.5895702562781,452.4868039042961,46186.43547461945,35542.31452538055,41774.06095622413,87.19800378519548,1927.905461468679,65802490.0,15.072966207436393,0.04686453444511551,4.328053495992042,4.328053495992042,41521.825,42500.95,41880.1,35075.2,44544.4,0,645.0,3.1385429375223626,24085027442.197224
2022-02-16,43883.6,44540.9,44552.9,43377.6,41400.0,67527.9,0.1,43659.43333333333,59.14030982141273,417.18627714493505,46392.4369453205,36008.24305467949,41974.969436583735,80.21125196925321,1874.1479285066307,65761090.0,18.9573382632786,-0.014834636901608356,4.270725119421905,4.270725119421905,41521.825,42500.95,41591.3,35075.2,44544.4,0,646.0,3.1388606317213594,24166925221.220943
2022-02-17,40552.8,43885.5,44167.1,40103.8,72630.0,67527.9,0.1,42993.6,45.52235368704694,157.48783310659127,46298.05934574535,36383.39065425465,41839.52472833766,40.29905555364301,2030.5159336132997,65688460.0,8.75621516957289,-0.07590079209545242,5.007091825011589,5.007091825011589,41149.95,41844.7,45755.2,35075.2,44544.4,0,647.0,3.1391591108330554,24245210204.079395
2022-02-18,40000.1,40532.5,40935.5,39505.0,64959.99999999999,67527.9,0.1,41478.83333333333,43.723209534388346,-52.31215138062896,46216.69317249413,36647.68682750586,41664.34142087693,7.92134651691144,1987.657652640921,65623500.0,-3.7709658484011586,-0.013629145213154281,4.9691317087730305,4.9691317087730305,41000.25,40769.75,45642.172,35075.2,44544.4,0,648.0,3.1394539310922216,24323004753.857834
2022-02-19,40090.3,40000.1,40434.3,39666.6,25780.0,67527.9,0.1,40214.4,44.111418975070805,-178.69108020710695,46094.2883991883,36987.3516008117,41514.43271412675,9.3645003359893,1900.517820309427,65649280.0,-3.191820748042228,0.0022549943625143065,4.740592662837212,4.740592662837212,41381.5,40769.75,45396.68512,35075.2,44544.4,0,649.0,3.1397489014532853,24401078631.77589
2022-02-20,38355.0,40089.6,40120.3,38042.2,47920.0,67527.9,0.1,39481.799999999996,38.59540801366736,-362.2501873813511,46106.68467085184,36960.59532914816,41213.534360400394,4.055490729936508,1913.2022617158968,65601360.0,-9.523450068644697,-0.04328478459876839,4.988143036672916,4.988143036672916,41015.799999999996,40769.75,45161.0177152,35075.2,44544.4,0,650.0,3.1400329472790807,24477168968.320206
2022-02-21,37017.7,38355.0,39444.1,36868.9,91820.0,67527.9,0.1,38487.666666666664,34.96658132577525,-545.8011792125809,46283.0780960028,36615.00190399719,40813.931087981306,1.6744876945409868,1960.4878144504753,65509540.0,-15.550065132237844,-0.03486637987224617,5.296082183524302,5.296082183524302,40722.475,40465.25,44733.888652288006,37017.7,44544.4,0,651.0,3.1403081648640625,24551685311.69595
2022-02-22,38248.2,37018.3,38414.9,36399.6,82750.0,67527.9,0.1,37873.633333333324,40.5092333390816,-554.610049765939,46125.839389833374,36908.04061016663,40569.5757462688,19.75928855444866,1964.4029705611558,65592290.0,-13.14767633554505,0.033240855050421736,5.135935731776021,5.135935731776021,40763.475,40465.25,44104.68956010496,37017.7,44544.4,0,652.0,3.140590794227553,24627951871.36852
2022-02-23,37224.6,38248.2,39194.5,37099.5,64840.0,67527.9,0.1,37496.83333333332,37.635711503090086,-596.019495991306,46134.34545786405,36893.214542135946,40251.00662757653,8.818247894309293,1973.7313298067875,65527450.0,-16.13984577225388,-0.026762043704017358,5.302223072395103,5.302223072395103,40793.675,40270.8,43334.180604094465,37017.7,44544.4,0,653.0,3.140866590620235,24703044486.70427
2022-02-24,38339.2,37250.2,39351.6,34357.4,180470.0,67527.9,0.1,37937.33333333332,42.42496813796542,-517.8782221041387,46175.264913183186,36529.455086816815,40068.929805902575,38.41508123335774,2189.4790919634456,65707920.0,-11.906435973438118,0.029942564863020715,5.7108105854150475,5.7108105854150475,39755.725000000006,40245.5,42640.72254368502,37017.7,44544.4,1,654.0,3.1411490341962565,24779740676.628365
2022-02-25,39209.6,38339.2,39683.7,38042.6,83780.0,67527.9,0.1,38257.799999999996,45.9177496446377,-383.3050919123739,46154.410897614674,36330.05910238533,39987.08887200709,46.81241075907844,2150.3091568231994,65791700.0,-7.499221485123295,0.02270261246974381,5.484139488347751,5.484139488347751,39659.275,40002.5,41646.72383844282,37017.7,44544.4,0,655.0,3.1414364406808004,24857704359.88023
2022-02-26,39115.5,39221.6,40094.5,38639.1,41550.0,67527.9,0.1,38888.1,45.595704624497806,-281.09462022484183,46044.507215113925,36112.29278488608,39904.08040800642,45.90456527611624,2100.672788478685,65750150.0,-7.320661908959079,-0.0023999224679669418,5.370435731305199,5.370435731305199,38851.375,39370.399999999994,40772.00497782968,37017.7,44544.4,0,656.0,3.141722895385073,24935714121.922405
2022-02-27,37689.1,39116.6,39838.5,37062.3,66140.0,67527.9,0.1,38671.399999999994,40.91167490546679,-288.91007974471745,45777.51097147679,35764.8090285232,39693.12989295819,32.143132790491244,2148.9247321587786,65684010.0,-10.394402428847558,-0.036466362439442235,5.7017141087443814,5.7017141087443814,38726.075000000004,39370.399999999994,40094.5,37017.7,44544.4,0,657.0,3.142000138383723,25012043068.2752
2022-02-28,43188.2,37707.2,43977.8,37458.9,108070.0,67527.9,0.1,39997.6,58.578442777840124,77.34975319504144,45636.81968053269,35820.50031946732,40025.993712676456,85.19661945741518,2461.0658227188655,65792080.0,1.4991668683886932,0.1459069067714538,5.698468152687228,5.698468152687228,39611.950000000004,39370.399999999994,34357.4,37017.7,44544.4,0,658.0,3.1423093823074617,25095311943.682384
2022-03-01,44420.3,43187.2,44900.5,42876.6,90670.0,67527.9,0.1,41765.86666666666,61.36564280442178,386.3865195036574,45643.08979816305,35817.370201836944,40444.49907337394,95.44536236970154,2429.839692524661,65882750.0,-0.27859843212614505,0.02852862587466043,5.470110945951875,5.470110945951875,39842.625,39370.399999999994,34549.808000000005,37017.7,44544.4,0,659.0,3.142624915438858,25180180163.720867
2022-03-02,43912.8,44420.3,45294.2,43361.3,80820.0,67527.9,0.1,43840.43333333333,59.5870824409339,531.4588972808456,45709.933632408705,35789.706367591294,40774.813447338325,87.36924877477877,2394.344000201471,65801930.0,0.06653966402028176,-0.011424956607677172,5.452496766777502,5.452496766777502,39941.05,39370.399999999994,34963.835680000004,37017.7,44544.4,0,660.0,3.1429373186532494,25264674152.739033
2022-03-03,42463.0,43912.8,44077.2,41840.8,74110.0,67527.9,0.1,43598.700000000004,54.708900020084656,504.80995213541644,45718.6965088159,35788.40349118411,40935.59311902039,74.11308609465293,2383.062285901365,65727820.0,4.710402241028972,-0.0330154305806053,5.612091199164838,5.612091199164838,39941.05,39370.399999999994,35583.6575392,37017.7,44544.4,0,661.0,3.1432413497816833,25347678096.57101
2022-03-04,39142.7,42463.0,42848.7,38594.9,3210000000.0,67527.9,0.1,41839.49999999999,45.51826484508923,251.40488615235108,45565.94620038841,35634.903799611595,40764.8413933994,43.7541145490454,2516.6864083369815,-3144272180.0,-2.1434946412634006,-0.07819277959635451,6.429516636146667,6.429516636146667,39941.05,39370.399999999994,36166.290086848,37017.7,44544.4,1,662.0,3.143525654474071,25426763306.96687
2022-03-05,39395.8,39142.8,39600.2,38626.1,1500000000.0,67527.9,0.1,40333.833333333336,46.25938677615969,96.63042621171009,45411.740117422174,35522.57988257782,40634.456498789936,46.068319801038726,2406.50166488434,-1644272180.0,-1.7323392441563172,0.006466084352893642,6.108523408293117,6.108523408293117,40617.275,39370.399999999994,36713.96468163712,37017.7,44544.4,1,663.0,3.1438111120303933,25506339899.4853
2022-03-06,38403.1,39396.3,39668.1,38115.0,1930000000.0,67527.9,0.1,38980.53333333333,43.7458450196285,-67.93503358286833,45185.351151293304,35334.2488487067,40421.946356048036,36.99162460683197,2345.544403106887,-3574272180.0,0.12540737843827024,-0.025198117565832012,6.107695480591116,6.107695480591116,40617.275,39370.399999999994,37228.77880073889,37017.7,44544.4,1,664.0,3.144090133806074,25584788818.798656
2022-03-07,38024.8,38420.6,39532.0,37182.1,3020000000.0,67527.9,0.1,38607.9,42.79162609406487,-190.6460987357865,44534.19910072711,35333.440899272886,40193.64670309108,33.532660375978374,2345.8555171706807,-6594272180.0,2.7205904202584326,-0.009850767255768278,6.169277727090427,6.169277727090427,40617.275,39370.399999999994,45294.2,37017.7,44544.4,1,665.0,3.144366432965181,25662894157.13222
2022-03-08,38744.8,38020.6,39351.5,37886.6,2670000000.0,67527.9,0.1,38390.9,45.239879943417655,-210.1654621822473,43926.823119431945,35426.936880568064,40055.66130279669,40.11593884865777,2282.930123087061,-3924272180.0,1.298361752971397,0.018935010835033905,5.892223274057579,5.892223274057579,40531.975,39370.399999999994,45131.958,37017.7,44544.4,1,666.0,3.1446468111038506,25742114091.16866
2022-03-09,41929.0,38731.5,42538.5,38663.3,3600000000.0,67527.9,0.1,39566.2,54.51141766444567,-6.2445320885993,44093.56752628876,35397.812473711245,40234.07451205415,69.23048789408239,2396.6636857236995,-324272180.0,12.63787925189257,0.08218393177923233,5.716004879018578,5.716004879018578,40531.975,39370.399999999994,44972.96084,37017.7,41929.0,1,667.0,3.1449455489264597,25825538875.78943
2022-03-10,39416.3,41933.9,42029.1,38603.5,3620000000.0,67527.9,0.1,40030.03333333333,47.65467466120549,-36.51404333177143,44064.99231619499,35368.00768380501,40156.19122519185,28.596071380847697,2470.1591367434353,-3944272180.0,2.8093961272014174,-0.059927496482148346,6.266846803843677,6.266846803843677,40531.975,39370.399999999994,44817.1436232,37017.7,41929.0,1,668.0,3.1452292450676835,25905977025.07962
2022-03-11,38730.2,39422.5,40177.0,38236.4,2790000000.0,67527.9,0.1,40025.166666666664,45.95489119555036,-95.33024076458486,44013.98454344262,35283.005456557374,40020.38253707834,20.261422028936156,2432.333484118904,-6734272180.0,-1.2226597567942583,-0.01740650441568603,6.280198615341269,6.280198615341269,40227.725,39370.399999999994,44664.442750735994,37017.7,41929.0,1,669.0,3.145508401876808,25985679007.596424
2022-03-12,38814.3,38730.2,39355.3,38666.5,1110000000.0,67527.9,0.1,38986.93333333333,46.208169316798624,-119.5860642268633,44014.26321746298,35328.656782537015,39905.51753354706,21.283057374360734,2307.795378110411,-5624272180.0,-0.7700272270583198,0.0021714321124084446,5.945734891806398,5.945734891806398,39920.6,39370.399999999994,44514.795895721276,37017.7,41929.0,0,670.0,3.145787699899854,26065655849.112015
2022-03-13,37792.4,38813.2,39272.3,37603.4,1550000000.0,67527.9,0.1,38445.63333333333,43.53818513147574,-191.21835983557082,43970.66716325924,35449.72283674076,39704.268244637824,7.523329347517943,2262.1599939596676,-7174272180.0,0.2740845496443346,-0.026327925532600105,5.985753733448174,5.985753733448174,39843.05,39370.399999999994,44368.14197780685,37792.4,41929.0,0,671.0,3.1460603025253886,26144414936.65699
2022-03-14,39671.1,37789.5,39914.3,37613.6,2330000000.0,67527.9,0.1,38759.26666666666,49.33430849242906,-103.24488605722536,43988.97549010686,35573.704509893134,39701.10936419613,30.68256061932176,2264.9128515339776,-4844272180.0,-8.143659610727001,0.049711053015950135,5.7092262416065545,5.7092262416065545,39843.05,39370.399999999994,44224.42113825071,37792.4,41929.0,0,672.0,3.146344030921246,26225848991.35521
2022-03-15,39285.7,39673.0,39854.7,38220.9,2250000000.0,67527.9,0.1,38916.399999999994,48.24027277791861,-64.09957963935409,43934.51388737933,35834.27611262066,39661.54656760602,25.93163299268992,2219.8333621386932,-7094272180.0,-11.559129497099311,-0.009714880605781073,5.650486976530121,5.650486976530121,39843.05,39370.399999999994,44083.5747154857,37792.4,41929.0,0,673.0,3.146625071224164,26306944674.3774
2022-03-16,41118.7,39282.5,41701.6,38953.2,4470000000.0,67527.9,0.1,40025.166666666664,53.51970008244627,84.10831710990783,44042.49715006714,36004.24284993287,39800.32308497687,57.0927180171426,2257.58812198593,-2624272180.0,-6.362837259295707,0.0466581987847996,5.490417065680408,5.490417065680408,39948.375,39370.399999999994,43945.54522117599,37792.4,41929.0,1,674.0,3.146916536432187,26390589106.06628
2022-03-17,40914.8,41118.7,41406.0,40557.8,1900000000.0,67527.9,0.1,40439.73333333333,52.873639146523516,162.72333043761813,44127.4346910004,36089.82530899961,39906.4637435505,65.87195143472286,2156.9175418440777,-4524272180.0,-3.645997692108417,-0.004958814359403263,5.271729403159926,5.271729403159926,39948.375,40056.3,43810.27631675247,37792.4,41929.0,0,675.0,3.14720644369347,26474153821.77634
2022-03-18,41767.8,40914.6,42308.4,40234.8,2310000000.0,67527.9,0.1,41267.1,55.30439383196974,260.6757532743777,44295.10140716427,36187.388592835734,40083.73386321236,85.61160480920027,2150.9662888552148,-2214272180.0,6.706486777866642,0.020848201628750562,5.149819451479884,5.149819451479884,39890.850000000006,40056.3,43677.71279041742,37792.4,41929.0,0,676.0,3.147500854926353,26558981864.11469
2022-03-19,42233.0,41768.0,42386.0,41529.6,224590000.0,67527.9,0.1,41638.53333333333,56.618578405738845,340.27103910023436,44433.03459133046,36503.84540866954,40288.42587623975,94.29654245388693,2058.4972682226994,-1989682180.0,7.201782931175396,0.011137766413361394,4.8741440774339955,4.8741440774339955,39910.25,40056.3,43547.80053460907,37792.4,41929.0,0,677.0,3.1477975042492536,26644579166.79486
2022-03-20,41276.0,42241.0,42301.0,40922.0,308450000.0,67527.9,0.1,41758.93333333333,53.15599157892171,312.6508826671936,44158.65315017576,36587.00684982424,40382.48055469311,76.43006496900904,2009.9617490639353,-2298132180.0,7.480906489319877,-0.022660005209196643,4.869565241457349,4.869565241457349,39910.25,40056.3,43420.486523916894,37792.4,41929.0,0,678.0,3.148088346684562,26729154134.745934
2022-03-21,41022.0,41282.0,41532.0,40530.0,406620000.0,67527.9,0.1,41510.33333333333,52.24277371022509,263.42928143437115,43523.284580800726,36882.545419199276,40443.387168531866,69.27113938927276,1937.964481273654,-2704752180.0,7.88222423260608,-0.0061536970636689725,4.7242076965376,4.7242076965376,39910.25,40056.3,43295.71879343856,37792.4,41929.0,0,679.0,3.1483773489880185,26813584173.84907
2022-03-22,42373.0,41022.0,43327.9,40893.0,537060000.0,67527.9,0.1,41556.99999999999,56.52139720681301,305.0755325707428,43157.48379895258,37094.36620104743,40627.15981914788,83.31906716743818,1973.4598754683932,-2167692180.0,9.364353410005979,0.03293354785237179,4.657352265519064,4.657352265519064,40824.5,40056.3,37182.1,37792.4,41929.0,0,680.0,3.1486736347149034,26899917457.25089
2022-03-23,42912.0,42373.0,43027.0,41795.0,433960000.0,67527.9,0.1,42102.33333333333,58.132988948018806,348.97755599843765,43254.56102332616,37042.18897667384,40844.7636458957,92.73473665822341,1920.4984557920795,-1733732180.0,2.3444394094779266,0.012720364382979632,4.47543450734545,4.47543450734545,40976.325,40056.3,37305.015999999996,37792.4,41929.0,0,681.0,3.1489725249248406,26987115295.747814
2022-03-24,44013.0,42911.0,44251.0,42658.0,491660000.0,67527.9,0.1,43099.33333333333,61.289393537580104,427.0621738085381,43884.164649509505,36899.615350490494,41146.50044152468,96.41976051507311,1897.105708949788,-1242072180.0,11.661926664856917,0.025657158836688954,4.310330377274415,4.310330377274415,41390.175,40056.3,37425.473679999996,37792.4,41929.0,0,682.0,3.1492770173245628,27075862784.94358
2022-03-25,44331.0,44013.0,45112.0,43622.0,494090000.0,67527.9,0.1,43752.0,62.17636262620396,471.53586300716756,44493.166662048134,36784.13333795187,41449.78611376043,89.59859361265748,1868.026729739089,-747982180.0,14.461066557879906,0.007225138027401101,4.213815907015608,4.213815907015608,41955.774999999994,40056.3,37698.4947328,37792.4,41929.0,0,683.0,3.149582821538192,27165199182.918663
2022-03-26,44548.0,44331.0,44818.0,44090.0,196300000.0,67527.9,0.1,44297.333333333336,62.80269843562069,485.091179367664,45012.43744560495,36879.35255439506,41744.854102926096,92.48861305702795,1786.5962490434397,-551682180.0,14.772132951000009,0.004894994473393366,4.010497102099846,4.010497102099846,41955.774999999994,40056.3,38143.305048832,37792.4,41929.0,0,684.0,3.149889389190507,27255003476.67583
2022-03-27,46859.0,44542.0,46947.0,44445.0,388790000.0,67527.9,0.1,45246.0,68.7396405389668,611.0854336514834,45974.84158795865,36800.368412041345,42231.91561693314,99.05714959178863,1837.6965169689083,-162892180.0,23.990537780082764,0.051876627458022906,3.9217578628842023,3.9217578628842023,42901.525,40652.2,38561.42674590208,37792.4,41929.0,0,685.0,3.15020751162484,27347745337.05722
2022-03-28,47105.0,46859.0,48199.0,46672.0,610270000.0,67527.9,0.1,46170.666666666664,69.3013230248697,667.7731458195901,46853.84711997096,36757.38288002905,42696.01889151093,89.03598881550596,1815.5039086139861,447377820.0,18.73883002992103,0.005249791928978453,3.8541639074705154,3.8541639074705154,43527.525,41278.2,39232.27260622991,37792.4,41929.0,0,686.0,3.150526471849186,27440994313.621212
2022-03-29,47449.0,47126.0,48127.0,47029.0,478820000.0,67527.9,0.1,47137.666666666664,70.11010111777917,682.7813375147625,47698.23832875425,36464.99167124576,43148.68375898608,91.88820870016656,1764.2536294272727,926197820.0,20.779316647024242,0.007302834094045307,3.7182103509605526,3.7182103509605526,43527.525,41278.2,40128.94534560692,37792.4,47449.0,0,687.0,3.1508467507485944,27534864152.838917
2022-03-30,47075.0,47449.0,47714.0,46601.0,467760000.0,67527.9,0.1,47209.666666666664,68.01215608177255,623.5015796337123,48340.42429256331,36588.6757074367,43522.61863908265,85.88684362522288,1717.7355130396104,458437820.0,14.485623329531341,-0.007882147147463603,3.648933644268955,3.648933644268955,43618.275,41278.2,40935.95081104623,37792.4,47449.0,0,688.0,3.1511647620378795,27628530690.593285
2022-03-31,45525.0,47071.0,47624.0,45228.0,520000000.0,67527.9,0.1,46683.0,59.99902113111468,444.29645814736296,48561.754935855555,37046.82506414445,43713.32162583668,66.42475075964943,1766.182976393924,-61562180.0,11.26780529295022,-0.03292618162506633,3.8795891848301465,3.8795891848301465,43843.775,41278.2,41662.25572994161,37792.4,47449.0,0,689.0,3.151474474951817,27720591910.303165
2022-04-01,46297.0,45529.0,46728.0,44261.0,632930000.0,67527.9,0.1,46299.0,62.37664792486205,346.490644568873,48821.499967028714,37535.35003297129,43959.38623289985,75.19885252314513,1816.2413352229294,571367820.0,10.843760025665697,0.016957715540911522,3.9230216541523846,3.9230216541523846,44059.525,41278.2,42315.93015694745,37792.4,47449.0,0,690.0,3.1517877625893913,27813790392.649914
2022-04-02,45811.0,46299.0,47212.0,45641.0,345930000.0,67527.9,0.1,45877.666666666664,59.96040135451491,223.75913923517578,48754.8310930668,38403.87890693319,44135.730401195106,68.86165080192984,1798.7240969927202,225437820.0,8.472047924608718,-0.010497440438905326,3.9264021675857768,3.9264021675857768,44405.85,41278.2,42904.237141252706,37792.4,47449.0,0,691.0,3.1520981666675496,27906628671.38199
2022-04-03,46407.0,45813.0,47435.0,45554.0,398860000.0,67527.9,0.1,46171.666666666664,61.90905920451561,160.37920142457642,48903.739911170116,38928.56008882989,44352.04179155747,76.63319859173295,1804.600947207526,624297820.0,12.430952611687179,0.013009975770011506,3.8886395311214383,3.8886395311214383,44522.85,41278.2,43433.71342712743,37792.4,47449.0,0,692.0,3.1524112262187134,28000397757.156395
2022-04-04,46629.0,46407.0,46899.0,45152.0,446120000.0,67527.9,0.1,46282.333333333336,62.63845309826442,113.28881446769151,48922.33538765792,39644.294612342084,44568.89495426629,78.51081303038599,1800.4865938355597,1070417820.0,13.668275559455903,0.004783761070528136,3.8613021806934733,3.8613021806934733,44565.6,41278.2,43910.24208441469,37792.4,47449.0,0,693.0,3.152725016593617,28094652868.337208
2022-04-05,45506.0,46614.0,47201.0,45388.0,421110000.0,67527.9,0.1,46180.666666666664,56.72148186936754,-7.216007656568536,48932.58521867069,40072.77478132931,44658.143053859974,57.94815740162399,1801.380408561591,649307820.0,7.393859297193968,-0.024083724720667443,3.958555813654443,3.958555813654443,44565.6,41278.2,44339.11787597322,37792.4,47449.0,0,694.0,3.1530326666568427,28187777246.04678
2022-04-06,43173.0,45494.0,45519.0,43122.0,649520000.0,67527.9,0.1,45102.666666666664,46.82546930103731,-244.62144004752463,48781.17504601764,40450.00495398237,44516.70085825426,9.294351200144378,1843.9246650929058,-212180.0,0.6082214765100671,-0.0512679646640003,4.271013515606759,4.271013515606759,44262.85,41278.2,48199.0,37792.4,47449.0,0,695.0,3.1533275255123314,28278184720.185364
2022-04-07,43448.0,43166.0,43893.0,42747.0,390850000.0,67527.9,0.1,44042.333333333336,47.97761023501777,-375.85871617250586,48696.416202930246,40702.78379706975,44414.91982413481,12.85766691122524,1794.0729033005555,390637820.0,-1.2837116306545793,0.006369721816876339,4.129241629765595,4.129241629765595,44065.85,41278.2,48097.46,37792.4,47449.0,0,696.0,3.15362349910145,28369145632.122456
2022-04-08,42275.0,43450.0,43979.0,42113.0,467830000.0,67527.9,0.1,42965.33333333333,43.634671948769714,-525.2234930605784,48693.37083312311,40710.029166876884,44211.11793612197,2.6618468616496878,1799.2105530648016,-77192180.0,-4.637838081703548,-0.026997790462161664,4.255968191755888,4.255968191755888,43887.4,41278.2,47883.4416,42275.0,47449.0,0,697.0,3.1539126450068893,28458773247.270664
2022-04-09,42767.0,42275.0,42809.0,42129.0,165160000.0,67527.9,0.1,42829.99999999999,45.84881063379634,-570.6667869819687,48559.467407182114,40993.032592817886,44073.58289458654,10.745974367400592,1719.2669421316016,87967820.0,-3.9979348118883005,0.011638083973979807,4.02007842993804,4.02007842993804,43991.975,41278.2,47537.215103999995,42275.0,47449.0,0,698.0,3.1542041386403437,28549243480.061504
2022-04-10,42138.0,42760.0,43421.0,41884.0,255830000.0,67527.9,0.1,42393.33333333333,43.49638362326278,-618.83083221273,48420.012289378996,41244.08771062101,43889.24166653068,4.022169437846397,1706.2478748364872,-167862180.0,-10.07490556776713,-0.014707601655482017,4.049190457156218,4.049190457156218,44117.8,41278.2,47211.76219775999,42275.0,47449.0,0,699.0,3.15449176588848,28639074258.607395
2022-04-11,39497.0,42144.0,42418.0,39202.0,608380000.0,67527.9,0.1,41467.33333333333,35.30546734260024,-793.1660517741021,48844.44127928513,40532.05872071487,43470.9329363849,3.3053221288515404,1814.0873123481667,-776242180.0,-16.151151682411633,-0.06267502017181636,4.592974940750352,4.592974940750352,43509.5,41278.2,46785.541221939195,42275.0,47449.0,0,700.0,3.154763784221338,28725436576.335915
2022-04-12,40078.0,39507.0,40678.0,39265.0,468270000.0,67527.9,0.1,40570.99999999999,38.06848375135906,-830.0156800858663,49108.72914926692,39984.37085073309,43147.79646625301,10.291353383458647,1785.438218609012,-307972180.0,-15.534573963624101,0.014709977973010657,4.454908474996287,4.454908474996287,43451.0,41278.2,46027.18709974528,42275.0,47449.0,0,701.0,3.1550388741621567,28812798192.204636
2022-04-13,41133.0,40072.0,41515.0,39581.0,406700000.0,67527.9,0.1,40235.99999999999,42.84215737650187,-746.618938654276,49198.80522569492,39606.29477430508,42955.91108851463,22.92804559487058,1796.049774422654,98727820.0,-12.622411046202867,0.02632366884575088,4.366444884697576,4.366444884697576,43451.0,41278.2,45344.66838977075,42275.0,47449.0,0,702.0,3.1553197100132664,28901813127.802395
2022-04-14,39936.0,41133.0,41494.0,39585.0,294290000.0,67527.9,0.1,40382.33333333333,39.1545116150997,-734.2415805499655,49359.661388911816,39005.93861108819,42668.300508656095,8.915340702052715,1804.1176476781786,-195562180.0,-12.27677100494234,-0.029100722047990635,4.517522154642875,4.517522154642875,43030.5,41278.2,44730.40155079367,42275.0,47449.0,0,703.0,3.155593229722905,28989327955.919765
2022-04-15,40560.0,39936.0,40850.0,39781.0,233090000.0,67527.9,0.1,40542.99999999999,41.95921084228237,-649.1411867097163,49390.72042327862,38576.079576721386,42467.50998402218,16.49459492287137,1751.6092442725944,37527820.0,-12.391731645678986,0.015625,4.318563225524148,4.318563225524148,42645.5,41278.2,44177.56139571431,42275.0,47449.0,0,704.0,3.1558700298365596,29077904312.28224
2022-04-16,40382.0,40571.0,40691.0,40003.0,151310000.0,67527.9,0.1,40292.666666666664,41.37334438011353,-572.6227485258339,49114.80436528913,38204.29563471088,42268.88998554388,14.332564071419895,1675.6371553959805,-113782180.0,-11.8508655126498,-0.004388560157790877,4.1494654930315,4.1494654930315,42645.5,41278.2,43680.005256142875,42275.0,47449.0,0,705.0,3.1561454286729687,29166408222.65757
2022-04-17,39703.0,40382.0,40599.0,39561.0,210010000.0,67527.9,0.1,40214.99999999999,39.12892652533829,-536.1620633566627,48763.80261834732,37815.097381652675,42024.51951073018,6.263282910363795,1630.0916442962675,-323792180.0,-14.446096494063395,-0.016814422267346862,4.105714037468875,4.105714037468875,42506.0,42630.65,43232.20473052859,42275.0,47449.0,0,706.0,3.1564164758681637,29254115401.575836
2022-04-18,40803.0,39700.0,41095.0,38577.0,484260000.0,67527.9,0.1,40295.99999999999,44.39187294723109,-411.9664853660149,48182.373335897355,37731.92666410265,41908.18431923207,25.81168831168831,1693.5136697036771,160467820.0,-12.494370456153895,0.027705714933380365,4.1504636171450064,4.1504636171450064,42193.5,42630.65,42829.18425747573,42275.0,47449.0,0,707.0,3.1566935813959467,29343571994.150036
2022-04-19,41503.0,40809.0,41746.0,40585.0,268279999.99999997,67527.9,0.1,40669.666666666664,47.50249123586134,-263.8790242585941,47579.984462482025,37777.11553751798,41869.59533644806,42.14923653125901,1655.4769790105572,428747820.0,-8.796642201028435,0.01715560130382565,3.988812806328596,3.988812806328596,41942.75,42630.65,42318.92214657865,42275.0,41503.0,0,708.0,3.1569743155952765,29434194320.127647
2022-04-20,41368.0,41499.0,42203.0,40915.0,382840000.0,67527.9,0.1,41224.666666666664,46.95694855671785,-161.2658987046724,47221.94257852685,37719.45742147315,41821.824352024436,51.66604961125509,1629.2286233669458,45907820.0,-4.180853774349709,-0.003252776907693433,3.9383789967292246,3.9383789967292246,41889.0,42690.55,38577.0,42275.0,41503.0,0,709.0,3.1572539149414127,29524815033.485214
2022-04-21,40482.0,41370.0,42969.0,39793.0,493050000.0,67527.9,0.1,41117.666666666664,43.4315943804159,-140.0938632162738,46663.14473032418,37696.755269675814,41694.22203278401,35.264716771566086,1739.7122931264496,-447142180.0,-6.8265512796906656,-0.02141752078901571,4.297495907135145,4.297495907135145,42080.5,42690.55,38649.52,42275.0,41503.0,0,710.0,3.1575280619891872,29614362765.29529
2022-04-22,39709.0,40487.0,40792.0,39200.0,421300000.0,67527.9,0.1,40519.666666666664,40.569813642136815,-163.54670002653256,46153.9743157925,37595.7256842075,41505.15326775696,23.36911643270025,1729.1614150459889,-868442180.0,-6.069781194559432,-0.019094906378143373,4.354583129884885,4.354583129884885,42080.5,42690.55,38822.299199999994,42275.0,41503.0,0,711.0,3.1577973183682655,29702965517.308044
2022-04-23,39418.0,39709.0,39973.0,39291.0,190600000.0,67527.9,0.1,39869.666666666664,39.51425453973654,-182.60723583500794,45388.24731254119,37662.55268745881,41306.37676606582,17.36168455821635,1654.3641711141324,-1059042180.0,-7.830804124675568,-0.007328313480571169,4.19697643491332,4.19697643491332,42062.5,42690.55,38988.16723199999,42275.0,41503.0,0,712.0,3.158064487226111,29791311716.89735
2022-04-24,39464.0,39434.0,39929.0,39033.0,283630000.0,67527.9,0.1,39530.33333333333,39.780978947561174,-175.99282615078948,44337.12547466961,37997.174525330396,41130.91231215479,20.195810564663024,1600.1953017488372,-775412180.0,-6.34581612796051,0.0011669795524886784,4.054822880977187,4.054822880977187,41959.25,42690.55,42969.0,42275.0,41503.0,0,713.0,3.1583315700341226,29879897782.437252
2022-04-25,40427.0,39464.0,40599.0,38233.0,654600000.0,67527.9,0.1,39769.666666666664,45.22643057359876,-94.71067535225961,43390.138158292786,38436.26184170721,41063.87304433052,46.326013513513516,1654.895637338206,-120812180.0,2.3546092108261387,0.024401986620717686,4.093540547995661,4.093540547995661,41764.75,42690.55,42890.28,42275.0,41503.0,0,714.0,3.158603948879227,29970073768.504456
2022-04-26,38113.0,40443.0,40770.0,37708.0,681470000.0,67527.9,0.1,39334.666666666664,36.650170163629205,-179.80379517840868,43195.16971185199,38125.23028814801,40782.83751629904,7.698156244060065,1755.4030918140484,-802282180.0,-4.902939268426568,-0.05723897395305122,4.605785668443965,4.605785668443965,41455.0,42690.55,42703.9888,42275.0,41503.0,0,715.0,3.158862140897879,30056952736.120014
2022-04-27,39243.0,38113.0,39447.0,37869.0,426830000.0,67527.9,0.1,39260.99999999999,42.3948608370239,-144.51914604868102,42707.50987517652,38192.390124823476,40636.186324270566,29.176962554647407,1742.731442398759,-375452180.0,-4.594850849682737,0.02964867630467305,4.440872110691739,4.440872110691739,41455.0,42690.55,42404.229472,42275.0,41503.0,0,716.0,3.159126830596382,30145720853.22137
2022-04-28,39748.0,39243.0,40382.0,38888.0,542390000.0,67527.9,0.1,39034.666666666664,44.80381148846273,-75.19037457380819,42436.67940220122,38210.52059779878,40551.59715053051,38.775898118228476,1724.9649107988478,166937820.0,-0.4707532051282051,0.012868537063934982,4.339752719127624,4.339752719127624,41455.0,42901.2,42122.455703679996,42275.0,41503.0,0,717.0,3.159394160143541,30235417517.698227
2022-04-29,38581.0,39748.0,39919.0,38175.0,382900000.0,67527.9,0.1,39190.666666666664,40.58054303099465,-94.68949534834746,42038.661930616785,38189.93806938322,40363.921231432374,16.59380345941836,1726.3245600275015,-215962180.0,-4.879191321499014,-0.02935996779712191,4.474545916454995,4.474545916454995,41396.5,42901.2,41857.588361459195,42275.0,41503.0,0,718.0,3.15965414646531,30323516438.21619
2022-04-30,37650.0,38590.0,38776.0,37596.0,248220000.0,67527.9,0.1,38659.666666666664,37.54038630322692,-153.56525679622825,41864.040309098425,37915.75969090158,40105.452542724524,1.0050251256281406,1687.3013771683943,-464182180.0,-6.765390520528948,-0.024131048961924306,4.4815441624658545,4.4815441624658545,40796.25,42897.5,41608.61305977164,37650.0,41503.0,0,719.0,3.1599080553011696,30410324032.61169
2022-05-01,38461.0,37642.0,38676.0,37397.0,276990000.0,67527.9,0.1,38230.666666666664,41.641820172136164,-122.51479240951903,41903.03921460348,37773.16078539652,39948.838014846,19.09547738693467,1658.1369930849376,-187192180.0,-3.1282270861144,0.021540504648074332,4.311216539052384,4.311216539052384,40270.75,42798.0,41287.604014989905,37650.0,41503.0,0,720.0,3.1601666068573446,30498563351.557312
2022-05-02,38514.0,38472.0,39134.0,38061.0,580790000.0,67527.9,0.1,38208.33333333333,41.91027759666177,-84.8225816614904,41899.67820346111,37620.12179653889,39812.18677533686,20.046661880832737,1616.3414935788708,393597820.0,-5.609881626351004,0.0013780192922701051,4.1967634978939365,4.1967634978939365,39885.75,42798.0,40898.54361349092,37650.0,41503.0,0,721.0,3.160425128122063,30587049414.66313
2022-05-03,37718.0,38515.0,38647.0,37513.0,367210000.0,67527.9,0.1,38230.99999999999,39.00793594923883,-98.93120969677398,41806.991047056195,37371.30895294381,39612.740415780965,5.7609475951184494,1581.8885297518086,26387820.0,-9.119822663421921,-0.02066780910837618,4.193988360336732,4.193988360336732,39885.75,42798.0,40548.389252141824,37650.0,41503.0,0,722.0,3.160678406744484,30674444892.87801
2022-05-04,39688.0,37717.0,40021.0,37660.0,691490000.0,67527.9,0.1,38639.99999999999,48.511307363745786,31.977140020872525,41789.462622553445,37364.037377446555,39619.9079952304,41.11629576453697,1637.5393490552508,717877820.0,-4.061110036743377,0.052229704650299524,4.126031417696157,4.126031417696157,39746.25,42798.0,40233.25032692764,37650.0,41503.0,0,723.0,3.1609432543408715,30765066822.50193
2022-05-05,36544.0,39686.0,39833.0,36183.0,1040000000.0,67527.9,0.1,37983.33333333333,38.26426107969342,-79.51952519361316,41902.00878593658,36849.89121406341,39326.964376637035,7.83250162725103,1781.286538408447,-322122180.0,-9.727780248011463,-0.07921789961701264,4.874361149322589,4.874361149322589,39042.25,42191.0,40021.0,37650.0,41503.0,1,724.0,3.16118842966916,30850875583.79982
2022-05-06,36009.0,36540.0,36646.0,35267.0,752840000.0,67527.9,0.1,37413.666666666664,36.838288761484506,-170.42459218863223,42030.37933061506,36284.220669384944,39010.96776933827,13.483554424859168,1752.5517856649865,-1074962180.0,-9.317786899695284,-0.014639886164623417,4.866982658960222,4.866982658960222,38471.25,41733.0,40021.0,37650.0,41503.0,0,725.0,3.1614298112066668,30935939704.498634
2022-05-07,35468.0,36003.0,36119.0,34773.0,288860000.0,67527.9,0.1,36006.99999999999,35.401580523554614,-243.65232438381645,42222.41767966111,35668.6823203389,38673.54226749653,11.589127897281974,1723.5123724032017,-1363822180.0,-10.020802678979146,-0.01502402177233464,4.859344683667536,4.859344683667536,38134.0,41486.0,39833.0,37650.0,41503.0,0,726.0,3.161667311305288,31020228877.6155
2022-05-08,34060.0,35468.0,35497.0,33727.0,671050000.0,67527.9,0.1,35178.99999999999,31.91315866855497,-356.73610846544034,42398.76633585827,34818.03366414173,38234.15728963972,4.7280988215249184,1726.8329172315443,-2034872180.0,-13.693492803567809,-0.03969775572346901,5.069973333034481,5.069973333034481,37611.0,40963.0,39023.4,37650.0,41503.0,0,727.0,3.1618950004778252,31102191894.188354
2022-05-09,30095.0,34041.0,34227.0,30095.0,268090.0,67527.9,0.1,33207.666666666664,24.57060125424215,-651.2415475360583,43125.76045033646,32950.23954966354,37458.99945253117,0.0,1898.6305660007197,-2035140270.0,-25.55717713409355,-0.11641221374045807,6.308790716068183,6.308790716068183,35795.0,39147.0,38070.048,37650.0,41503.0,0,728.0,3.1620934208871265,31176731217.92272
2022-05-10,31007.5,30098.2,32621.2,29831.0,235610.0,67527.9,0.1,31720.83333333333,28.63979185454062,-731.2651369789185,43219.07254676194,31820.877453238056,36844.57093324249,11.150601838688276,1962.3140970006682,-2034904660.0,-18.643245086978197,0.030320651270975274,6.328514382006508,6.328514382006508,35663.0,39015.0,36475.038400000005,37650.0,31007.5,0,729.0,3.1622985138723503,31253192141.501278
2022-05-11,29068.2,31008.0,32113.6,27835.5,296900.0,67527.9,0.1,30056.899999999994,25.49224452028642,-852.9892019960114,43560.54405203451,30338.0259479655,36103.96417769558,9.825050810983148,2127.7273757863345,-2035201560.0,-25.927681369925843,-0.06254293316133186,7.319776855073017,7.319776855073017,34665.25,38017.25,35146.23072000001,37650.0,31007.5,0,730.0,3.162488198498914,31325797917.07408
2022-05-12,28976.0,29073.4,30136.7,26500.5,309480.0,67527.9,0.1,29683.899999999994,25.34960358041529,-874.6475988319796,43743.95293916404,29081.31706083597,35425.110446486484,18.30923412595688,2235.475420373025,-2035511040.0,-27.10073462815739,-0.0031718510262073174,7.714920694274658,7.714920694274658,33997.75,37349.75,33684.08457600001,37650.0,31007.5,0,731.0,3.1626768372085596,31398294913.412006
2022-05-13,29284.4,28994.3,31002.7,28755.0,141230.0,67527.9,0.1,29109.53333333333,26.824528047460305,-804.8925495690896,43721.14708477364,28090.762915226365,34840.28088015444,20.59021485891795,2236.3486046320945,-2035369810.0,-24.09631683989528,0.01064329099944783,7.636655026676642,7.636655026676642,33950.75,37349.75,32247.367660800006,37650.0,31007.5,0,732.0,3.1628676462483183,31471528831.881985
2022-05-14,30080.4,29285.2,30277.4,28666.7,70460.0,67527.9,0.1,29446.93333333333,30.634024235174422,-648.5459924003171,43464.9870798786,27408.562920121403,34386.958891568305,26.47757109574351,2191.659418586945,-2035299350.0,-20.10517928286852,0.02718170766688055,7.286004902152049,7.286004902152049,33154.0,37349.75,31097.994128640006,37650.0,31007.5,0,733.0,3.1630644144752784,31546504595.461926
2022-05-15,31308.7,30078.6,31383.8,29499.4,65440.0,67527.9,0.1,30224.5,36.15721334959562,-417.05495693721605,42857.946185995985,27103.773814004013,34093.79137808561,35.56229429385009,2169.712317259306,-2035233910.0,-18.596240347364862,0.04083389848539243,6.930061986793786,6.930061986793786,33022.25,37349.75,26500.5,37650.0,31007.5,0,734.0,3.1632702192295055,31624048602.264374
2022-05-16,29849.0,31308.3,31312.4,29135.8,100250.0,67527.9,0.1,30412.699999999993,32.81342474332526,-321.1912886029486,42609.4686919305,26525.851308069505,33689.52553255365,24.766095928405015,2170.2042945979274,-2035334160.0,-22.498312302020047,-0.04662282368798454,7.270609717571534,7.270609717571534,32866.75,37349.75,26598.166,37650.0,31007.5,0,735.0,3.1634645641967567,31698739775.946095
2022-05-17,30437.5,29856.7,30720.1,29484.5,79630.0,67527.9,0.1,30531.733333333326,35.4069885500308,-183.91815939918934,42060.55600768092,26194.213992319088,33379.80881516759,29.118745608520396,2103.4468449837896,-2035254530.0,-19.30245506124397,0.019715903380347788,6.910708320275284,6.910708320275284,32005.0,37349.75,26693.87868,37650.0,31007.5,0,736.0,3.1636631593406,31774735366.099934
2022-05-18,28683.7,30437.5,30687.9,28648.1,92030.0,67527.9,0.1,29656.733333333326,31.503990913245488,-176.94739389498727,41404.84644411446,25743.493555885532,32932.5603565802,16.37502343896494,2098.900641770662,-2035346560.0,-27.727020761943155,-0.05761971252566733,7.317398528678873,7.317398528678873,31598.05,37349.75,26787.677106400002,37650.0,31007.5,0,737.0,3.1638475981263228,31847136164.64023
2022-05-19,30305.9,28700.4,30525.1,28682.1,101380.0,67527.9,0.1,29809.03333333333,38.28098770164622,-36.16131267586479,40760.24191915476,25560.588080845246,32682.40222738209,37.50825489133114,2080.6220245013287,-2035245180.0,-17.07010726795096,0.056554768038990844,6.865402527235055,6.865402527235055,31471.15,37313.75,26879.599564272,37650.0,31007.5,0,738.0,3.164044570767677,31923048846.953762
2022-05-20,29178.6,30305.9,30735.1,28738.5,98780.0,67527.9,0.1,29389.399999999994,35.64190662212799,5.733129264035597,40232.13808739221,25241.551912607796,32348.706777155225,27.843218797109724,2074.6204513226626,-2035343960.0,-18.968591185536955,-0.03719737740835949,7.110075367984285,7.110075367984285,31288.7,37107.25,26969.68357298656,37650.0,31007.5,0,739.0,3.1642323949248286,31996689174.54544
2022-05-21,29434.6,29188.7,29623.2,28953.9,32270.000000000004,67527.9,0.1,29639.699999999997,36.708986161622235,71.71393907705351,39426.42366974105,25144.62633025895,32071.172798378535,32.61379425332072,1974.2404190853297,-2035311690.0,-17.01082666065186,0.008773553220510877,6.707209947087203,6.707209947087203,31825.6,37062.25,27057.96590152683,37650.0,31007.5,0,740.0,3.1644219544064116,32070962686.76602
2022-05-22,30286.6,29433.0,30462.0,29260.1,50600.0,67527.9,0.1,29633.26666666666,40.259157233548116,187.20467162586874,38458.67417530123,25289.635824698766,31901.213484247248,49.001488384132514,1919.0732462935207,-2035261090.0,-11.078684674104526,0.028945526693075596,6.336377296538802,6.336377296538802,31728.6,36967.75,27144.482583496294,37650.0,31007.5,0,741.0,3.1646178630260198,32147114853.257244
2022-05-23,29093.3,30287.3,30644.8,28913.6,92100.0,67527.9,0.1,29604.83333333333,37.11868778868081,196.72010441877865,37552.63065586659,25333.20934413341,31633.793152414175,42.36116784027969,1905.6537287011265,-2035353190.0,-3.328459877055992,-0.03940026282250231,6.550146352256797,6.550146352256797,31728.6,36967.75,27229.26893182637,37650.0,31007.5,0,742.0,3.1648040965322024,32220835050.322567
2022-05-24,29648.7,29091.6,29810.8,28706.1,79420.0,67527.9,0.1,29676.199999999993,39.48479972301801,250.46304150449578,35775.028343869526,26106.88165613047,31444.736661708062,56.08665443337908,1848.4427480796173,-2035273770.0,-4.3821656050955395,0.019090306015474345,6.234481606544696,6.234481606544696,31620.5,36967.75,27312.359553189843,37650.0,31007.5,0,743.0,3.1649944361568396,32295831967.35151
2022-05-25,29540.6,29648.7,30202.3,29353.5,78850.0,67527.9,0.1,29427.53333333333,39.17581554722962,286.19575200570125,34712.81910334146,26468.750896658545,31263.390312973963,62.25503245755942,1777.0396946453588,-2035352620.0,1.6251436277444002,-0.003646028325019368,6.015584296342522,6.015584296342522,31476.175,36850.75,27393.788362126044,37650.0,31007.5,0,744.0,3.1651836221097938,32370688121.581192
2022-05-26,29203.5,29537.9,29868.9,28077.9,126710.0,67527.9,0.1,29464.266666666663,38.17264157628785,293.5002906453137,33573.387973024306,26927.632026975698,31067.210283166918,34.04821682446533,1778.0368593135477,-2035479330.0,0.7851325234676974,-0.011411413444547436,6.088437547943046,6.088437547943046,31333.625,36850.75,27473.588594883524,37650.0,31007.5,0,745.0,3.1653698332572624,32444906934.430843
2022-05-27,28601.2,29194.0,29377.1,28282.2,116410.0,67527.9,0.1,29115.099999999995,36.380132830307694,265.0102949457987,32288.260698904647,27526.079301095357,30832.352160960545,15.829274932696077,1729.24136936258,-2035595740.0,-2.3329827484940813,-0.020624240245176062,6.046044814072766,6.046044814072766,31333.625,36009.75,27551.79282298585,28601.2,31007.5,0,746.0,3.165550892347947,32517890299.175117
2022-05-28,29027.1,28620.1,29194.4,28537.2,43870.0,67527.9,0.1,28943.93333333333,38.57658859984235,280.5917810989986,31112.232702838934,28198.81729716107,30660.423383726207,28.71230224749683,1652.6669858366815,-2035551870.0,-3.501615670004398,0.014890983595093887,5.693531168586189,5.693531168586189,31333.625,35239.75,27628.432966526136,28601.2,31007.5,0,747.0,3.165735096248274,32591893349.418995
2022-05-29,29465.2,29027.1,29556.5,28838.7,36870.0,67527.9,0.1,29031.16666666666,40.839220411995036,323.1186610912373,31068.558422139737,28179.51157786027,30546.592585276092,42.89070953779562,1585.8907725626327,-2035515000.0,-5.888139718353045,0.015092792597262594,5.382250154632016,5.382250154632016,31311.05,35239.75,27703.540307195613,28601.2,31007.5,0,748.0,3.165922488343467,32666934236.515278
2022-05-30,31723.3,29465.2,32185.6,29307.2,129560.0,67527.9,0.1,30071.866666666658,50.88240894995165,495.7167579605623,31266.09765665275,28053.55234334725,30658.65995810694,88.74552669377024,1678.2128602367302,-2035385440.0,6.279272337431737,0.07663616741104762,5.290158527759503,5.290158527759503,31649.25,34960.75,27777.145501051702,28601.2,31007.5,0,749.0,3.166126761414878,32746774276.37604
2022-05-31,31793.4,31730.2,32377.5,31221.2,86600.0,67527.9,0.1,30993.966666666664,51.159598265156625,600.0302090298728,31625.366040493846,27966.803959506153,30766.73043828723,86.41501535026516,1640.9333702198207,-2035298840.0,4.454702258726904,0.002209732278798393,5.161239031433633,5.161239031433633,30900.475,34960.75,27953.483681009635,28601.2,31793.4,0,750.0,3.166331236076794,32826862433.627342
2022-06-01,29798.5,31793.1,31969.9,29396.6,135090.0,67527.9,0.1,31105.066666666662,43.6160813787117,522.9248175268069,31627.460638209697,28046.9593617903,30674.51801559321,40.01767606288955,1707.5309866326909,-2035433930.0,3.8865278886615022,-0.06274572710059323,5.730258189615889,5.730258189615889,30768.725,34734.75,28218.924660149056,28601.2,31793.4,0,751.0,3.166520328203733,32902904941.348236
2022-06-02,30455.5,29798.6,30638.5,29604.4,81400.0,67527.9,0.1,30682.466666666664,46.41823952834296,504.19781344172907,31686.46858270436,28105.061417295645,30653.659156965285,55.29816727137407,1659.4287733017843,-2035352530.0,0.4936332529309426,0.022048089668943005,5.448699818757808,5.448699818757808,30613.225,34734.75,28468.439180540114,28601.2,31793.4,0,752.0,3.1667141900158176,32980438363.803867
2022-06-03,29700.9,30455.7,30674.8,29330.8,72130.0,67527.9,0.1,29984.966666666664,43.73008737511991,431.8087690614102,31667.30824218862,28086.27175781138,30562.92018963526,37.74769746022887,1636.8981466373712,-2035424660.0,1.7900104871378437,-0.024777133851028532,5.511274562849514,5.511274562849514,30295.725,34734.75,28702.982829707707,28601.2,31793.4,0,753.0,3.166901915213599,33056452847.34541
2022-06-04,29864.3,29700.9,29963.8,29489.5,33510.0,67527.9,0.1,30006.899999999994,44.47987037219288,387.1805866081372,31470.41831614713,28138.721683852862,30496.384933479523,41.54805098148661,1553.855421877559,-2035391150.0,1.4598465751190801,0.005501516789053529,5.203053216976654,5.203053216976654,29945.35,34734.75,28923.453859925245,28601.2,31793.4,0,754.0,3.167090615518003,33132910425.1646
2022-06-05,29913.0,29865.1,30166.9,29539.0,30330.0,67527.9,0.1,29826.066666666662,44.71630875058532,354.0895087469046,31474.193193672672,28141.34680632732,30440.82446362433,42.68071448506836,1487.715748886305,-2035360820.0,-1.2335488301757165,0.0016307095763168356,4.973475575456507,4.973475575456507,29948.175,34734.75,29130.69662832973,28601.2,31793.4,0,755.0,3.1672793938552455,33209563854.11982
2022-06-06,31367.6,29911.2,31753.4,29888.6,94010.0,67527.9,0.1,30381.633333333328,51.376855051575006,418.87856546087824,31636.30119271161,28072.248807288393,30529.08880042201,76.51176853660802,1514.650338251569,-2035266810.0,7.817263768634013,0.04862768695884734,4.828709682129233,4.828709682129233,30023.55,34734.75,29325.504830629947,28601.2,31793.4,0,756.0,3.167478901793305,33289383574.78437
2022-06-07,31128.8,31370.3,31556.6,29235.0,140320.0,67527.9,0.1,30803.133333333328,50.305330206125966,432.59710397154424,31756.04280984718,28197.01719015282,30586.204152762773,70.9577635128849,1572.2895998050283,-2035407130.0,4.992124443904786,-0.007612950943011287,5.050916192738006,5.050916192738006,30516.975,34734.75,32377.5,28601.2,31793.4,0,757.0,3.167676327030313,33368810467.210293
2022-06-08,30201.6,31127.2,31312.1,29874.8,87960.0,67527.9,0.1,30899.333333333325,46.27018002996913,368.66842653776416,31747.544556422872,28195.085443577118,30549.575185832986,49.392966787608096,1562.6474855332403,-2035495090.0,2.237598423864106,-0.02978592171879424,5.17405530016039,5.17405530016039,30516.975,34734.75,32314.65,28601.2,31793.4,0,758.0,3.1678664248142407,33446371331.449226
2022-06-09,30097.8,30202.1,30691.4,29953.8,61720.0,67527.9,0.1,30476.066666666662,45.82700448991857,311.13041980418916,31756.25815906457,28278.29184093543,30506.548977658418,44.333748443337456,1503.7155222808663,-2035556810.0,3.062304175869328,-0.0034369040050857835,4.996097795456366,4.996097795456366,30415.075,34734.75,32253.057,28601.2,31793.4,0,759.0,3.168055422252594,33523800778.505184
2022-06-10,29083.3,30097.4,30325.6,28884.9,104260.0,67527.9,0.1,29794.233333333326,41.63016722077484,201.78632344696848,31768.717670873757,28230.70232912624,30371.001455976664,14.220243210165837,1499.2144135465185,-2035661070.0,1.6855936114568568,-0.03370678255553561,5.154897874541467,5.154897874541467,30273.425000000003,34734.75,32192.69586,28601.2,31793.4,0,760.0,3.1682361617285637,33599082396.2811
2022-06-11,28403.4,29083.3,29426.6,28161.8,82920.0,67527.9,0.1,29194.83333333333,39.049155488222596,86.59665044306234,31799.51506462242,28011.584935377577,30183.610841121743,5.730958085252796,1482.4705268646244,-2035743990.0,-2.1486817491240844,-0.023377677223698767,5.219341793111474,5.219341793111474,30092.65,34734.75,32060.3840256,28601.2,31793.4,0,761.0,3.1684111180144794,33672898823.590313
2022-06-12,26606.3,28404.0,28534.8,26606.3,120020.0,67527.9,0.1,28030.999999999996,33.19153710095921,-97.71294905472837,32141.350858739806,27421.049141260195,29842.91457053872,0.0,1514.3297749457226,-2035864010.0,-9.70263225771419,-0.06327059436546334,5.691621063228344,5.691621063228344,29335.875,33646.25,31826.468984064,28601.2,31793.4,0,762.0,3.1685706217735605,33742506127.222534
2022-06-13,22448.0,26606.3,26857.6,22006.3,379260.0,67527.9,0.1,25819.233333333326,24.16040951750979,-466.1473258706112,33396.52214988104,25445.80785011896,29138.636992392177,4.258909287257026,1752.6847910210283,-2036243270.0,-29.23813096367654,-0.1562900516043193,7.807754771120049,7.807754771120049,27035.875,31388.15,31408.85546533888,28601.2,31793.4,1,763.0,3.168690431504926,33801011917.38149
2022-06-14,22157.3,22449.1,23200.3,20860.9,251010.0,67527.9,0.1,23737.199999999993,23.675426730379883,-682.7899665493819,34132.17984760484,23971.820152395157,28473.747755021494,11.669817265280384,1794.5930202338118,-2036494280.0,-30.30849169953513,-0.012949928724162563,8.099330785943287,8.099330785943287,26463.175000000003,30815.45,30468.59991880499,28601.2,31793.4,1,764.0,3.168806966998343,33858686541.22822
2022-06-15,22577.9,22137.5,22754.4,20125.8,280410.0,67527.9,0.1,22394.399999999994,25.990260602818296,-745.9860017811613,34529.97513662555,22911.464863374436,27912.238445019448,21.08861673948194,1854.1649473599682,-2036213870.0,-24.23142104468345,0.018982457248852613,8.212300290815215,8.212300290815215,26046.425,30447.9,29315.675928548393,28601.2,31793.4,1,765.0,3.168927612100679,33917623509.11665
2022-06-16,20386.6,22577.9,22942.1,20231.1,144000.0,67527.9,0.1,21707.26666666666,22.210747371975117,-874.6769400100068,35162.82174604561,21457.158253954392,27195.510974065215,2.2429392135952324,1915.3674511199704,-2036357870.0,-33.061023460458706,-0.0970550848395999,9.395227507872674,9.395227507872674,25985.3,30447.9,28029.09329855162,28601.2,31793.4,0,766.0,3.169024343423487,33969852416.705627
2022-06-17,20444.6,20391.3,21315.4,20244.1,136270.0,67527.9,0.1,21136.36666666666,22.531861338572554,-892.1339860563407,35529.04991520116,20232.68008479884,26552.56707177329,2.741752382262885,1855.0769188971155,-2036221600.0,-31.165048870572953,0.002845006033374897,9.07367676010837,9.07367676010837,25830.125,30253.9,26922.63223675439,28601.2,31793.4,0,767.0,3.169121497339271,34022278034.15753
2022-06-18,18986.5,20446.4,20744.7,17630.5,267250.0,67527.9,0.1,19939.233333333326,20.26685249167761,-933.6772625407048,35884.3342493839,18829.525750616096,25831.98925541393,9.601427468862626,1945.0142818330357,-2036488850.0,-36.424091641190316,-0.07131956604678003,10.244196043678592,10.244196043678592,24491.025,29006.25,25971.075723608777,18986.5,31793.4,0,768.0,3.1692012750901504,34069819718.090244
2022-06-19,20577.2,18983.4,20763.5,17983.7,169390.0,67527.9,0.1,20002.766666666663,28.688864201121575,-791.4442216433627,35566.27647929988,18032.97352070012,25331.5331358507,20.864694928095506,2004.6418331306759,-2036319460.0,-31.209841874770166,0.08378058093908836,9.742053501597281,9.742053501597281,24266.275,28825.75,24636.583607831373,18986.5,31793.4,0,769.0,3.1692994626581856,34122686650.495716
2022-06-20,20572.3,20576.9,20996.8,19658.8,140600.0,67527.9,0.1,20045.33333333333,28.67881502130149,-641.5034392965076,35090.880708985016,17386.259291014983,24878.272837198252,21.1243636050294,1957.0245593356278,-2036460060.0,-34.41544778688838,-0.0002381276364131768,9.512910852630128,9.512910852630128,24043.325,28825.75,23515.610230578353,18986.5,31793.4,0,770.0,3.169397358655978,34175547951.56614
2022-06-21,20720.4,20571.6,21689.3,20371.7,136320.0,67527.9,0.1,20623.299999999996,29.482814733930866,-483.3655188438229,34789.92488526211,16779.405114737892,24482.284947941276,22.58434686001638,1911.35137652594,-2036323740.0,-33.436560355683476,0.0071990005978914695,9.224490726655565,9.224490726655565,23624.025,28825.75,22573.992593685816,18986.5,31793.4,0,771.0,3.1694966790751433,34228895517.630222
2022-06-22,19965.8,20720.2,20864.3,19780.2,125940.0,67527.9,0.1,20419.499999999996,27.765353376759208,-384.88615946797836,34337.78241464733,16182.577585352672,24052.14352432782,17.88008483335757,1852.2619924883727,-2036449680.0,-33.89158190294554,-0.036418215864558734,9.277173929861927,9.277173929861927,22709.7,28825.75,21783.033778696084,18986.5,31793.4,0,772.0,3.169587176490346,34279787637.1128
2022-06-23,21100.7,19967.3,21189.8,19907.5,110700.0,67527.9,0.1,20595.633333333328,33.99312504239785,-207.50137194924628,33840.13599041368,15820.204009586323,23771.053664868028,27.33495600664824,1811.550421596346,-2036338980.0,-29.892882536265102,0.05684220016227748,8.585262202658424,8.585262202658424,22645.15,28825.75,17630.5,18986.5,31793.4,0,773.0,3.1696902354053296,34334365148.752472
2022-06-24,21226.9,21100.9,21488.7,20743.9,104560.0,67527.9,0.1,20764.466666666664,34.66765588426067,-53.858934291904006,33227.88992977653,15568.710070223467,23528.753315832975,30.488042658166695,1735.3539629108927,-2036234420.0,-27.01344070308389,0.005980844237394978,8.175258577139822,8.175258577139822,22645.15,28825.75,17701.686,18986.5,31793.4,0,774.0,3.1697944343300795,34389353982.22983
2022-06-25,21489.9,21226.9,21553.4,20917.5,66630.0,67527.9,0.1,21272.499999999996,36.13244138417786,85.7010797900266,32513.04255596394,15441.247444036055,23334.57680956317,35.393376924699446,1656.8215369886861,-2036167790.0,-24.3403958681003,0.012389939180944998,7.709768481885379,7.709768481885379,22331.95,28731.75,17853.16656,18986.5,21489.9,0,775.0,3.1699012410588656,34445179563.94818
2022-06-26,21043.5,21489.9,21837.4,20989.7,67210.0,67527.9,0.1,21253.43333333333,34.70993975652122,163.65095623796878,31372.524307432443,15549.355692567555,23116.3790181762,36.98886974238927,1599.0271414894944,-2036235000.0,-20.907830100389756,-0.02077254896486258,7.59867484729011,7.59867484729011,22267.075,27138.25,18075.180566400002,18986.5,21489.9,0,776.0,3.1700029521662922,34499618378.11723
2022-06-27,20730.2,21037.7,21497.5,20568.0,84690.0,67527.9,0.1,21087.866666666665,33.70695153244877,207.01966809585565,30099.503572506117,15782.516427493887,22889.123873587992,55.65190850658912,1551.2037742402447,-2036319690.0,-7.652352102637202,-0.014888207760115901,7.482821073796899,7.482821073796899,22301.25,26874.75,18376.158121088003,18986.5,21489.9,0,777.0,3.1701009573860626,34553065893.52488
2022-06-28,20278.0,20727.9,21200.2,20210.5,83830.0,67527.9,0.1,20683.899999999994,32.258062580773014,217.10400319455493,28858.436074620688,16031.223925379309,22640.445409436754,49.84373823330071,1511.0963617945129,-2036403520.0,-8.481629079355333,-0.02181358597601568,7.451900393502875,7.451900393502875,22720.025,26563.75,18653.057471400964,18986.5,21489.9,0,778.0,3.17019362964063,34605045248.647705
2022-06-29,20111.3,20278.0,20415.8,19880.7,98970.0,67527.9,0.1,20373.16666666666,31.716816286340958,223.52281733771906,27378.048009117505,16512.96199088249,22399.574418061824,46.705324196099106,1441.3823359520477,-2036502490.0,-10.924842434415964,-0.008220731827596417,7.167027173539492,7.167027173539492,22750.375,25928.75,18907.804873688885,18986.5,21489.9,0,779.0,3.1702841626750353,34656477118.459984
2022-06-30,19926.6,20111.3,20155.1,18682.7,127730.0,67527.9,0.1,20105.299999999996,31.094296203977578,225.64949745147715,25880.806007957362,17094.53399204264,22164.05304491308,54.5793814923102,1443.597883384044,-2036630220.0,-2.2563840954352368,-0.009183891643006703,7.244577014563669,7.244577014563669,22476.0,25125.85,21837.4,18986.5,21489.9,0,780.0,3.170372334036233,34707294069.692314
2022-07-01,19262.9,19926.6,20785.6,18980.1,150180.0,67527.9,0.1,19766.933333333327,28.899267423156317,193.8915052047655,24175.261448139834,17886.02855186016,21887.752754921356,38.80291901400083,1469.448034570898,-2036780400.0,-5.780010369486305,-0.03330723756185183,7.628384275321462,7.628384275321462,22476.0,25004.0,21774.306,18986.5,21489.9,0,781.0,3.170452453159709,34755835319.592094
2022-07-02,19243.2,19275.4,19425.4,19006.4,58570.0,67527.9,0.1,19477.566666666662,28.834202559418358,183.21672074687012,22603.589270931716,18721.39072906828,21635.89058778599,32.682876196901674,1394.4160321015481,-2036838970.0,1.352013272588422,-0.0010226912873970706,7.246279371942027,7.246279371942027,22426.800000000003,25004.0,21712.47388,18986.5,21489.9,0,782.0,3.1705321131111117,34804305994.34195
2022-07-03,19309.9,19243.4,19626.4,18794.4,65269.99999999999,67527.9,0.1,19271.999999999996,29.413664104855002,191.41233050825258,22348.864797836362,18662.305202163636,21414.367674663514,19.88144673027548,1354.243458380009,-2036773700.0,-6.158758237272317,0.003466159474515784,7.013208035152998,7.013208035152998,22365.675000000003,25004.0,21651.8784024,18986.5,21489.9,0,783.0,3.1706123493546343,34853008108.28698
2022-07-04,20215.8,19310.6,20303.8,19052.5,92790.0,67527.9,0.1,19589.633333333328,36.925502072809145,264.12542643551615,22091.111786404523,18725.90821359548,21300.218372314608,48.59733096649438,1346.8903542100084,-2036680910.0,-1.7329127030035534,0.046913759263382815,6.662562719308701,6.662562719308701,22210.5,25004.0,21592.494834352,18986.5,21489.9,0,784.0,3.170702944219289,34904804555.41049
2022-07-05,20200.6,20215.8,20706.9,19315.4,122430.0,67527.9,0.1,19908.76666666666,36.854631546427015,314.08064672256637,21646.858298605526,18932.431701394467,21195.49281304655,48.11551019114329,1350.0767574807219,-2036803340.0,-2.5086388293662423,-0.0007518871377834024,6.683349789019742,6.683349789019742,22034.074999999997,25004.0,21534.29893766496,18986.5,21489.9,0,785.0,3.1707931356501926,34956555405.55997
2022-07-06,20561.1,20180.4,20654.9,19785.3,105240.0,67527.9,0.1,20325.833333333325,39.80545191206764,370.4133792275445,21660.19999835211,18936.540001647896,21135.07444989926,59.54290423812081,1315.756989089242,-2036698100.0,2.981598533492268,0.017846004574121554,6.39925387790168,6.39925387790168,21735.0,25004.0,21477.26695891166,18986.5,21489.9,0,786.0,3.1708871782494596,35009508855.223236
2022-07-07,21637.8,20557.9,21817.8,20282.7,115810.0,67527.9,0.1,20799.83333333333,47.67082433624576,472.65232172246783,21839.54327513853,18876.516724861474,21182.953073718378,93.67293244999519,1331.424347011439,-2036582290.0,2.545413185344555,0.05236587536659032,6.15323344800044,6.15323344800044,21666.45,25004.0,18682.7,18986.5,21489.9,0,787.0,3.170992760919874,35065930423.95328
2022-07-08,21611.2,21637.1,22482.1,21207.0,439900.0,67527.9,0.1,21270.03333333333,47.50567409028908,526.8175542416141,21925.878791215884,19052.651208784122,21223.738495269008,77.07795967784392,1327.4011793677648,-2037022190.0,1.81043864153503,-0.0012293301537124046,6.142190990633398,6.142190990633398,21413.225,25004.0,18745.402000000002,18986.5,21489.9,1,788.0,3.1710978200046096,35122284626.3953
2022-07-09,21587.5,21610.4,21944.1,21338.4,190110.0,67527.9,0.1,21612.16666666666,47.348282260788196,546.9960331527402,22054.15433760998,19025.405662390025,21258.382448100532,76.45417697531192,1275.8510951272099,-2037212300.0,0.4541668411672392,-0.0010966535870289285,5.910138251892113,5.910138251892113,20526.825,25004.0,18894.86992,18986.5,21489.9,0,789.0,3.171202386639749,35178580018.17484
2022-07-10,20847.4,21587.4,21599.2,20689.7,204680.0,67527.9,0.1,21348.699999999993,42.601607973819,497.8487951628606,22073.82685918746,19033.24314081254,21219.24126256715,56.97478549244622,1249.6831597609805,-2037416980.0,-0.9318792026041226,-0.034283729009843555,5.994431726550939,5.994431726550939,20462.275,25004.0,19038.3591232,18986.5,21489.9,0,790.0,3.1712986737783706,35232515760.53627
2022-07-11,19963.2,20847.2,20855.0,19897.0,160200.0,67527.9,0.1,20799.366666666665,37.734523700239194,397.49509684438635,22055.052833902926,18976.297166097072,21099.6182851798,33.70268989840503,1228.848648349482,-2037577180.0,-3.6999160644856297,-0.042412962767539364,6.155569489608288,6.155569489608288,20462.275,25004.0,19176.108758272,18986.5,21489.9,0,791.0,3.1713847411323646,35283506548.61809
2022-07-12,19330.9,19963.2,20051.7,19279.6,167910.0,67527.9,0.1,20047.16666666666,34.68299911077601,285.4765857033856,22092.0092867305,18875.8507132695,20931.168924686484,17.06058851397592,1196.2237448959477,-2037745090.0,-4.670578952559417,-0.03167327883305282,6.188143050225016,6.188143050225016,20411.8,25004.0,22482.1,19330.9,21489.9,0,792.0,3.1714631674954195,35332303047.635666
2022-07-13,20250.0,19331.6,20250.8,18942.2,249380.0,67527.9,0.1,19848.03333333333,42.022428388705166,270.37505608795936,22026.81156668261,18855.978433317392,20866.29569376396,41.2512501973996,1204.250620260523,-2037495710.0,0.6896620307986094,0.047545639364954484,5.946916643261842,5.946916643261842,20384.225,25004.0,22418.05,19330.9,21489.9,0,793.0,3.171552071567106,35384270856.662605
2022-07-14,20586.0,20250.0,20862.2,19664.9,205280.0,67527.9,0.1,20055.63333333333,44.47859431553454,278.9825408191941,21955.38255528843,18863.317444711567,20839.60086578644,48.5831276947691,1203.7541473847712,-2037290430.0,3.309144560537179,0.016592592592592492,5.847440723718892,5.847440723718892,20472.525,25004.0,22279.016,19330.9,21489.9,0,794.0,3.171644537139182,35437368911.41361
2022-07-15,20825.1,20586.1,21178.1,20393.4,164670.0,67527.9,0.1,20553.699999999993,46.224446819116864,295.179368583355,21854.909859214113,18897.31014078589,20838.219830949634,55.0668438321989,1173.821708285859,-2037125760.0,8.10988999579501,0.011614689594870331,5.6365717729367875,5.6365717729367875,20647.275,25004.0,22145.54336,19330.9,21489.9,0,795.0,3.1717394309103852,35491264890.29958
2022-07-16,21209.9,20825.2,21561.3,20484.4,136890.0,67527.9,0.1,20873.66666666666,49.00368679191486,323.909445183745,21879.933729320554,18888.926270679447,20873.617942287765,65.50153212029183,1166.898729122583,-2036988870.0,10.220233640974477,0.018477702387983852,5.501670112176781,5.501670112176781,20647.275,25004.0,22017.4096256,19330.9,21489.9,0,796.0,3.171838306901183,35546425448.95231
2022-07-17,20785.6,21209.8,21654.4,20755.2,132810.0,67527.9,0.1,20940.199999999993,46.17017310083063,306.61591431511965,21885.457924394756,18888.942075605246,20865.2352811175,52.074917370547155,1147.7773913281128,-2037121680.0,7.642193900538051,-0.020004809075007568,5.521983446848361,5.521983446848361,20512.775,25004.0,21894.401240576,19330.9,21489.9,0,797.0,3.1719322983408547,35600209272.80349
2022-07-18,22525.8,20785.6,22714.9,20770.6,279720.0,67527.9,0.1,21507.099999999995,57.12110264369053,398.81672701728803,22262.141509491754,18737.038490508246,21023.38430196345,94.98767460969593,1204.671863376105,-2036841960.0,11.426705843943846,0.0837214225232854,5.347964837546747,5.347964837546747,20763.675000000003,25004.0,18942.2,19330.9,21489.9,0,798.0,3.172044555649998,35659531755.04083
2022-07-19,23410.2,22529.3,23757.3,21581.8,308910.0,67527.9,0.1,22240.533333333326,61.41703873032652,499.28901336686033,22823.686847627127,18505.383152372873,21250.700082728836,92.79142696932568,1274.0167302778118,-2036533050.0,15.888636971179086,0.03926164664518028,5.442143724862717,5.442143724862717,21284.875,25004.0,19017.654000000002,19330.9,23410.2,0,799.0,3.172165427059918,35721529359.785576
2022-07-20,23215.2,23412.0,24258.0,22944.4,281310.0,67527.9,0.1,23050.399999999994,59.989910562951,529.6560088984971,23226.058360115872,18431.871639884128,21437.795312945138,80.38300914255616,1276.8441066865396,-2036814360.0,12.908356070443713,-0.008329702437399056,5.500034919735946,5.500034919735946,21535.225,25004.0,19207.239840000002,19330.9,23410.2,0,800.0,3.172284125609784,35782978780.14491
2022-07-21,23153.0,23219.9,23403.8,22360.2,217080.0,67527.9,0.1,23259.466666666664,59.51485984687193,521.7582707980896,23510.324160663946,18536.615839336057,21601.148140283694,79.21291244967831,1260.1838133517867,-2037031440.0,7.0025603342299165,-0.0026792790930080246,5.442853251638176,5.442853251638176,21535.225,25004.0,19510.285449600004,19330.9,23410.2,0,801.0,3.172401959553194,35844270031.64551
2022-07-22,22675.2,23150.0,23741.4,22524.2,197540.0,67527.9,0.1,23014.466666666664,55.85579232722067,462.5791377271981,23640.152313626993,18749.987686373006,21703.43879359001,70.2246134166071,1257.1135409695162,-2037228980.0,4.9233730658177235,-0.02063663456139586,5.54400199764287,5.54400199764287,21715.9,24800.2,19795.148322624,19330.9,23410.2,0,802.0,3.1725147534499465,35904144612.4071
2022-07-23,22460.4,22683.6,22991.0,21971.7,137420.0,67527.9,0.1,22762.866666666665,54.241256940338516,390.0898218780044,23695.373229775814,19009.81677022418,21775.530337057626,66.18382933895182,1240.1268594716935,-2037366400.0,4.043543717429075,-0.00947290431837422,5.5213925819295,5.5213925819295,21898.025,24691.95,20062.91942326656,19330.9,23410.2,0,803.0,3.1726251165617514,35963381951.23407
2022-07-24,22582.1,22449.8,22987.9,22281.3,126660.0,67527.9,0.1,22572.566666666662,55.03430883911713,333.64350130771527,23811.100593009785,19130.719406990214,21852.346495433092,68.47323074607769,1202.0177980808585,-2037239740.0,8.320941700164035,0.005418425317447406,5.322878731742657,5.322878731742657,21920.775,24691.95,20314.624257870568,19330.9,23410.2,0,804.0,3.1727364793341013,36023014927.242615
2022-07-25,21301.9,22582.3,22653.3,21275.4,206930.0,67527.9,0.1,22114.8,46.00239312786677,199.98520483659087,23794.749729123956,19257.20027087604,21799.92301967756,44.390308138003704,1214.5808125036542,-2037446670.0,6.705838743287653,-0.056690918913652744,5.7017487290037705,5.7017487290037705,21988.475,24691.95,20551.226802398334,19330.9,23410.2,0,805.0,3.1728341946800316,36078612691.600334
2022-07-26,21248.7,21301.6,21322.3,20737.3,201570.0,67527.9,0.1,21710.899999999994,45.666989899507335,102.78699324585382,23790.10618923872,19330.60381076128,21747.42558923208,43.38951804055834,1169.610754467679,-2037648240.0,9.920903837896834,-0.0024974298067308442,5.504387348250382,5.504387348250382,22011.925000000003,24691.95,24258.0,19330.9,23410.2,0,806.0,3.1729311028375617,36134047287.25941
2022-07-27,22958.3,21248.0,23027.8,21047.5,242660.0,67527.9,0.1,21836.3,56.614170419489795,145.8000528014363,23938.090116431442,19314.669883568553,21862.746961686167,71.7032069843896,1227.517129148559,-2037405580.0,13.374320987654317,0.08045668676201356,5.346724840900934,5.346724840900934,22011.925000000003,24691.95,24187.586,19330.9,23410.2,0,807.0,3.17304554481062,36194885476.9735
2022-07-28,23850.0,22957.7,24190.5,22611.6,268320.0,67527.9,0.1,22685.66666666666,61.02512134713321,221.91123006107952,24244.857951520276,19231.782048479723,22052.009155811294,89.44263313150132,1252.6159056379477,-2037137260.0,15.855435733022444,0.03883998379670972,5.252058304561626,5.252058304561626,22011.925000000003,24593.55,20737.3,19330.9,23410.2,0,808.0,3.1731684887659486,36258407687.75506
2022-07-29,23774.3,23850.2,24340.0,23451.4,221660.0,67527.9,0.1,23527.533333333326,60.46312088004271,252.5348040422861,24504.61410905259,19190.705890947404,22216.03685525784,85.32783483763873,1226.6147695209513,-2037358920.0,14.16175672625822,-0.0031740041928721707,5.159414870347187,5.159414870347187,22089.875,24471.3,20806.363999999998,19330.9,23410.2,0,809.0,3.1732904531805044,36321739000.69585
2022-07-30,23634.2,23774.2,24605.3,23521.8,168720.0,67527.9,0.1,23752.83333333333,59.37332210943866,248.35685572791783,24710.964686997875,19263.035313002125,22351.10001189995,74.89400206825236,1216.3922859837405,-2037527640.0,11.430039745590499,-0.005892917982863732,5.146746181312422,5.146746181312422,22222.525,24160.95,20947.70944,19330.9,23410.2,0,810.0,3.1734108123478433,36384687031.60177
2022-07-31,23303.4,23634.2,24179.3,23236.2,138840.0,67527.9,0.1,23570.633333333328,56.77138215394657,209.84891840892968,24768.554465028552,19539.465534971452,22441.79524886186,66.34177869700109,1196.8714084134733,-2037666480.0,12.113193749518912,-0.013996665848643008,5.136037695844697,5.136037695844697,22222.525,23978.05,21167.1648736,19330.9,23410.2,0,811.0,3.1735276902922167,36446675803.6592
2022-08-01,23271.2,23303.4,23484.4,22863.8,162330.0,67527.9,0.1,23402.93333333333,56.51177305594635,170.41992505268956,24661.050065559117,20040.999934440886,22520.786177541682,65.50930713547056,1155.7091649553681,-2037828810.0,3.3090944605741037,-0.0013817726168713351,4.966263729224828,4.966263729224828,22222.525,23528.55,21373.452981184,19330.9,23410.2,0,812.0,3.1736440055561355,36508593803.504944
2022-08-02,22988.6,23271.1,23423.3,22670.8,177300.0,67527.9,0.1,23187.733333333326,54.17048869945827,116.11220009963336,24599.74468410952,20376.165315890477,22565.339874918667,58.2032057911065,1126.908510315699,-2038006110.0,-1.800924383388447,-0.012143765684623165,4.902031921542413,4.902031921542413,22222.525,23082.65,21567.36380231296,19330.9,23410.2,0,813.0,3.1737572744635214,36569678330.49712
2022-08-03,22820.8,22988.7,23623.7,22698.6,174660.0,67527.9,0.1,23026.866666666658,52.77242561434666,62.38729972708131,24525.411218426634,20673.978781573365,22589.6694106407,53.86504653567735,1112.4936167217206,-2038180770.0,-1.6988869361452903,-0.007299270072992692,4.874910681140541,4.874910681140541,22222.525,22244.05,21749.639974174184,19330.9,23410.2,0,814.0,3.173868621174325,36630270235.53537
2022-08-04,22612.1,22822.2,23214.5,22438.7,181190.0,67527.9,0.1,22807.16666666666,51.00912222954467,9.091714838240591,24434.508422106395,20943.58157789361,22591.80565724635,48.469493278179925,1088.4440726701691,-2038361960.0,-2.3361983328294453,-0.009145165813643774,4.813547050783294,4.813547050783294,22300.075,21117.9,21920.979575723733,22612.1,23410.2,0,815.0,3.1739776209550725,36690235946.98898
2022-08-05,23308.2,22613.3,23447.6,22593.5,208900.0,67527.9,0.1,22913.699999999993,56.25892842516577,16.580559569068384,24419.293973560925,21168.626026439073,22660.033689889555,66.4658738366081,1071.7052103365854,-2038153060.0,2.791596104995766,0.03078440304084995,4.597975005948916,4.597975005948916,22647.875,21117.9,22082.038801180308,22612.1,23410.2,0,816.0,3.1740933275910295,36752363594.087296
2022-08-06,22944.2,23308.2,23344.4,22923.6,94440.0,67527.9,0.1,22954.83333333333,53.057183876932754,-5.915566282373561,24240.89239716415,21562.88760283585,22687.09714799531,57.055325749741506,1025.2119810268296,-2038247500.0,2.1540132856048837,-0.015616821547781434,4.468283840913301,4.468283840913301,22647.875,21117.9,22233.43447310949,22612.1,23410.2,0,817.0,3.17420518446287,36813403266.72317
2022-08-07,23175.3,22944.2,23387.7,22852.3,99360.0,67527.9,0.1,23142.566666666662,54.815386952842225,-8.035032189108733,24266.795405353816,21601.934594646187,22733.592657710044,63.029989658738366,990.2254109534848,-2038148140.0,2.6268593266348157,0.010072262271074939,4.272761996407748,4.272761996407748,22647.875,21117.9,22375.74640472292,22612.1,23410.2,0,818.0,3.1743190947920947,36875175471.352066
2022-08-08,23816.3,23175.3,24234.1,23160.6,197940.0,67527.9,0.1,23311.93333333333,59.36187755647204,28.90547736361657,24327.258682894964,21582.08131710504,22836.70764269004,79.60186142709411,996.1735958853787,-2037950200.0,11.80364192865424,0.02765875738393886,4.182738695285913,4.182738695285913,22735.75,21117.9,22509.519620439543,22612.1,23410.2,0,819.0,3.174439008798368,36938907901.28727
2022-08-09,23146.7,23818.1,23912.0,22886.5,169620.0,67527.9,0.1,23379.43333333333,53.325670182774985,4.686228635491204,24321.55616827943,21580.933831720577,22866.230724338606,59.002754511214825,998.2683390364231,-2038119820.0,8.932311153152899,-0.02811519841453114,4.312789032719235,4.312789032719235,22917.875,21294.5,22635.26644321317,22612.1,23410.2,0,820.0,3.174552147985075,37000643058.18927
2022-08-10,23962.9,23150.3,24209.9,22714.7,243610.0,67527.9,0.1,23641.966666666664,58.822165422352484,38.212445354379724,24429.704349214306,21553.77565078569,22970.67541725874,70.34985691867449,1033.7634576766786,-2037876210.0,4.375759529233446,0.03526204599359728,4.31401649081154,4.31401649081154,22940.625,21644.0,24605.3,22612.1,23410.2,0,821.0,3.174672975649554,37064868346.31018
2022-08-11,23935.3,23963.3,24873.5,23864.0,285360.0,67527.9,0.1,23681.633333333328,58.570984031482126,52.23846279814569,24541.31303743095,21568.176962569047,23062.544425138858,61.467060949564605,1032.030353556916,-2038161570.0,0.3576519916142527,-0.001151780460628804,4.31175023315737,4.31175023315737,23230.75,21778.1,22714.7,22612.1,23410.2,0,822.0,3.17479329222104,37129041848.14013
2022-08-12,24398.7,23935.3,24440.8,23616.4,194960.0,67527.9,0.1,24098.966666666664,61.54047494229154,84.52227701760506,24721.025564045325,21582.294435954675,23189.797337030395,80.49942500410714,1017.1996140171361,-2037966610.0,2.6263654450393976,0.019360526084903906,4.169072999861206,4.169072999861206,23230.75,21778.1,22714.7,22612.1,23410.2,0,823.0,3.1749177481347153,37194614340.558716
2022-08-13,24442.5,24398.9,24882.9,24318.7,170590.0,67527.9,0.1,24258.83333333333,61.81904022388111,99.58681855159881,24886.834455101984,21602.525544898017,23309.10235255131,81.98183454709103,984.8424987301979,-2037796020.0,3.4200438347817963,0.0017951776119218277,4.029221637435606,4.029221637435606,23274.15,21782.800000000003,22757.876,22612.1,24442.5,0,824.0,3.175042364506167,37260348827.72145
2022-08-14,24302.8,24442.1,24997.3,24172.2,177250.0,67527.9,0.1,24381.33333333333,60.31838894177042,91.1314255845395,24835.440796925708,21954.00920307429,23403.7402237369,72.85624951145157,973.4323202494694,-2037973270.0,4.2886445754696645,-0.005715454638437145,4.005432790663913,4.005432790663913,23361.65,21840.0,22842.87696,22612.1,24442.5,0,825.0,3.1751654205950204,37325706770.35195
2022-08-15,24101.7,24303.3,25205.7,23784.5,279280.0,67527.9,0.1,24282.33333333333,58.13080750593725,64.25132748897329,24620.492716368477,22454.257283631523,23470.212583381006,60.10119262739429,1005.415725945936,-2038252550.0,3.5687888892708584,-0.008274766693549651,4.1715552261705025,4.1715552261705025,23465.85,21944.2,22972.142342400002,22612.1,24442.5,0,826.0,3.1752863287003197,37390501331.59621
2022-08-16,23856.8,24102.6,24240.8,23693.8,201700.0,67527.9,0.1,24087.099999999995,55.49142826366626,24.290424876868087,24639.84993263262,22524.75006736738,23507.030432582815,51.250451752800814,972.6717455212263,-2038454250.0,3.7766545157164892,-0.010161108967417287,4.07712579022009,4.07712579022009,23465.85,21944.2,23150.826955008,22612.1,24442.5,0,827.0,3.1754046556991122,37454592984.88692
2022-08-17,23338.0,23855.8,24423.5,23191.6,239530.0,67527.9,0.1,23765.499999999996,50.282936964922534,-39.30947695311636,24611.874990232078,22501.525009767924,23490.93229614636,32.500903505601705,991.1880494125674,-2038693780.0,2.266353502068292,-0.02174642030783669,4.247099363324052,4.247099363324052,23465.85,21944.2,25205.7,22612.1,24442.5,0,828.0,3.175517713953075,37517131418.90501
2022-08-18,23203.6,23337.7,23578.0,23131.3,160970.0,67527.9,0.1,23466.133333333328,48.99982500335397,-89.77072936059278,24589.109506141234,22467.220493858767,23463.56731556099,23.35579205267584,952.2960458830984,-2038854750.0,2.615856112435378,-0.005758848230353997,4.104087494540065,4.104087494540065,23465.85,21944.2,25165.418,22612.1,24442.5,0,829.0,3.175629211391906,37579277799.39855
2022-08-19,20831.3,23201.6,23202.3,20807.8,339470.0,67527.9,0.1,22457.633333333328,32.995095699497426,-271.9646128200985,24968.971688829006,21807.068311170995,23212.875190269468,0.534345937833966,1055.4034711771626,-2039194220.0,-10.626732222994487,-0.10223844575841678,5.066431145330165,5.066431145330165,22989.125,21944.2,25084.05328,22612.1,24442.5,0,830.0,3.1757158373940957,37633666206.553955
2022-08-20,21138.9,20830.7,21357.4,20784.8,206940.0,67527.9,0.1,21724.599999999995,35.91784984386396,-355.53023327543065,25140.664067374517,21418.925932625487,23015.35374357714,8.009681286615894,1020.9175089502226,-2038987280.0,-7.868219419286788,0.014766241185139695,4.829567806036372,4.829567806036372,22983.375,21944.2,24827.4780832,22612.1,24442.5,0,831.0,3.175805587018958,37689116762.75225
2022-08-21,21517.2,21138.9,21692.4,21077.4,177520.0,67527.9,0.1,21162.46666666666,39.41782718539375,-367.57468716689743,25205.401230535062,21178.788769464933,22872.67243466503,16.566762423940855,991.9234011680638,-2038809760.0,-7.1545999404538385,0.01789591700608817,4.609909287305336,4.609909287305336,22995.25,22000.050000000003,24504.063836544,22612.1,24442.5,0,832.0,3.1758991604103746,37745855828.6254
2022-08-22,21416.3,21516.8,21517.4,20912.1,251830.0,67527.9,0.1,21357.466666666664,38.808991605664524,-363.9033167125406,25270.118179762965,20956.841820237034,22733.970298030268,14.284421724083327,964.3074439417738,-2039061590.0,-10.077132048219077,-0.004689271838343334,4.502679939773788,4.502679939773788,22995.25,22000.050000000003,24206.52272962048,22612.1,24442.5,0,833.0,3.1759914332128716,37802263084.04722
2022-08-23,21517.2,21416.5,21661.0,20919.6,228650.0,67527.9,0.1,21483.566666666662,39.810178331807016,-336.8662175029274,25312.496139916177,20784.103860083822,22618.087412503577,16.566762423940855,948.3854836602187,-2038832940.0,-7.039880414918757,0.004711364708189558,4.407569217464255,4.407569217464255,22995.25,22000.050000000003,23932.78491125084,22612.1,24442.5,0,834.0,3.1760845516067615,37859018772.885124
2022-08-24,21365.2,21516.2,21832.3,21171.1,202400.0,67527.9,0.1,21432.899999999998,38.780785408479325,-311.97296252493675,25360.728167675457,20611.18183232454,22498.76480178895,13.128548485602508,927.872234827346,-2039035340.0,-10.840507618026201,-0.007064116148941313,4.342913873155159,4.342913873155159,22799.7,22073.95,23680.946118350774,22612.1,24442.5,0,835.0,3.1761758254235155,37915268037.7313
2022-08-25,21565.4,21365.4,21801.2,21324.8,190150.0,67527.9,0.1,21482.599999999995,40.94667627591604,-266.54074245444656,25346.671411865565,20450.95858813444,22409.87291590429,17.657038159650792,895.6242180539642,-2038845190.0,-9.901275521927854,0.009370377997865775,4.15306100537882,4.15306100537882,22799.7,22073.95,23449.254428882712,22612.1,24442.5,0,836.0,3.1762690003426624,37972202247.698944
2022-08-26,20249.9,21564.2,21815.3,20122.4,322160.0,67527.9,0.1,21060.166666666664,32.74798003652096,-306.73766179986137,25470.083492930316,20058.11650706968,22204.161209627688,2.508213168610942,952.5724881929666,-2039167350.0,-17.004184649182125,-0.061000491528095946,4.704084900137613,4.704084900137613,22257.125,22073.95,23236.098074572095,22612.1,24442.5,0,837.0,3.176347596520009,38024563557.32929
2022-08-27,20033.9,20249.9,20343.6,19849.8,187340.0,67527.9,0.1,20616.399999999998,31.628161453036753,-327.6314393393067,25553.32327196248,19660.73672803752,21997.469665853623,3.437330794077599,919.8030247506118,-2039354690.0,-18.036616549043668,-0.01066671934182395,4.59123298384544,4.59123298384544,22026.9,22073.95,22924.728267114886,22612.1,24442.5,0,838.0,3.17642353075383,38076141363.48023
2022-08-28,19550.2,20034.2,20150.8,19542.9,159600.0,67527.9,0.1,19944.66666666666,29.21864321262487,-351.668345495528,25567.842687722274,19219.607312277723,21764.396364343756,0.12891149254784334,897.5242372684252,-2039514290.0,-19.55577135144921,-0.024144075791533437,4.590869849251799,4.590869849251799,21530.95,22073.95,22555.7368750611,19550.2,24442.5,0,839.0,3.176493679362509,38125932412.921295
2022-08-29,20295.8,19551.3,20394.5,19551.2,248040.0,67527.9,0.1,19959.966666666664,37.165070254963105,-297.1626720107835,25531.51693062335,18970.84306937665,21624.530043930066,15.426382002212803,893.7225060349663,-2039266250.0,-15.791002294443965,0.03813771726120452,4.403484987213938,4.403484987213938,21530.95,22073.95,22133.939712552547,19550.2,24442.5,0,840.0,3.1765721451659923,38178449304.87149
2022-08-30,19792.6,20295.6,20558.2,19559.7,308410.0,67527.9,0.1,19879.53333333333,34.361302412378166,-275.3035134362858,25390.742419820435,18694.587580179566,21450.060515936726,5.116174240871966,901.2066127467543,-2039574660.0,-17.035813688340433,-0.024793306989623454,4.553250269023546,4.553250269023546,21530.95,22073.95,21771.19415279519,19550.2,24442.5,0,841.0,3.176644674706792,38229128391.19939
2022-08-31,20043.9,19793.4,20469.1,19793.4,318170.0,67527.9,0.1,20044.099999999995,36.92065888808159,-226.27455140673737,25185.877396429023,18510.31260357098,21316.140466799898,12.416049168546014,885.1561404077004,-2039256490.0,-14.114748478875647,0.012696664409931113,4.416087390216975,4.416087390216975,21530.95,22073.95,21459.232971403864,19550.2,24442.5,0,842.0,3.1767198650347206,38280724950.33892
2022-09-01,20126.1,20049.9,20202.7,19584.4,275080.0,67527.9,0.1,19987.53333333333,37.775326921861556,-173.06210362250704,24836.054667823082,18432.875332176918,21202.803279485623,15.937038858829247,866.0949875214361,-2038981410.0,-13.263028150804187,0.004100998308712134,4.303342364002147,4.303342364002147,21530.95,22073.95,21190.946355407323,19550.2,24442.5,0,843.0,3.1767957727689597,38332617126.75149
2022-09-02,19952.7,20131.6,20428.2,19764.7,272220.0,67527.9,0.1,20040.899999999994,36.647313127952735,-135.9343637878551,24416.176581982072,18403.773418017925,21083.745824296515,17.899886433126568,851.6239169841907,-2039253630.0,-4.217691646704711,-0.00861567814926878,4.268213910820043,4.268213910820043,21526.7,22073.95,20960.2198656503,19550.2,24442.5,0,844.0,3.1768694956907466,38383870624.90769
2022-09-03,19831.4,19952.8,20043.8,19660.7,157850.0,67527.9,0.1,19970.066666666662,35.84103820701047,-107.1997825595721,23954.43792645004,18418.372073549966,20964.474793411133,12.601554992574485,818.1579229138913,-2039411480.0,-6.18527927186372,-0.006079377728327451,4.125568154108591,4.125568154108591,21526.7,22374.300000000003,20761.795084459256,19550.2,24442.5,0,845.0,3.1769416173582896,38434670962.47415
2022-09-04,19999.9,19832.2,20017.8,19594.7,158270.0,67527.9,0.1,19927.999999999996,37.88540335914719,-66.49349580978469,23446.173715040593,18516.456284959404,20872.610527371977,19.961561981305163,789.9394998486132,-2039253210.0,-7.051568047887267,0.008496626561916854,3.949717247829305,3.949717247829305,21212.425000000003,22374.300000000003,20591.14977263496,19550.2,24442.5,0,846.0,3.177015452100928,38486087139.36976
2022-09-05,19793.1,19999.9,20042.9,19650.7,238710.0,67527.9,0.1,19874.8,36.354341502990714,-44.2166838885438,22908.64169637991,18647.618303620093,20769.800000955598,10.92862758801421,761.5295355737123,-2039491920.0,-7.5792737307564835,-0.010340051700258646,3.8474495433949834,3.8474495433949834,21212.425000000003,22374.300000000003,20444.394804466065,19550.2,24442.5,0,847.0,3.1770867089795396,38536732978.50848
2022-09-06,18786.4,19793.4,20169.3,18723.3,402430.0,67527.9,0.1,19526.46666666666,29.998723167414695,-85.60586756421662,22503.680886042108,18597.41911395789,20580.90476276935,2.029591508523711,810.4202830327329,-2039894350.0,-12.691242354953241,-0.050861158686612895,4.313866855984823,4.313866855984823,20802.625,21964.5,20318.185531840816,19550.2,24442.5,0,848.0,3.1771458816029687,38583525113.94948
2022-09-07,19281.5,18786.3,19445.9,18548.4,319100.0,67527.9,0.1,19286.999999999996,35.931070060732594,-68.69349385424903,21959.2048866845,18749.6851133155,20457.151928219886,22.440233860846643,816.6402628161092,-2039575250.0,-9.752775541534836,0.02635417110249949,4.235356496206774,4.235356496206774,20715.175000000003,21877.050000000003,20169.3,19550.2,24442.5,0,849.0,3.1772107663301914,38632221848.30737
2022-09-08,19317.4,19281.5,19444.7,19034.5,291430.0,67527.9,0.1,19128.43333333333,36.35227135040337,-45.27391289738148,21928.58323096962,18628.91676903038,20348.604125532278,23.539134959747788,787.6088154721014,-2039283820.0,-10.424105279753679,0.0018618883385630447,4.077198874962994,4.077198874962994,20692.9,21877.050000000003,20169.3,19550.2,24442.5,0,850.0,3.1772758670209327,38681045077.15814
2022-09-09,21365.2,19318.8,21545.7,19294.1,480370.0,67527.9,0.1,19988.03333333333,54.66201336926269,109.49451260373121,21966.233454873094,18613.896545126903,20445.42278024349,93.97791345544323,892.1796143669515,-2038803450.0,5.5076815194149065,0.10600805491422238,4.175854260044144,4.175854260044144,20962.050000000003,21877.050000000003,18548.4,19550.2,24442.5,0,851.0,3.177363662137919,38737306812.15983
2022-09-10,21650.4,21363.8,21790.6,21139.9,331120.0,67527.9,0.1,20777.666666666664,56.53727941022601,225.74205822002568,21993.27840838762,18600.171591612376,20560.182515458397,95.67577570785278,874.9310704835976,-2038472330.0,8.06882334443119,0.013348810214741658,4.04117739387539,4.04117739387539,20827.725,21877.050000000003,18608.346,19550.2,24442.5,0,852.0,3.1774542482604735,38794554939.47392
2022-09-11,21834.9,21650.4,21836.4,21363.0,297120.0,67527.9,0.1,21616.833333333332,57.75461811939077,304.81062360676367,22078.06632634156,18557.24367365844,20681.584180652833,99.9543795620438,846.2502797347694,-2038175210.0,11.686325459586094,0.00852178250748259,3.8756773776603937,3.8756773776603937,20839.175000000003,21877.050000000003,18735.636160000002,19550.2,24442.5,0,853.0,3.177546538100055,38852438891.21094
2022-09-12,22395.3,21836.6,22465.4,21581.6,431980.0,67527.9,0.1,21960.199999999997,61.300216190930065,379.72555437098083,22276.46927973407,18446.650720265934,20844.79521106685,98.21036507531268,848.9324026108576,-2037743230.0,10.344504774386818,0.025665333937870072,3.7906721616180965,3.7906721616180965,20785.050000000003,21877.050000000003,18921.6819904,19550.2,22395.3,0,854.0,3.1776443587566,38912211985.6858
2022-09-13,20175.5,22395.3,22702.5,19909.6,485320.0,67527.9,0.1,21468.566666666662,45.13931348427446,269.81856266650516,22161.695580524873,18442.45441947513,20781.052810012865,39.168532293396865,987.7872309957964,-2038228550.0,1.93456140173601,-0.09911901157832226,4.895973983275738,4.895973983275738,20750.4,21877.050000000003,19205.179431168,19550.2,22395.3,0,855.0,3.177718246683061,38964239786.787254
2022-09-14,20222.5,20175.5,20503.7,19654.2,374220.0,67527.9,0.1,20931.099999999995,45.46712987130723,193.87718593102022,22001.91141597801,18467.94858402199,20727.857304297355,40.29994463301315,977.9095716389538,-2037854330.0,0.8910441580730224,0.002329558127431852,4.835750137910515,4.835750137910515,20625.45,21877.050000000003,19554.9114880512,19550.2,22395.3,0,856.0,3.1777924503201227,39016435620.07196
2022-09-15,19701.7,20222.3,20321.4,19532.3,358420.0,67527.9,0.1,20033.233333333326,42.44083564734791,106.52821625070521,21989.664808485457,18425.375191514544,20630.128037221413,27.762933005945925,964.4231736647429,-2038212750.0,-2.108704617387362,-0.025753492397082467,4.895126682797641,4.895126682797641,20625.45,21877.050000000003,22702.5,19550.2,22395.3,0,857.0,3.177860519028009,39066683315.36237
2022-09-16,19802.4,19701.9,19883.0,19352.9,315590.0,67527.9,0.1,19908.86666666666,43.22768821512643,56.02804435174812,21985.442096368603,18406.447903631397,20551.29679558128,30.187044125081254,933.4000898315469,-2037897160.0,-0.7532815107729744,0.005111234055944491,4.713570525954161,4.713570525954161,20746.975,21877.050000000003,22639.096,19550.2,22395.3,0,858.0,3.177929536230027,39117302258.440186
2022-09-17,20113.5,19802.8,20178.6,19761.0,204580.0,67527.9,0.1,19872.53333333333,45.69744601769088,44.57082470167404,21989.637939062894,18458.582060937108,20509.601862668776,37.67603090922219,896.5572262721506,-2037692580.0,1.4224916042235975,0.01571021694340069,4.457489876312678,4.457489876312678,20811.875,21877.050000000003,22507.64816,19550.2,22395.3,0,859.0,3.178001881059238,39169076483.49236
2022-09-18,19418.8,20113.9,20113.9,19347.7,273110.0,67527.9,0.1,19778.233333333326,41.36951628524554,-6.103814673321608,21979.72507651904,18380.794923480964,20405.71597098604,20.95279362557469,887.2459958241399,-2037965690.0,-2.9055145275726484,-0.03453899122479931,4.569005272334747,4.569005272334747,20825.275,21877.050000000003,22381.458233600002,19550.2,22395.3,0,860.0,3.1780660417114843,39218218049.260124
2022-09-19,19538.9,19417.4,19666.6,18277.8,423430.0,67527.9,0.1,19690.399999999994,42.38541658962843,-26.69018032536178,21981.31241195127,18353.83758804874,20323.162068987367,28.501367324338418,923.0712818367012,-2037542260.0,-1.2842859380288945,0.0061847282015368155,4.724274559144584,4.724274559144584,20490.15,21741.75,22199.432739584,19550.2,22395.3,0,861.0,3.1781313950397228,39267809489.15892
2022-09-20,18872.4,19538.9,19626.3,18742.6,361180.0,67527.9,0.1,19276.699999999997,38.40808253148167,-77.47676964888922,22008.567274937024,18209.432725062976,20184.99425289333,13.438199199945807,920.2590474197941,-2037903440.0,0.45777796703998636,-0.034111439231481855,4.876216312815509,4.876216312815509,20490.15,21741.75,21885.70212041728,19550.2,22395.3,0,862.0,3.178188673081805,39314791500.54621
2022-09-21,18489.0,18875.1,19758.4,18191.8,446850.0,67527.9,0.1,18966.766666666663,36.298020637811454,-126.28659130419862,22053.564597692366,18000.725402307635,20023.470990713013,6.588777795020744,966.4262583183803,-2038350290.0,-4.110157404766227,-0.020315381191581383,5.2270336866157185,5.2270336866157185,20447.15,21698.75,21597.069950783898,18489.0,22395.3,0,863.0,3.1782410979435314,39360219711.72858
2022-09-22,19404.0,18488.1,19490.9,18371.0,448630.0,67527.9,0.1,18921.8,44.179694279012125,-88.15003438825795,22044.19506857147,17955.22493142853,19964.47375350225,26.873877668654544,977.3886684384961,-2037901660.0,0.4483004959259452,0.04948888528314144,5.03704735332146,5.03704735332146,19897.45,21698.75,21256.542955705507,18489.0,22395.3,0,864.0,3.178304272147492,39409253573.01617
2022-09-23,19293.5,19404.1,19477.3,18554.8,431150.0,67527.9,0.1,19062.16666666666,43.48004344274772,-62.760455632052526,22039.480597795562,17906.149402204435,19900.57149126394,24.424147028177458,973.4680492643178,-2038332810.0,-9.696609439649526,-0.0056947021232734985,5.045575189904982,5.045575189904982,19851.875,21698.75,20950.068660134955,18489.0,22395.3,0,865.0,3.178365947811541,39457846566.25603
2022-09-24,18925.2,19288.4,19310.6,18812.0,258500.0,67527.9,0.1,19207.566666666662,41.141411062707846,-63.0005494677298,22035.42345284779,17802.736547152213,19807.678968286426,16.259117210189135,939.548902888295,-2038591310.0,-12.587296308613238,-0.019089330603571097,4.9645388312318754,4.9645388312318754,19816.175,21698.75,20674.24179412146,18489.0,22395.3,0,866.0,3.1784230540196816,39504977667.35981
2022-09-25,18803.2,18925.1,19125.1,18659.6,209710.0,67527.9,0.1,19007.299999999992,40.36687802604155,-63.430357844899106,22040.984095770214,17698.185904229784,19712.0143046401,13.554437227037962,905.6882669677025,-2038801020.0,-13.88465255164897,-0.006446431213408599,4.816670922862611,4.816670922862611,19816.175,21698.75,20425.99761470931,18489.0,22395.3,0,867.0,3.1784784952539167,39551606485.26085
2022-09-26,19225.7,18803.1,19304.8,18695.2,516030.0,67527.9,0.1,18984.699999999993,44.2791586194379,-29.06325579104532,22027.270912949938,17755.829087050068,19665.698656579138,22.921054381803295,884.539105041438,-2038284990.0,-14.152969596299217,0.0224695796460177,4.600816121345064,4.600816121345064,19800.0,21698.75,20202.57785323838,18489.0,22395.3,0,868.0,3.1785387686247026,39599892602.156166
2022-09-27,19081.0,19228.8,20361.2,18850.4,660120.0,67527.9,0.1,19036.633333333328,43.233031080021576,-10.818842564356203,22030.447491741317,17732.602508258686,19610.013070238267,38.46187118820019,929.2720261099066,-2038945110.0,-5.424896532923595,-0.007526383954810534,4.870143211099558,4.870143211099558,19861.825,21698.75,18191.8,18489.0,22395.3,0,869.0,3.178597129510233,39647595315.100945
2022-09-28,19411.0,19083.4,19757.8,18505.3,581190.0,67527.9,0.1,19239.233333333326,46.3462892123406,26.68268270992587,22030.59573349791,17741.814266502093,19591.05944450129,56.19987093205494,952.3597385306275,-2038363920.0,-4.012856966250464,0.017294691053928002,4.906288900781142,4.906288900781142,19861.825,21698.75,18235.188,18489.0,22395.3,0,870.0,3.1786591701007874,39696577450.58177
2022-09-29,19593.0,19420.2,19631.5,18877.9,449570.0,67527.9,0.1,19361.66666666666,48.03883503936136,64.78247134390779,21833.943025734236,17761.246974265767,19591.24425931069,64.5892873605605,938.1626143498682,-2037914350.0,-0.551729038610885,0.009376126938333895,4.788254041493739,4.788254041493739,19861.825,21698.75,18277.70824,18489.0,22395.3,0,871.0,3.17872311897286,39746252123.71267
2022-09-30,19423.0,19593.4,20174.9,19208.9,490290.0,67527.9,0.1,19475.66666666666,46.56133232266827,78.64851596420061,21540.56779018517,17831.882209814827,19575.220996519194,56.753019268000365,940.1509990391634,-2038404640.0,-1.9159293822971026,-0.008676568162098719,4.840400551094905,4.840400551094905,19906.625,21698.75,18319.3780752,18489.0,22395.3,0,872.0,3.1787848919546837,39795256155.42977
2022-10-01,19311.9,19422.9,19480.3,19172.6,173910.0,67527.9,0.1,19442.633333333328,45.57480201344538,80.17804287281831,21134.747944935472,17985.40205506453,19550.142806374508,51.631787591039064,894.9759276792231,-2038578550.0,-3.9853829517488184,-0.005720022653554979,4.634323539782327,4.634323539782327,19940.2,21698.75,18360.214513696,18489.0,22395.3,0,873.0,3.1788451645554248,39843813013.51094
2022-10-02,19052.2,19311.9,19389.9,18937.3,222820.0,67527.9,0.1,19262.366666666665,43.26707141595421,64.22905232848893,20293.87446633655,18491.965533663453,19502.71968195789,39.660735687286845,863.3776471307074,-2038801370.0,-1.8878612478628882,-0.013447666982534079,4.531642787345857,4.531642787345857,19940.2,21698.75,18400.234223422078,18489.0,22395.3,0,874.0,3.1789021739189836,39891329957.5706
2022-10-03,19628.3,19057.6,19676.0,19001.3,333030.0,67527.9,0.1,19330.799999999996,49.38934690730833,91.35335051494098,20200.61636313472,18530.503636865284,19514.679712247613,66.21646538213326,849.9006723356569,-2038468340.0,0.45754878729098264,0.03023797776634707,4.329975964987579,4.329975964987579,19940.2,21698.75,18439.453538953636,18489.0,22395.3,0,875.0,3.1789657180183406,39941091401.63558
2022-10-04,20340.2,19629.7,20436.1,19506.4,368170.0,67527.9,0.1,19673.566666666662,55.744816080731745,152.51147705959613,20231.849550145907,18511.040449854092,19593.300692033557,95.7269527246804,855.6006243116811,-2038100170.0,7.77749517814374,0.03626906048919176,4.2064513835246515,4.2064513835246515,19958.925,21698.75,18477.888468174562,18489.0,20340.2,0,876.0,3.179037110227251,39993547175.06277
2022-10-05,20157.5,20340.5,20353.8,19761.7,352760.0,67527.9,0.1,20041.999999999996,53.875007050971746,174.3564512644652,20310.73992257913,18477.73007742087,19647.03395945893,86.50912788726944,836.7791511465609,-2038452930.0,9.024284709827466,-0.008982212564281555,4.151205016229993,4.151205016229993,19958.925,21698.75,18556.21692944758,18489.0,20340.2,0,877.0,3.179106254458781,40045310222.184875
2022-10-06,19956.7,20157.5,20436.7,19873.7,370600.0,67527.9,0.1,20151.466666666664,51.81778370492575,168.8630602239391,20334.52537497608,18469.37462502392,19676.525963319986,75.14756135445792,817.2234974932352,-2038823530.0,2.848381776953209,-0.009961552771921123,4.0949831259338225,4.0949831259338225,19959.075,21307.65,18631.412252269674,18489.0,20340.2,0,878.0,3.17917292941204,40096303048.17034
2022-10-07,19531.3,19962.4,20051.4,19352.1,263500.0,67527.9,0.1,19881.83333333333,47.66523879765022,131.80416375030765,20249.420210597855,18496.259789402146,19662.69491919427,53.122087604846186,808.8003905294329,-2039087030.0,1.2325394562935668,-0.02131614946358873,4.1410473984293565,4.1410473984293565,20052.225000000002,21307.65,18739.729517133495,18489.0,20340.2,0,879.0,3.1792345320369098,40145644237.6749
2022-10-08,19415.0,19530.2,19612.2,19274.7,113500.0,67527.9,0.1,19634.33333333333,46.566545592420354,96.32894012234698,20249.191927127154,18496.10807287285,19639.104926890053,47.10054882468676,775.1360769201876,-2039200530.0,2.5880836133832097,-0.005954544756365365,3.9924598347678995,3.9924598347678995,20067.075,20884.9,18841.547746105487,18489.0,20340.2,0,880.0,3.179294583724214,40194516926.610016
2022-10-09,19441.0,19416.3,19552.1,19329.6,127530.0,67527.9,0.1,19462.43333333333,46.86143745210631,72.56770221719239,20241.617940003624,18493.89205999637,19620.23779099576,48.44672258465362,735.6620714258886,-2039073000.0,3.391975833900609,0.001339170744269813,3.7840752606650305,3.7840752606650305,19517.375,20697.05,18937.25688133916,18489.0,20340.2,0,881.0,3.1793547363249193,40243477911.225075
2022-10-10,19134.6,19441.7,19520.7,19057.0,243770.0,67527.9,0.1,19330.199999999993,43.79407572803412,36.015779054768245,20232.185083817934,18529.54491618206,19573.986572805687,32.58258258258252,716.2362091811823,-2039316770.0,-0.4738449055171057,-0.015760506146803244,3.7431470173464945,3.7431470173464945,19500.625,20447.15,19027.22346845881,18489.0,20340.2,0,882.0,3.179411102153744,40291210845.12085
2022-10-11,19059.1,19134.3,19261.3,18868.7,288570.0,67527.9,0.1,19211.566666666662,43.04637323503258,8.016425710992905,20172.991406465128,18645.748593534878,19524.949756348004,28.67350108729413,693.119337096812,-2039605340.0,-0.11477385881243883,-0.003945731815663822,3.6366845081709633,3.6366845081709633,19483.475,20447.15,20436.7,18489.0,20340.2,0,883.0,3.1794663772775222,40338625190.90556
2022-10-12,19154.8,19058.5,19212.6,19010.6,242180.0,67527.9,0.1,19116.16666666666,44.34349008934994,-2.2472572024131523,20168.56539952221,18625.25460047779,19489.697398600576,18.246173469387664,658.0393844470398,-2039363160.0,-1.3198701767039345,0.005021223457561064,3.4353759081120128,3.4353759081120128,19483.475,20447.15,20405.34,18489.0,20340.2,0,884.0,3.179522584620717,40386406347.139366
2022-10-13,19379.8,19154.6,19494.4,18207.9,455130.0,67527.9,0.1,19197.899999999994,47.377945639805255,7.400219616508821,20171.483011001365,18630.966988998633,19479.230979686236,52.57986360373287,702.9294284151083,-2038908030.0,-1.0881437247996772,0.011746402990373106,3.627124265550255,3.627124265550255,19318.275,20447.15,20374.6072,18489.0,20340.2,0,885.0,3.179581227660359,40435066498.40961
2022-10-14,19181.8,19379.8,19933.9,19098.6,400450.0,67527.9,0.1,19238.799999999996,45.05023379969844,2.0101505435621334,20160.344805579425,18667.765194420575,19450.904219716118,43.69615936826984,712.3844692426007,-2039308480.0,-1.2418267003037673,-0.010216823703031008,3.7138562034981115,3.7138562034981115,19318.275,20447.15,20287.938911999998,18489.0,20340.2,0,886.0,3.179637355056784,40482923861.80196
2022-10-15,19068.7,19181.7,19218.7,19000.8,123660.0,67527.9,0.1,19210.099999999995,43.72863094201622,-7.109066522846973,20138.293304546565,18716.36669545343,19414.50381783839,38.62167982770996,677.0641500109865,-2039432140.0,-1.2593271506169808,-0.005896214119634147,3.5506570978146725,3.5506570978146725,19221.95,20447.15,20204.73735552,18489.0,20340.2,0,887.0,3.1796919511074084,40530310722.64721
2022-10-16,19261.9,19068.8,19411.9,19066.0,140950.0,67527.9,0.1,19170.799999999992,46.609963194735684,1.4759565494319418,20138.222647941533,18720.057352058466,19399.970120901402,47.29002153625271,653.4095678673448,-2039291190.0,1.1006602911999703,0.01013178664513048,3.3922383973924934,3.3922383973924934,19192.575,20447.15,20124.8638612992,18489.0,20340.2,0,888.0,3.1797486223962355,40578455459.46746
2022-10-17,19548.2,19262.2,19663.5,19163.6,248400.0,67527.9,0.1,19292.93333333333,50.643183186913504,26.645673754872803,20144.750105100586,18760.249894899414,19414.087252244128,60.135498923187356,642.4445987339631,-2039042790.0,-0.4080842457064471,0.01486353890322345,3.286464220408851,3.286464220408851,19196.600000000002,20447.15,20048.185306847234,18489.0,20340.2,0,889.0,3.1798084202353674,40627719749.51486
2022-10-18,19328.2,19548.4,19692.9,19102.8,290070.0,67527.9,0.1,19379.43333333333,47.66354166977736,28.519303705933595,20142.54102654262,18754.178973457372,19405.907513935163,50.26471643933954,638.7056988243945,-2039332860.0,-4.975368973756403,-0.011254233126323676,3.304527575378952,3.304527575378952,19196.600000000002,20447.15,19974.573894573343,18489.0,20340.2,0,890.0,3.1798654677833,40676098023.289894
2022-10-19,19123.9,19328.2,19358.6,19101.2,209280.0,67527.9,0.1,19333.43333333333,45.014862716587714,16.630114768030182,20129.57333468787,18720.236665312128,19379.049655465147,41.098348887293625,611.4695774797948,-2039542140.0,-5.127619992558594,-0.010570047909272406,3.1974104522602333,3.1974104522602333,19196.600000000002,20447.15,19903.90693879041,18489.0,20340.2,0,891.0,3.179919923355106,40723641101.49579
2022-10-20,19042.9,19125.1,19334.5,18935.6,253200.0,67527.9,0.1,19164.999999999996,43.97154619755555,4.568723063941121,20129.98393160723,18681.816068392774,19347.035402563703,45.294277190127474,596.2860362312382,-2039795340.0,-4.578913347397111,-0.00423553773027463,3.1312774642057577,3.1312774642057577,19196.600000000002,20447.15,19836.066661238794,19042.9,20340.2,0,892.0,3.1799732264780767,40770839259.914375
2022-10-21,19162.6,19042.9,19245.5,18703.3,294660.0,67527.9,0.1,19109.8,45.96465893952092,5.829468169950758,20129.28820900423,18667.581790995773,19329.470126129065,55.3128621089222,592.422747929007,-2039500680.0,-1.8877391673877353,0.006285807308760605,3.091557241339938,3.091557241339938,19196.600000000002,20447.15,19770.93999478924,19042.9,20340.2,0,893.0,3.1800277446762784,40818503591.265686
2022-10-22,19204.8,19162.6,19249.9,19116.1,118240.0,67527.9,0.1,19136.76666666666,46.68473403718678,10.41502471110067,20125.39573972393,18686.73426027607,19317.59678078344,57.75782155272293,559.6639802197924,-2039382440.0,-1.082668040175126,0.002202206381179961,2.914188016640592,2.914188016640592,19320.45,20447.15,19708.418394997672,19042.9,20340.2,0,894.0,3.1800825615672133,40866320787.25147
2022-10-23,19571.2,19204.8,19680.9,19092.5,180630.0,67527.9,0.1,19312.866666666658,52.59191173198738,37.51007485796404,20119.436461122303,18686.983538877696,19341.749468327875,78.98609501738119,561.7165530612359,-2039201810.0,0.669718635872644,0.019078563692410233,2.870118097312561,2.870118097312561,19260.2,20447.15,18207.9,19042.9,20340.2,0,895.0,3.180141434989466,40915583948.43998
2022-10-24,19331.5,19571.2,19588.6,19177.2,286940.0,67527.9,0.1,19369.16666666666,48.783867900751915,38.52789312638899,19925.70082374317,18779.849176256834,19340.773328487125,65.09849362688288,550.9796564140046,-2039488750.0,1.0290259529856987,-0.012247588293001987,2.850165048827068,2.850165048827068,19260.2,20447.15,18237.36,19042.9,20340.2,0,896.0,3.1801973364859224,40963877488.55314
2022-10-25,20082.7,19331.8,20406.9,19249.0,371540.0,67527.9,0.1,19661.799999999996,58.841853658403274,86.29676215294438,19901.510958854127,18796.559041145872,19411.433011488352,85.25693497044108,594.3311095272901,-2039117210.0,5.370662832977435,0.03885885730543426,2.959418352747838,2.959418352747838,19438.7,20447.15,18266.2308,19042.9,20340.2,0,897.0,3.180261616390362,41015111811.9619
2022-10-26,20769.5,20086.8,20981.5,20062.9,427990.0,67527.9,0.1,20061.233333333326,65.51066524560142,156.55761570080227,20182.3389007245,18597.0110992755,19540.772724679937,92.35650418229017,617.4931731324834,-2038689220.0,8.429740848246919,0.03419858883516658,2.9730767381616476,2.9730767381616476,19718.550000000003,20447.15,18351.857568,19042.9,20340.2,0,898.0,3.1803332560841575,41068946289.47535
2022-10-27,20292.9,20769.5,20867.9,20231.6,365490.0,67527.9,0.1,20381.699999999993,58.43490051140526,162.63052280092563,20311.874486218785,18543.63551378121,19612.40389375804,69.77438328504968,618.8365179087349,-2039054710.0,4.711606930928091,-0.022947109944871036,3.0495223349483553,3.0495223349483553,19718.550000000003,20447.15,18509.636113919998,19042.9,20340.2,0,899.0,3.1803994685211348,41120969636.37445
2022-10-28,20594.4,20293.0,20744.0,20058.2,318900.0,67527.9,0.1,20552.266666666663,61.283769045943785,177.43917312787644,20506.498011758875,18466.951988241122,19705.927332447754,83.00851549468887,623.6196237723967,-2038735810.0,7.3642723831965835,0.01485741318392142,3.0281029006545306,3.0281029006545306,19718.550000000003,20447.15,18657.9479470848,19042.9,20340.2,0,900.0,3.180468792384447,41174130817.67701
2022-10-29,20809.8,20594.2,21038.1,20561.9,276540.0,67527.9,0.1,20565.699999999997,63.22314173763895,191.04780352714218,20726.014348597742,18384.31565140226,19811.058062690827,90.22186054480044,613.0896506457967,-2038459270.0,9.130669631385455,0.010459153944761601,2.9461583035194803,2.9461583035194803,19746.85,20447.15,18797.36107025971,19042.9,20340.2,0,901.0,3.180540248790222,41228094797.20791
2022-10-30,20626.3,20809.4,20922.3,20522.5,207630.0,67527.9,0.1,20676.83333333333,60.44531042310981,177.29859510516218,20871.815844475143,18387.684155524857,19888.70015195837,82.36251499057738,597.8546755996683,-2038666900.0,7.083413370435926,-0.008817960768484068,2.898506642488805,2.898506642488805,19844.15,20447.15,18976.620184638934,19042.9,20340.2,0,902.0,3.1806095078320045,41281361493.09413
2022-10-31,20496.3,20626.0,20822.4,20260.0,327470.0,67527.9,0.1,20644.133333333328,58.48481914564165,150.13292519658484,20969.33458350059,18433.88541649941,19946.566804152808,76.79458626006513,595.3221987711206,-2038994370.0,4.850062921394289,-0.006302633046159523,2.9045349588516984,2.9045349588516984,19844.15,20447.15,19141.53856986782,19042.9,20340.2,0,903.0,3.1806771408659777,41334126562.83095
2022-11-01,20483.5,20496.1,20676.6,20348.1,302720.0,67527.9,0.1,20535.366666666658,58.28436931013636,123.11939334815065,21053.32370203771,18482.766297962295,19997.7032989954,76.24635943121471,576.2634702874691,-2039297090.0,5.977276725199446,-0.000624502959070572,2.8133056864670056,2.8133056864670056,19865.325,20447.15,19293.263484278392,19042.9,20340.2,0,904.0,3.1807444290837696,41386833778.00975
2022-11-02,20154.4,20482.9,20778.3,20065.8,420230.0,67527.9,0.1,20378.066666666662,53.23260725242358,77.15117159818672,21089.60331723958,18523.946682760423,20012.62679432917,62.15093369881801,585.9946509812214,-2039717320.0,5.3885452235161235,-0.0160665901823418,2.9075271453440505,2.9075271453440505,19883.275,20447.15,19432.85040553612,19042.9,20340.2,0,905.0,3.180807876167957,41438264293.136086
2022-11-03,20206.4,20154.0,20384.5,20066.6,347230.0,67527.9,0.1,20281.43333333333,53.912335981935165,45.857316129092766,21118.549214976898,18597.460785023104,20031.081385345442,64.37810519102291,566.8450330539914,-2039370090.0,6.109888724931602,0.002580081768745357,2.805274730055781,2.805274730055781,20085.575,20447.15,19561.27037309323,19042.9,20340.2,0,906.0,3.1808717001655586,41489884865.9101
2022-11-04,21145.9,20206.4,21281.9,20184.6,499500.0,67527.9,0.1,20502.233333333326,64.0724429289515,81.93520330820274,21285.858334239907,18637.871665760096,20137.254586741117,93.78825248926647,604.7346735501351,-2038870590.0,10.34984814169269,0.046495169847177165,2.8598199818883807,2.8598199818883807,20207.475000000002,19736.85,19679.416743245773,19042.9,20340.2,0,907.0,3.18094552257536,41545057727.76214
2022-11-05,21301.6,21145.7,21464.7,21084.1,261230.00000000003,67527.9,0.1,20884.63333333333,65.43250281281439,108.14209930743345,21468.251068787577,18659.44893121242,20248.144626099107,93.12452575668148,588.7250540108398,-2038609360.0,10.918103807381485,0.00736312949555229,2.76375978335355,2.76375978335355,20298.875,19828.25,19839.665068921197,19042.9,21301.6,0,908.0,3.181020782804668,41600801836.14383
2022-11-06,20916.3,21298.7,21360.4,20901.0,242260.0,67527.9,0.1,21121.26666666666,59.43628902497653,92.01640663029536,21562.562869625166,18701.94713037483,20311.778471232526,76.02622950819666,579.4875501529228,-2038851620.0,6.872853989535637,-0.018087843166710416,2.7705069737617207,2.7705069737617207,20300.775,19828.25,20034.66926065065,19042.9,21301.6,0,909.0,3.1810917387938606,41655107558.96963
2022-11-07,20589.0,20916.3,21055.4,20410.5,414240.0,67527.9,0.1,20935.633333333328,54.83897094814247,53.69450344362292,21588.9616552342,18801.628344765802,20338.180521591334,60.47750146680505,584.1598679991428,-2039265860.0,6.504927191371595,-0.015648083073966257,2.8372425469869484,2.8372425469869484,20300.775,19828.25,20206.272949372575,19042.9,21301.6,0,910.0,3.1811589510294014,41708165574.32824
2022-11-08,18527.4,20589.0,20667.5,17260.0,865100.0,67527.9,0.1,20010.899999999998,35.96748718436082,-107.33201198298349,21670.643053310378,18660.296946689625,20165.72523382073,30.14245962851098,785.8270202849183,-2040130960.0,-7.744476589303227,-0.10013113798630324,4.241431718886181,4.241431718886181,19362.35,19362.35,21464.7,19042.9,21301.6,1,911.0,3.181202300744566,41752904714.574684
2022-11-09,15886.9,18538.9,18583.8,15603.3,869570.0,67527.9,0.1,18334.43333333333,24.390349029900378,-373.52553937354776,22368.84388779643,17646.496112203567,19758.218068694943,4.838434503702192,942.5893759788527,-2041000530.0,-23.508510074869402,-0.14251864805639225,5.9331233656588305,5.9331233656588305,18534.0,18534.0,21380.606,19042.9,21301.6,1,912.0,3.1812109921756986,41785502811.6511
2022-11-10,17589.1,15887.0,18138.2,15799.3,720740.0,67527.9,0.1,17334.466666666664,38.200155655997776,-413.6890989481223,22493.649092448282,17364.340907551723,19551.635395485904,33.87927798819393,1042.3258491232205,-2040279790.0,-13.323871896081894,0.10714488037313763,5.9259760256250775,5.9259760256250775,18534.0,18534.0,21149.513759999998,19042.9,21301.6,0,913.0,3.1812423333383286,41826087922.817085
2022-11-11,17049.9,17589.1,17679.4,16435.5,466350.0,67527.9,0.1,16841.966666666664,35.95963175825776,-452.1740440074534,22664.48066211866,16978.01933788134,19313.374881630105,24.680110553792645,1056.7240027572764,-2040746140.0,-17.210989395175385,-0.030655349051400993,6.197831088494808,6.197831088494808,18534.0,18534.0,20927.6652096,19042.9,21301.6,0,914.0,3.1812665180009545,41864186186.6293
2022-11-12,16795.2,17049.9,17100.8,16633.9,192910.0,67527.9,0.1,17144.733333333326,34.91780588416685,-468.4027001276057,22817.061548184516,16547.838451815485,19073.548702427237,20.334732316511435,1014.5937168460422,-2040939050.0,-19.291872098722713,-0.014938504038146894,6.040974307218979,6.040974307218979,18534.0,18534.0,20714.690601216,19042.9,21301.6,0,915.0,3.1812871560227114,41901062903.20539
2022-11-13,16324.5,16803.9,16946.5,16274.9,210800.0,67527.9,0.1,16723.199999999997,33.01418516591454,-482.54784342915326,22991.276423371863,16072.923576628136,18811.73454029131,12.304227658921086,990.0941656427534,-2041149850.0,-20.85589756766846,-0.02802586453272371,6.065081109024799,6.065081109024799,18534.0,18534.0,20510.234977167358,19042.9,21301.6,0,916.0,3.1813012547602972,41935658946.871284
2022-11-14,16613.7,16325.0,17158.4,15834.0,442460.0,67527.9,0.1,16577.799999999996,35.34638138662102,-445.0507025951306,23031.29775849955,15686.002241500451,18602.397917406422,17.238202477223894,1013.9731538111282,-2040707390.0,-18.942931163185545,0.01771570339060924,6.103235003708555,6.103235003708555,18507.925,18534.0,20313.957578080663,19042.9,21301.6,0,917.0,3.1813191183633296,41971606530.879524
2022-11-15,16895.1,16615.0,17112.0,16543.9,337150.0,67527.9,0.1,16611.099999999995,37.62212486664133,-376.63425782790034,22927.103305472752,15402.756694527247,18439.79811574867,22.039103285904375,982.1250713960475,-2040370240.0,-17.518490492347507,0.016937828418714496,5.813076403194107,5.813076403194107,18431.675,18534.0,20125.531274957437,19042.9,21301.6,0,918.0,3.1813405723131547,42008847512.75026
2022-11-16,16540.5,16895.4,16993.4,16408.2,295730.0,67527.9,0.1,16683.099999999995,35.906950359952575,-332.15430397847103,22867.83775643765,15086.782243562344,18258.91258091546,15.989354079230226,953.7732805820441,-2040665970.0,-17.931072123208832,-0.020988333895626488,5.766290502596924,5.766290502596924,18334.7,18534.0,19944.64202395914,19042.9,21301.6,0,919.0,3.1813571057839347,42044374852.07398
2022-11-17,16691.2,16540.5,16739.7,16425.8,257000.0,67527.9,0.1,16708.93333333333,37.21693649831183,-272.00487921611716,22719.931138409273,14844.36886159073,18109.606620828275,18.56041218821444,908.0680462547554,-2040408970.0,-17.396468445640988,0.009110970043227251,5.440400008715702,5.440400008715702,17813.775,18534.0,19770.988343000772,19042.9,21301.6,0,920.0,3.181375499891768,42080584667.73098
2022-11-18,16638.3,16715.4,16846.3,16553.0,241960.0,67527.9,0.1,16623.33333333333,36.93158457206898,-217.56058810450713,22501.55817607291,14645.59182392709,17969.48218074939,17.657897430647964,864.1560429508443,-2040650930.0,-21.31666185880006,-0.0031693347392638405,5.193776064566959,5.193776064566959,17751.375,18534.0,19604.280809280743,19042.9,21301.6,0,921.0,3.181393013515836,42116507419.06131
2022-11-19,16699.2,16652.2,16814.9,16608.9,114890.0,67527.9,0.1,16676.233333333326,37.52545214600344,-161.7879092126492,22267.560734487382,14486.879265512614,17848.502925439923,19.03562557537651,817.144897025784,-2040536040.0,-21.605888759529794,0.0036602297109682436,4.893317626148462,4.893317626148462,17645.35,18534.0,19444.241576909513,19042.9,21301.6,0,922.0,3.1814111748144307,42152684263.328125
2022-11-20,16286.7,16699.3,16749.3,16209.2,172830.0,67527.9,0.1,16541.399999999998,35.11363266736811,-137.94885326263295,22031.12849931161,14302.351500688386,17699.75978968374,12.53461968782673,797.3559758096565,-2040708870.0,-22.133933821947473,-0.024701782121299254,4.8957491438391845,4.8957491438391845,17515.1,18534.0,19290.603913833133,19042.9,21301.6,0,923.0,3.1814235724703233,42186840046.25447
2022-11-21,15776.2,16278.6,16287.9,15504.2,372150.0,67527.9,0.1,16254.033333333331,32.34313696179666,-141.31457393391327,21776.030076793217,14086.719923206783,17516.56361923767,5.267948792438945,796.3805489661096,-2041081020.0,-23.375588906697747,-0.031344594055272124,5.047987151317235,5.047987151317235,17407.875,18484.45,19143.111757279807,15776.2,21301.6,0,924.0,3.1814286835575616,42218428657.48933
2022-11-22,16212.9,15776.6,16274.6,15620.4,287210.0,67527.9,0.1,16091.933333333329,36.92764654608583,-100.7851092410541,21506.3394579076,13962.260542092397,17392.405179310274,23.012728925834498,786.2247954685305,-2040793810.0,-12.492308688752884,0.02768093710779529,4.849377936510621,4.849377936510621,17407.875,18484.45,18924.77705184302,15776.2,21301.6,0,925.0,3.1814397372795207,42252147088.470245
2022-11-23,16623.9,16216.9,16677.6,16162.3,305080.0,67527.9,0.1,16204.333333333328,40.98101494666613,-36.278018573396025,21177.91989296609,13932.43010703391,17319.21420985215,42.509491268033436,766.8730243636354,-2040488730.0,4.639042229761639,0.02535018411265111,4.613075297394928,4.613075297394928,17396.275,18484.45,18719.54242873244,15776.2,21301.6,0,926.0,3.1814562209289585,42287818135.94066
2022-11-24,16601.2,16604.9,16785.6,16472.0,229590.0,67527.9,0.1,16479.333333333332,40.82496215201197,12.281179390647935,20571.56297957267,14084.317020427326,17250.831904151946,50.43214417065096,734.4963797662328,-2040718320.0,-5.616546611253549,-0.0013655038829637478,4.424357153496331,4.424357153496331,17366.625,18484.45,18526.62188300849,15776.2,21301.6,0,927.0,3.1814722307199816,42323344233.78564
2022-11-25,16512.3,16600.6,16611.8,16360.9,204070.0,67527.9,0.1,16579.13333333333,40.17967086291176,44.04627313575213,19784.170652612127,14392.779347387872,17180.49553232795,60.94184500060441,699.9537812115019,-2040922390.0,-3.1530976721271218,-0.005355034575813877,4.23898415854546,4.23898415854546,17329.85,18484.45,18345.27657002798,15776.2,21301.6,0,928.0,3.181486872876825,42358406374.02822
2022-11-26,16456.5,16512.3,16686.3,16387.9,194940.0,67527.9,0.1,16523.33333333333,39.754916373974424,65.6319433150909,18919.09317224512,14811.87682775488,17111.543576868145,57.56861322693742,671.271368267823,-2041117330.0,-2.016647613603891,-0.0033792990679675228,4.079065222057078,4.079065222057078,17329.85,18484.45,18174.811975826302,15776.2,21301.6,0,929.0,3.181500591850459,42393161874.275986
2022-11-27,16425.6,16456.4,16595.4,16414.6,173250.0,67527.9,0.1,16464.8,39.50585747780638,81.14526286645116,17801.760062513684,15512.869937486312,17046.215617166417,55.70064079313248,636.237699105836,-2041290580.0,0.6193145272443171,-0.0018776775134445867,3.8734518014917936,3.8734518014917936,17322.0,18484.45,18014.575257276723,15776.2,21301.6,0,930.0,3.1815137246800194,42427730247.26401
2022-11-28,16211.7,16426.1,16481.4,16013.5,284840.0,67527.9,0.1,16364.599999999997,37.743126348227996,80.17573789304242,17313.79990127284,15769.260098727158,16966.737939341045,44.00422938176392,624.2135777411335,-2041575420.0,-2.4196897741020966,-0.013022355347749759,3.8503893961838265,3.8503893961838265,17314.675,18484.45,17863.95274184012,15776.2,21301.6,0,931.0,3.1815237652623782,42461215443.0015
2022-11-29,16440.4,16211.9,16531.4,16100.1,271580.0,67527.9,0.1,16359.23333333333,40.78536781029059,96.98887067959367,17283.119943051315,15855.290056948688,16916.610516546658,62.86596830513029,610.4340364739097,-2041303840.0,-2.691312865860499,0.014107095492761346,3.713012070715491,3.713012070715491,17314.675,18484.45,17722.36757732971,15776.2,21301.6,0,932.0,3.181536768550669,42495780189.0219
2022-11-30,17163.9,16440.8,17215.5,16433.2,348220.0,67527.9,0.1,16605.333333333332,49.236501504587494,155.42237944157387,17156.682925475292,15939.207074524707,16940.161895923167,96.98474843686094,622.7101767257733,-2040955620.0,3.768930806202965,0.04400744507432908,3.6280226331181913,3.6280226331181913,17451.2,18484.45,17589.27752268993,15776.2,21301.6,0,933.0,3.181559216038016,42533747255.260086
2022-12-01,16972.0,17163.4,17244.7,16868.9,266140.0,67527.9,0.1,16858.766666666663,47.307907562138396,178.10662395803377,17140.769315936697,15947.3306840633,16943.19409631144,84.33208848032172,605.0737355310752,-2041221760.0,1.6823236196318974,-0.011180442673285329,3.5651292454105303,3.5651292454105303,17530.7,18484.45,17464.172871328534,15776.2,21301.6,0,934.0,3.181578983186324,42570781691.243095
2022-12-02,17093.6,16972.2,17096.2,16799.9,227010.0,67527.9,0.1,17076.499999999996,48.679692854443815,196.79567322581545,17193.768623511394,15924.171376488606,16957.5184680913,91.3185866130421,583.0184687074269,-2040994750.0,2.7364574505808847,0.00716474192788108,3.4107412640252894,3.4107412640252894,17454.45,18484.45,17346.57449904882,15776.2,21301.6,0,935.0,3.181600172525976,42608352123.655075
2022-12-03,16884.5,17093.4,17132.6,16862.1,169290.0,67527.9,0.1,16983.366666666665,46.440739896781096,190.44786209526217,17227.307420749374,15946.632579250629,16950.56432827308,79.30479747199077,560.6957209426107,-2041164040.0,1.109633994442843,-0.012232648476622754,3.3207718377364492,3.3207718377364492,17357.475,18484.45,17244.7,15776.2,21301.6,0,936.0,3.181618446211277,42644902947.00285
2022-12-04,17112.6,16884.8,17198.1,16881.6,197120.0,67527.9,0.1,17030.23333333333,49.18631762839691,196.20720808006945,17292.104297998696,15931.725702001306,16965.996297008976,92.41022694627966,543.25316944671,-2040966920.0,5.071008859990039,0.013509431727323884,3.174579955393745,3.174579955393745,16836.55,18484.45,15504.2,15776.2,21301.6,0,937.0,3.181639542558918,42682492874.06582
2022-12-05,16966.5,17106.9,17395.2,16886.9,268720.0,67527.9,0.1,16987.866666666665,47.50650115884894,184.92540544036422,17302.299281383228,15928.670718616775,16966.044268722406,75.84516565246786,540.7565144862307,-2041235640.0,7.544909420519512,-0.008537568808947738,3.1872013349024884,3.1872013349024884,16762.775,18484.45,15538.078000000001,15776.2,21301.6,0,938.0,3.181658556934572,42719361057.42108
2022-12-06,17089.3,16966.3,17101.1,16914.9,246190.0,67527.9,0.1,17056.13333333333,49.080605757408485,180.29303911639704,17358.80042457606,15927.049575423938,16977.782909796464,77.86060649923998,515.4310491657855,-2040989450.0,5.405572106162375,0.007237792119765274,3.0161039314997424,3.0161039314997424,16648.075,18484.45,15612.36288,15776.2,21301.6,0,939.0,3.181679009034803,42756772232.872345
2022-12-07,16835.2,17089.4,17126.7,16715.3,244360.0,67527.9,0.1,16963.66666666666,46.00637101674671,155.60744515291572,17370.679025394318,15929.570974605682,16964.203585053943,59.47021784757909,508.000259939658,-2041233810.0,1.2710615439216986,-0.014868953087604386,3.0174887137643625,3.0174887137643625,16598.675000000003,18484.45,15683.676364800001,15776.2,21301.6,0,940.0,3.1816959532751565,42792946310.36947
2022-12-08,17225.7,16835.2,17294.2,16765.8,261640.0,67527.9,0.1,17050.066666666662,51.0778401939041,160.4291414803556,17442.369213689228,15916.620786310777,16989.108005524995,87.73250343779402,509.45738422968253,-2040972170.0,3.7617762571380378,0.023195447633529653,2.95754241760673,2.95754241760673,16681.95,18484.45,15752.137310208002,15776.2,21301.6,0,941.0,3.1817178373378887,42830925641.477
2022-12-09,17125.7,17225.6,17288.6,17082.1,260839.99999999997,67527.9,0.1,17062.199999999997,49.788162999438704,151.82445985449885,17488.1573904572,15913.4826095428,17002.116766903568,80.49504233914743,487.8175710704195,-2041233010.0,3.7148065381564135,-0.005805279321014489,2.8484533249468313,2.8484533249468313,16752.475,18484.45,15817.859817799681,15776.2,21301.6,0,942.0,3.1817382537553387,42868402809.58111
2022-12-10,17127.2,17125.7,17220.5,17105.7,148810.0,67527.9,0.1,17159.53333333333,49.80863467769351,141.38691049162298,17526.998473442512,15958.69152655749,17014.029455769894,80.60360425562713,461.1734588511038,-2041084200.0,4.075593230638354,8.758766065031232e-05,2.692637785809145,2.692637785809145,16752.475,18484.45,15880.953425087693,15776.2,21301.6,0,943.0,3.181758519655574,42905852133.120125
2022-12-11,17093.3,17127.0,17262.9,17080.6,167200.0,67527.9,0.1,17115.399999999998,49.31924268561217,127.76631405678344,17468.42143819339,16148.97856180661,17021.579031410856,78.15010494318584,441.25392607602515,-2041251400.0,4.064996103643098,-0.00197930776776134,2.5814437591104418,2.5814437591104418,16752.475,18484.45,15941.523288084185,15776.2,21301.6,0,944.0,3.1817781746850984,42943107055.12692
2022-12-12,17210.4,17093.2,17232.5,16878.5,249390.0,67527.9,0.1,17143.633333333328,51.106333837479376,122.2099215174513,17480.313983426287,16236.836016573712,17039.5619808003,85.73083159601582,435.02150278488045,-2041002010.0,6.160365661836826,0.006850637384238301,2.527666427188679,2.527666427188679,16752.475,18484.45,15999.670356560817,15776.2,21301.6,0,945.0,3.181799179740671,42980876528.94125
2022-12-13,17778.6,17210.9,17951.6,17094.5,328710.0,67527.9,0.1,17360.766666666663,58.7137631569054,150.50889804512997,17645.350994465985,16187.269005534015,17109.946554057413,88.60642781875656,465.1699668716746,-2040673300.0,8.139704630057643,0.0330149212104307,2.6164600523757473,2.6164600523757473,17030.675,18484.45,16055.491542298385,15776.2,21301.6,0,946.0,3.181827241706091,43021228835.53198
2022-12-14,17796.4,17778.6,18351.8,17682.1,318980.0,67527.9,0.1,17595.133333333328,58.929349063022705,163.07600251639153,17783.701450856115,16168.438549143884,17175.323072718613,66.06171707913242,479.7792549522693,-2040354320.0,3.6850599222787355,0.0010012036943292113,2.695934317908505,2.695934317908505,17230.775,18484.45,16169.258049760481,15776.2,17796.4,0,947.0,3.1818553514607917,43061630214.555824
2022-12-15,17356.1,17796.4,17846.1,17298.2,263440.0,67527.9,0.1,17643.699999999993,51.73323455529299,135.5173309856711,17812.625541556252,16223.894458443752,17192.539922935888,39.15673693858841,484.6450224556785,-2040617760.0,2.2631392882394445,-0.02474095884560934,2.792361316515107,2.792361316515107,17230.775,18484.45,16343.861405779642,15776.2,17796.4,0,948.0,3.1818777148539463,43099978137.95822
2022-12-16,16629.6,17356.7,17518.5,16542.4,303560.0,67527.9,0.1,17260.699999999993,42.50919915036868,65.67978472828267,17800.098960718246,16253.731039281756,17138.926596941994,4.81927710843358,519.74894942313,-2040921320.0,-2.714466232976085,-0.04185848203225384,3.125444685519375,3.125444685519375,17187.55,18484.45,16504.49649331727,15776.2,17796.4,0,949.0,3.1818903997202126,43134838796.14657
2022-12-17,16777.1,16629.0,16794.4,16587.0,164490.0,67527.9,0.1,16920.933333333327,44.666355811734874,28.630599107610294,17777.117787905943,16311.86221209406,17104.466921042756,12.971150657676432,497.4383101786208,-2040756830.0,-0.6360863513873758,0.008869726271227174,2.9649838778967808,2.9649838778967808,17216.6,18484.45,18351.8,15776.2,17796.4,0,950.0,3.1819048832568506,43170374999.76428
2022-12-18,16741.1,16777.0,16825.7,16666.5,124290.0,67527.9,0.1,16715.933333333327,44.23014457296001,2.2989060117562587,17714.110133026457,16427.80986697354,17069.860547610115,10.981540842268007,473.27843088014794,-2040881120.0,-2.170914998305342,-0.0021457820481489698,2.8270450023006135,2.8270450023006135,17314.875,18484.45,18316.504,15776.2,17796.4,0,951.0,3.1819187238702105,43205700182.21184
2022-12-19,16441.3,16741.1,16809.5,16331.2,207930.0,67527.9,0.1,16653.16666666666,40.66821557839576,-32.7752589256516,17713.97875211742,16428.031247882576,17009.997638313915,5.448876571315383,473.6371143887087,-2041089050.0,-3.095511743730296,-0.017908022770307785,2.8807765467980557,2.8807765467980557,17262.075,18484.45,18281.91392,16441.3,17796.4,0,952.0,3.181928384211408,43239525839.36436
2022-12-20,16902.8,16441.3,17031.3,16400.7,284570.0,67527.9,0.1,16695.066666666662,47.656270676139556,-22.831301250959996,17703.44686444781,16412.45313555219,16999.788339426876,28.28862714045328,484.8487490752294,-2040804480.0,-1.0913261514514931,0.02806955654358223,2.8684522627921374,2.8684522627921374,17262.075,18484.45,18203.8853632,16441.3,17796.4,0,953.0,3.181944032207112,43275553323.76198
2022-12-21,16831.8,16902.7,16919.4,16735.0,174340.0,67527.9,0.1,16725.3,46.744118679435125,-19.12300399094765,17703.029660715423,16398.85033928458,16983.78944995765,24.774819360585912,463.38812414128455,-2040978820.0,-0.020195780269919306,-0.004200487493196348,2.753051510481853,2.753051510481853,17262.075,18484.45,18128.977948672,16441.3,17796.4,0,954.0,3.181958579224801,43311202896.49289
2022-12-22,16820.6,16831.8,16862.2,16566.1,198280.0,67527.9,0.1,16851.733333333326,46.59262006889993,-15.657611453496628,17696.625243720486,16377.954756279514,16968.247597580732,24.220528555874402,451.43897241690723,-2041177100.0,-2.3517186529429988,-0.0006654071459974986,2.6838458343751546,2.6838458343751546,17262.075,18484.45,18057.06683072512,16441.3,17796.4,0,955.0,3.181972813168098,43346761144.47305
2022-12-23,16779.1,16820.5,16910.7,16768.0,184120.0,67527.9,0.1,16810.499999999996,45.99773525769621,-14.424116843372914,17697.809253752228,16366.230746247766,16950.233540668283,22.166683163416714,429.3861886728425,-2041361220.0,-2.023858878761173,-0.002467212822372611,2.559053755403106,2.559053755403106,17135.65,18484.45,17988.032157496116,16441.3,17796.4,0,956.0,3.1819863337098293,43382081538.41261
2022-12-24,16837.2,16778.6,16855.8,16777.8,110120.0,67527.9,0.1,16812.299999999996,47.01764035616617,-8.265079644537877,17688.182248822188,16348.317751177812,16939.46844155702,25.042066712857586,404.28717519621085,-2041251100.0,-1.6932131346629922,0.003462641023654456,2.4011544389578483,2.4011544389578483,17075.4,18484.45,17921.75887119627,16441.3,17796.4,0,957.0,3.1820004570305986,43417644670.74631
2022-12-25,16831.8,16835.7,16852.9,16733.0,132890.0,67527.9,0.1,16816.03333333333,46.92892665036463,-3.375258546063634,17686.08514839967,16336.944851600329,16929.214304265875,24.774819360585912,383.97380553933874,-2041383990.0,-1.529839176753465,-0.0003207184092367532,2.281240304301018,2.281240304301018,17011.375,18484.45,17858.13651634842,16441.3,17796.4,0,958.0,3.1820143443931426,43453144179.82983
2022-12-26,16918.1,16831.8,16936.1,16799.4,133360.0,67527.9,0.1,16862.366666666665,48.5981347730432,6.322482656527953,17677.704554954988,16328.205445045014,16928.155799097694,29.04582797188945,366.3113908579572,-2041250630.0,-1.6983916701529476,0.005127199705319718,2.1652040764504124,2.1652040764504124,17011.375,18484.45,17797.05905569448,16441.3,17796.4,0,959.0,3.1820292018075134,43489021563.17156
2022-12-27,16706.1,16918.2,16964.0,16610.1,192180.0,67527.9,0.1,16818.66666666666,44.865028807435735,-0.5258559167962886,17679.959233613794,16313.040766386206,16907.007627755058,18.55389488270801,365.4248629395318,-2041442810.0,-6.032533495325842,-0.012530957968093337,2.1873738511054754,2.1873738511054754,17011.375,18432.300000000003,17738.424693466703,16441.3,17796.4,0,960.0,3.1820410970621853,43523836332.33217
2022-12-28,16546.2,16705.9,16781.1,16474.2,217960.0,67527.9,0.1,16723.466666666664,42.23009299257615,-14.059856701572656,17664.34179340976,16260.708206590243,16872.64499654029,14.192355931084581,361.24451558670796,-2041660770.0,-7.02501629543054,-0.009571354176019398,2.183247607225272,2.183247607225272,17028.75,18279.800000000003,17682.135705728033,16441.3,17796.4,0,961.0,3.1820506964644597,43557830242.998665
2022-12-29,16636.4,16546.2,16659.1,16496.6,181470.0,67527.9,0.1,16629.566666666662,44.22022376272399,-15.08198337443423,17649.466321037387,16226.653678962606,16850.145473060264,25.705381959066866,347.0484787590859,-2041479300.0,-4.146668894509695,0.005451402738997579,2.086079192367855,2.086079192367855,17030.3,18085.85,17628.098277498913,16441.3,17796.4,0,962.0,3.18206133971751,43592227430.6025
2022-12-30,16607.2,16636.4,16644.4,16360.0,192760.0,67527.9,0.1,16596.599999999995,43.695443974672585,-15.79378234899977,17631.875138498734,16192.24486150126,16827.007808959286,39.422939580060074,342.57358741915135,-2041672060.0,-0.13469957184777637,-0.0017551874203554085,2.0628016006259413,2.0628016006259413,17001.75,17044.0,17576.222346398958,16441.3,17796.4,0,963.0,3.182071431449639,43626442616.7362
2022-12-31,16537.4,16607.2,16635.9,16487.3,130440.0,67527.9,0.1,16593.666666666668,42.40011392103559,-18.828760182150717,17616.75938299004,16151.770617009961,16799.426112867928,29.452935294958028,328.7183311749264,-2041802500.0,-1.4287332137258353,-0.004202996290765371,1.9877267960799545,1.9877267960799545,17001.75,16928.0,17526.421452543,16441.3,17796.4,0,964.0,3.182080428095898,43660275423.391655
2023-01-01,16618.4,16537.5,16621.9,16499.7,107840.0,67527.9,0.1,16587.66666666666,44.45781153002884,-13.494144706512785,17579.85974150876,16129.47025849124,16782.18553069003,41.022711041280004,313.9670218052888,-2041694660.0,-0.7329267491383309,0.004897988801141562,1.8892734667915614,1.8892734667915614,17001.75,16928.0,17478.61259444128,16441.3,17796.4,0,965.0,3.182090346415304,43694467138.55761
2023-01-02,16674.3,16618.4,16766.9,16551.0,136030.0,67527.9,0.1,16610.03333333333,45.89433955664374,-4.764347125606406,17390.624896297162,16208.27510370284,16771.91071824336,46.819603753910265,306.96223453348256,-2041558630.0,1.417162876414882,0.00336374139508,1.8409302611412925,1.8409302611412925,17001.75,16928.0,17432.71609066363,16441.3,17796.4,0,966.0,3.1821008471676886,43728893636.84977
2023-01-03,16674.2,16673.1,16773.2,16607.2,178730.0,67527.9,0.1,16655.63333333333,45.89205289726586,2.0729241458136016,17119.17251803425,16367.507481965758,16762.604935553518,52.019867549668994,296.89350349537665,-2041737360.0,-1.3524386492178726,-5.997253257894464e-06,1.7805562095655363,1.7805562095655363,17001.75,16928.0,17388.655447037087,16441.3,17796.4,0,967.0,3.182111184841919,43763280623.14478
2023-01-04,16852.1,16674.2,16976.5,16656.5,247390.0,67527.9,0.1,16733.53333333333,50.606916392911124,18.720395078777585,16975.007097176658,16461.27290282334,16771.12827502461,79.82157339821549,298.5439675314211,-2041489970.0,0.1206050452120348,0.010669177531755558,1.7715535009371008,1.7715535009371008,17004.875,16928.0,17346.357229155605,16441.3,17796.4,0,968.0,3.182123710761594,43798495467.50302
2023-01-05,16829.8,16852.2,16877.9,16772.3,178960.0,67527.9,0.1,16785.36666666666,50.01854343250178,27.825057306071216,16986.0368550585,16470.263144941502,16776.7160583556,76.20437956204368,284.7622555648912,-2041668930.0,0.0546948384718781,-0.001323277217676111,1.6920121187708181,1.6920121187708181,17004.875,16928.0,17305.75093998938,16441.3,17796.4,0,969.0,3.1821357806051536,43833563755.62343
2023-01-06,16950.9,16829.8,17012.3,16707.6,233470.0,67527.9,0.1,16877.599999999995,53.20059439612445,40.812785783866175,17011.881556154633,16461.798443845368,16793.305005178874,90.58715315039125,286.186380167399,-2041435460.0,1.0238928190427552,0.007195569763158272,1.6883255766207046,1.6883255766207046,17013.825,16928.0,17266.768902389802,16441.3,16950.9,0,970.0,3.182149274679681,43869179965.884575
2023-01-07,16943.6,16950.9,16979.6,16909.7,110480.0,67527.9,0.1,16908.099999999995,52.98162325419396,47.26629814340552,17036.419841230825,16457.510158769175,16807.618814209458,89.46803617967181,270.73735301258466,-2041545940.0,0.6319340507922803,-0.0004306555994079142,1.59787384624628,1.59787384624628,17013.825,16928.0,17229.34614629421,16441.3,16950.9,0,971.0,3.182162509989436,43904722934.88306
2023-01-08,17119.0,16943.6,17119.0,16913.8,144840.0,67527.9,0.1,17004.499999999996,57.50723038084107,60.83774437203941,17077.813166086235,16483.886833913763,16837.274165237126,100.0,266.0561135116858,-2041401100.0,1.7062940386649124,0.01035199131235398,1.5541568637869372,1.5541568637869372,17072.325,16928.0,17193.42030044244,16441.3,16950.9,0,972.0,3.1821778603909845,43941071196.804756
2023-01-09,17180.1,17119.0,17390.8,17107.1,301240.0,67527.9,0.1,17080.899999999998,58.98809535642168,70.72611551547979,17135.777928375337,16453.652071624663,16869.92424473835,79.55956538610779,267.316391117994,-2041099860.0,1.54863725832097,0.0035691337110812515,1.555965280283549,1.555965280283549,17016.95,16928.0,16331.2,16441.3,16950.9,0,973.0,3.182193834238102,43977674100.74976
2023-01-10,17439.1,17180.1,17491.0,17151.7,247140.0,67527.9,0.1,17246.066666666662,64.61716125903864,90.25595833927989,17267.128791890627,16383.031208109376,16924.131459525175,95.41114058355424,272.45807746670863,-2040852720.0,4.387618893697512,0.015075581632237212,1.5623402438583909,1.5623402438583909,16972.925,16928.0,16352.392,16441.3,16950.9,0,974.0,3.1822129518845155,44015466875.964745
2023-01-11,17942.3,17440.5,17989.8,17323.9,291530.0,67527.9,0.1,17520.499999999996,72.51131966691791,130.183664111936,17538.779717834055,16223.550282165948,17021.099891951348,97.08553196711253,300.56107193337215,-2040561190.0,8.43758687795384,0.02885470007053126,1.6751535306698258,1.6751535306698258,17229.5,16928.0,16397.93632,16441.3,16950.9,0,975.0,3.182238191376219,44055558011.52361
2023-01-12,18851.3,17941.0,19055.3,17915.5,522010.0,67527.9,0.1,18077.566666666662,80.83118589709109,206.4037719679056,18063.533508430854,15906.016491569148,17195.404664146456,92.43126924646607,360.5067096524169,-2040039180.0,13.313577456661282,0.05066240114143672,1.9123705508501634,1.9123705508501634,17774.575,17337.85,16493.4481408,16441.3,16950.9,1,976.0,3.1822741832726864,44099674416.14175
2023-01-13,19927.0,18850.8,19981.6,18723.8,426670.0,67527.9,0.1,18906.866666666665,86.16691229475066,311.54363895836156,18811.16009034268,15467.369909657318,17455.55660089441,98.43745528432022,424.599087534387,-2039612510.0,19.990124765162093,0.05706237766095712,2.1307727582395093,2.1307727582395093,18250.5,17997.55,16698.396289536,16441.3,16950.9,0,977.0,3.1823222601030636,44148324095.03897
2023-01-14,20958.2,19926.9,21185.6,19898.6,458210.0,67527.9,0.1,19912.16666666666,89.25473223647784,425.74828813057286,19695.671676084938,14995.498323915059,17789.141686523515,95.14714355833462,486.19915271050223,-2039154300.0,26.732134434675338,0.05174888342449946,2.319851670040854,2.319851670040854,18859.699999999997,18599.55,17026.7166605824,16441.3,16950.9,0,978.0,3.1823812979226425,44201103703.16506
2023-01-15,20879.8,20956.0,21032.2,20585.7,205800.0,67527.9,0.1,20588.33333333333,87.65275532918719,467.86532449569756,20341.4446807797,14745.895319220297,18083.4900973308,93.4018038234152,483.36349894546635,-2039360100.0,25.642661146680773,-0.0037407792653949556,2.3149814602892094,2.3149814602892094,18910.225,18599.55,17525.78266131251,16441.3,16950.9,0,979.0,3.182439314960095,44253560154.28667
2023-01-16,21184.2,20880.1,21416.8,20698.9,337460.0,67527.9,0.1,21007.399999999994,88.51470225866981,485.95443907656505,20951.502826366668,14583.647173633335,18378.795802346915,95.16383898868932,500.11610616364715,-2039022640.0,27.047012468289534,0.014578683703867057,2.3607976990570667,2.3607976990570667,19026.85,18715.15,17964.96074195501,16441.3,16950.9,0,980.0,3.1825003359542485,44307194731.59055
2023-01-17,21137.1,21184.4,21506.4,20926.2,310040.0,67527.9,0.1,21067.03333333333,87.49689844510281,464.49555920704665,21446.615780894936,14547.624219105064,18641.491440218637,92.38541000845373,505.8363842948152,-2039332680.0,26.765302083458266,-0.0022233551420399733,2.393121025565547,2.393121025565547,19119.975,18759.95,18448.218238081306,16441.3,16950.9,0,981.0,3.1825606713914443,44360632458.44761
2023-01-18,20670.6,21137.1,21584.1,20448.3,388670.0,67527.9,0.1,20997.299999999992,77.93789227419846,391.549864987522,21775.904324697764,14621.75567530224,18834.739874483526,81.267302368502,550.8337854166141,-2039721350.0,22.658897110745844,-0.022070198844685418,2.6648175931836238,2.6648175931836238,19169.975,18798.8,18937.527319988298,20670.6,16950.9,0,982.0,3.1826158870251073,44412212882.35765
2023-01-19,21081.2,20670.6,21169.4,20669.7,275760.0,67527.9,0.1,20962.966666666664,80.00815273980277,345.2392184165709,22130.662699407072,14714.397300592935,19048.688457866047,89.68727571003798,547.1813721725703,-2039445590.0,25.261143923278954,0.019863961375093275,2.5955893031353536,2.5955893031353536,19213.025,18842.1,19413.910402390404,20670.6,16950.9,0,983.0,3.182675253207637,44465402808.64321
2023-01-20,22677.2,21074.9,22718.5,20879.3,373740.0,67527.9,0.1,21476.33333333333,85.64633787557467,392.91317299906063,22764.73709631736,14694.302903682632,19394.26098568833,99.28900977826747,639.4684170173867,-2039071850.0,33.78168710805915,0.07570726524106797,2.819873780790339,2.819873780790339,19928.125,19524.85,19804.54452996013,20670.6,16950.9,0,984.0,3.1827505282459008,44524619742.503395
2023-01-21,22775.7,22677.5,23304.5,22461.1,382690.0,67527.9,0.1,22178.03333333333,85.91043998222837,400.5332271571665,23313.69211819345,14761.077881806556,19716.302796575153,91.7254760824323,654.0349586590021,-2038689160.0,34.420666210250495,0.004343569752879528,2.871634938372924,2.871634938372924,20423.2,19817.85,20387.335623968105,20670.6,16950.9,0,985.0,3.1828265561101716,44584193073.53511
2023-01-22,22707.8,22775.7,23068.7,22323.0,280640.0,67527.9,0.1,22720.233333333334,84.75277919751107,371.11666116825836,23754.977397054874,14923.142602945121,20001.20729213942,90.3717688062736,660.5824616119306,-2038969800.0,32.6467667503943,-0.0029812475577041253,2.9090553096818303,2.9090553096818303,20716.9,19817.85,20879.3,20670.6,16950.9,0,986.0,3.1829017218516475,44643516428.92647
2023-01-23,22915.5,22709.0,23161.8,22527.9,327850.0,67527.9,0.1,22799.66666666666,85.40083842603825,336.77062239564384,24150.978003322653,15151.271996677347,20278.758978602335,93.6776752047848,658.6765714967926,-2038641950.0,33.38397331796673,0.00914663683844319,2.8743713708921583,2.8743713708921583,20854.325,19817.85,21364.34,20670.6,16950.9,0,987.0,3.182978692157513,44703593262.33087
2023-01-24,22632.5,22916.3,23156.1,22517.1,334170.0,67527.9,0.1,22751.93333333333,80.38728124008371,269.0524656831017,24426.274511941432,15454.015488058563,20502.92479016402,88.76366919707053,657.2711021041645,-2038976120.0,29.78020654735624,-0.01234971962208986,2.9041029585956677,2.9041029585956677,20854.325,19817.85,21752.372,20670.6,16950.9,0,988.0,3.1830527189843023,44762635146.6995
2023-01-25,23055.1,22632.5,23779.0,22366.3,388180.0,67527.9,0.1,22867.699999999997,82.07916250340132,228.38372824172643,24694.781931721656,15808.038068278342,20745.989095862686,87.65413149143001,711.2303090967242,-2038587940.0,28.495789280081148,0.01867226333812,3.0849153076617504,3.0849153076617504,21123.4,20055.1,22062.797599999998,20670.6,16950.9,0,989.0,3.1831306209934636,44823213608.41565
2023-01-26,23016.0,23055.2,23259.5,22869.0,320970.0,67527.9,0.1,22901.199999999997,81.37967496929551,176.81581708520844,24881.9757197325,16227.354280267498,20962.18061054243,84.90663079601202,688.3210013041011,-2038908910.0,22.092375592134232,-0.0016959371245407473,2.9906195746615443,2.9906195746615443,21126.5,20055.1,22366.3,20670.6,16950.9,0,990.0,3.1832079443992147,44883649865.81125
2023-01-27,23074.6,23016.0,23480.3,22602.9,310360.0,67527.9,0.1,23048.566666666662,81.632317789983,126.95177685256408,24985.749258448075,16736.680741551925,21163.363409538386,81.84723224409852,701.8266440680936,-2038598550.0,15.795654137602241,0.0025460549183176084,3.0415549741624717,3.0415549741624717,21194.675,20055.1,23779.0,20670.6,16950.9,0,991.0,3.183285623840725,44944297173.0874
2023-01-28,23027.9,23074.6,23182.3,22889.8,156960.0,67527.9,0.1,23039.499999999996,80.69268573872226,73.76029651180306,25003.82805112693,17309.49194887307,21340.93832291568,77.44918485603633,672.5890266346584,-2038755510.0,9.875370976515162,-0.00202387040295382,2.9207571104384606,2.9207571104384606,21261.125,20055.1,23755.478,20670.6,16950.9,0,992.0,3.183362652777807,45004774349.66152
2023-01-29,23753.1,23023.5,23952.9,22973.3,320860.0,67527.9,0.1,23285.199999999997,83.80932325957406,70.36436653364854,25028.522239142858,17942.097760857145,21570.668006447522,94.29892141756541,694.5183818750401,-2038434650.0,13.761147137424684,0.031492233334346365,2.923906276970333,2.923906276970333,21721.325,20142.050000000003,22602.9,20670.6,23753.1,0,993.0,3.1834463055518265,45067843818.497
2023-01-30,22832.2,23746.0,23794.0,22560.0,339620.0,67527.9,0.1,23204.399999999994,68.65387331698798,-6.853287951212678,24813.061982947354,18696.868017052646,21690.813910595378,68.02202819151971,733.0527831696801,-2038774270.0,7.779382747519377,-0.03876967637908302,3.210609503988578,3.210609503988578,21734.1,20142.050000000003,23952.9,20670.6,23753.1,0,994.0,3.1835210451850515,45127605773.49015
2023-01-31,23125.1,22832.2,23262.9,22724.9,289380.0,67527.9,0.1,23236.8,70.4821931457335,-48.815591776801284,24573.697565607206,19454.512434392793,21827.412585776772,76.37961536266614,719.120441514703,-2038484890.0,9.405263730596914,0.012828373963087225,3.109696570024359,3.109696570024359,21744.925,20142.050000000003,23952.9,20670.6,23753.1,0,995.0,3.183598388284758,45188433303.523315
2023-02-01,23725.6,23124.7,23784.5,22809.6,333180.0,67527.9,0.1,23227.63333333333,73.84980163715417,-46.739217514489155,24471.211522169462,20044.428477830537,22008.192339512316,93.07687621832349,737.3904099779386,-2038151710.0,14.779445202364712,0.025967455275869078,3.107994781914635,3.107994781914635,21795.45,20142.050000000003,23925.042,20670.6,23753.1,0,996.0,3.1836811689352973,45251411671.3018
2023-02-02,23427.6,23726.2,24207.2,23398.1,382860.0,67527.9,0.1,23426.099999999995,69.6058429993592,-74.40274277661274,24423.75248430495,20441.947515695047,22143.374021463525,76.57381531896986,742.5125235509431,-2038534570.0,11.130296188072775,-0.012560272448325804,3.1693921850763336,3.1693921850763336,21923.625,20269.2,22560.0,20670.6,23753.1,0,997.0,3.183760961462819,45313331110.36893
2023-02-03,23431.2,23429.1,23694.1,23233.8,349360.0,67527.9,0.1,23528.133333333328,69.62854992078903,-99.83950688868686,24471.43013763208,20641.56986236792,22266.024114657474,58.81541237660547,722.3544861544472,-2038185210.0,3.3249254758083007,0.00015366490805734934,3.082874484253675,3.082874484253675,22020.375,20269.2,22592.944,20670.6,23753.1,0,998.0,3.1838405825460288,45375264396.13902
2023-02-04,23323.8,23431.2,23571.8,23269.8,170270.0,67527.9,0.1,23394.199999999997,67.99647159982271,-129.40334929652545,24457.101347281205,20900.298652718797,22366.764675166283,53.11538053285208,692.3291657148438,-2038355480.0,2.4065122037961446,-0.004583632080303213,2.9683377739255348,2.9683377739255348,22031.525,20269.2,22625.22912,20670.6,23753.1,0,999.0,3.1839189882716314,45436811471.144
2023-02-05,22936.0,23326.9,23423.4,22766.5,217260.0,67527.9,0.1,23230.33333333333,62.316515088795214,-177.60371548023045,24409.01880525411,21123.561194745893,22420.977563245688,30.946819490466634,689.7985110209265,-2038572740.0,1.0049410334774866,-0.016626793232663584,3.0074926361219325,3.0074926361219325,22074.575,20269.2,22656.8685376,20670.6,23753.1,0,1000.0,3.183993503490526,45496944372.218765
2023-02-06,22761.8,22936.0,23130.6,22633.7,278580.0,67527.9,0.1,23007.199999999997,59.89614094648576,-220.92210308993072,24310.847742087877,21384.202257912126,22453.436842936575,21.48405671139115,676.020045948003,-2038851320.0,-0.670725055093717,-0.00759504708754799,2.969976214306439,2.969976214306439,22222.475,20269.2,24207.2,20670.6,23753.1,0,1001.0,3.18406614129326,45556430345.16183
2023-02-07,23251.7,22761.8,23338.8,22748.2,318980.0,67527.9,0.1,22983.16666666666,64.11709751225288,-216.0249029481456,24053.410381448983,21899.749618551014,22529.461905514047,48.09603998044439,669.9186140945741,-2038532340.0,2.735888655694248,0.02152290240666388,2.8811597177607404,2.8811597177607404,22424.55,20269.2,24175.73,20670.6,23753.1,0,1002.0,3.184143258654124,45617711495.37938
2023-02-08,22964.6,23251.7,23425.1,22691.7,289120.0,67527.9,0.1,22992.699999999993,60.12336965771976,-230.25778615372542,23707.638805060622,22433.86119493937,22570.90362879842,24.562894609033414,674.4529988021043,-2038821460.0,-0.3925378766520206,-0.012347484269967457,2.9369246527355335,2.9369246527355335,22736.675000000003,20269.2,24144.8894,20670.6,23753.1,0,1003.0,3.1842174430627286,45677940123.77699
2023-02-09,21792.5,22964.6,23003.6,21744.6,425440.0,67527.9,0.1,22669.599999999995,47.197967446943686,-311.68875214139473,23859.346736373893,22193.683263626106,22496.769949865236,1.945098676195948,716.2063560305254,-2039246900.0,-5.315867222801529,-0.05103942589899235,3.2864809270644737,3.2864809270644737,22651.825,20283.6,24114.665612,20670.6,23753.1,0,1004.0,3.184279918343526,45733727453.416016
2023-02-10,21635.0,21792.5,21933.6,21491.7,352790.0,67527.9,0.1,22130.699999999997,45.77393597772054,-365.50962535462986,23996.747201078455,21942.212798921544,22414.696621306644,5.277112870557882,696.6130448854876,-2039599690.0,-6.2388947154013445,-0.007227257083859073,3.219843054705281,3.219843054705281,22588.6,20283.6,24019.862987520002,21635.0,23753.1,0,1005.0,3.184340607253649,45788887546.5028
2023-02-11,21859.8,21627.4,21902.9,21605.3,182070.0,67527.9,0.1,21762.43333333333,48.17728520851895,-373.9730849559513,24058.74669934728,21795.413300652723,22361.849324039344,13.555514638188125,668.112113107953,-2039417620.0,-5.072542437651728,0.010390570834296176,3.0563505297759037,3.0563505297759037,22460.325,20283.6,23868.173208268803,21635.0,23753.1,0,1006.0,3.1844033737690296,45844911582.62795
2023-02-12,21786.8,21859.9,22080.7,21653.1,211650.0,67527.9,0.1,21760.53333333333,47.441954656102965,-371.71626786425077,24106.7480531115,21634.5419468885,22307.082721749885,10.867243601546623,650.932676457385,-2039629270.0,-8.27807738779359,-0.00333946330707513,2.9877387980675687,2.9877387980675687,22429.75,20283.6,23725.584815772676,21635.0,23753.1,0,1007.0,3.1844652125657418,45900639416.25262
2023-02-13,21772.6,21782.7,21887.5,21418.7,312040.0,67527.9,0.1,21806.399999999998,47.29074948231508,-358.25879991138504,24150.659612214356,21504.640387785646,22256.17960539275,12.691411152949536,637.9231995675717,-2039941310.0,-4.640814288592436,-0.0006517707969964093,2.929935788870285,2.929935788870285,22430.175000000003,20283.6,23591.551726826314,21635.0,23753.1,0,1008.0,3.1845267155504793,45956299155.00015
2023-02-14,22198.5,21776.9,22308.6,21556.2,378390.0,67527.9,0.1,21919.3,52.21047394575144,-309.58374557944717,24130.86459153907,21438.77540846093,22250.68630964106,27.964855657163323,646.1001138841737,-2039562920.0,-4.006901591776894,0.019561283448003453,2.91055753264488,2.91055753264488,22482.575,20283.6,23417.72358868021,21635.0,23753.1,0,1009.0,3.1845922769674,46013595402.41128
2023-02-15,24327.9,22198.5,24330.9,22050.8,401530.0,67527.9,0.1,22766.33333333333,68.19460485541417,-131.96762287101672,24353.79637713342,21347.03362286658,22448.51618491334,99.89698509717739,762.8143914638757,-2039161390.0,2.5386080857807727,0.0959254003648895,3.135553794054874,3.135553794054874,22874.800000000003,20345.45,21418.7,21635.0,23753.1,0,1010.0,3.184677738406159,46078689529.870865
2023-02-16,23539.6,24328.1,25233.8,23525.9,484500.0,67527.9,0.1,23355.333333333332,60.171114741137266,-68.74468397087253,24404.330451727314,21342.999548272688,22552.428929207304,55.59225184136716,830.3205063593131,-2039645890.0,0.47806860284450825,-0.03240312562942149,3.5273348160517304,3.5273348160517304,23326.25,20796.9,21476.944,21635.0,23753.1,0,1011.0,3.1847557671145936,46140978231.5824
2023-02-17,24573.5,23538.2,24984.7,23373.0,523850.0,67527.9,0.1,24147.0,65.84677864191555,35.90980260331946,24651.58548226295,21250.304517737048,22744.911888330418,82.69245891326572,886.1333273336479,-2039122040.0,4.875123766601792,0.04392173189009174,3.6060525661124707,3.6060525661124707,23326.25,20796.9,21627.21824,21635.0,23753.1,0,1012.0,3.1848430186072627,46206939539.615845
2023-02-18,24631.4,24573.5,24838.9,24457.0,223770.0,67527.9,0.1,24248.16666666666,66.13779570633079,98.67873388760677,24817.100163538154,21172.619836461847,22924.57742277514,84.21011244790442,850.1166610955304,-2038898270.0,5.606290570147241,0.0023561967159746455,3.4513533988954355,3.4513533988954355,23326.25,20796.9,21771.481510399997,21635.0,23753.1,0,1013.0,3.1849305770452006,46273109713.55657
2023-02-19,24302.9,24631.3,25175.2,24273.7,312640.0,67527.9,0.1,24502.599999999995,62.864868920036436,107.02010538123523,24975.180699000164,21161.60930099983,23055.846239653696,75.59959109852957,853.7868995887068,-2039210910.0,5.959626787582845,-0.013336635351624326,3.5131070760637892,3.5131070760637892,23326.25,20796.9,21909.974249983996,21635.0,23753.1,0,1014.0,3.1850149834440478,46338137576.71404
2023-02-20,24839.5,24302.8,25085.4,23868.6,363020.0,67527.9,0.1,24591.266666666663,65.83872926128991,135.77480885853367,25211.579342609984,21096.65065739001,23225.718026353345,89.66475321747794,879.7164067609422,-2038847890.0,9.128012723071114,0.022079669504462274,3.541602716483593,3.541602716483593,23326.25,20860.55,22042.927279984637,21635.0,24839.5,0,1015.0,3.1851039687469056,46405043605.80902
2023-02-21,24450.7,24839.5,25236.8,24160.8,395970.0,67527.9,0.1,24531.03333333333,61.96656894740026,116.45049992938698,25311.409681951172,21069.330318048826,23342.382976224457,79.41122547864124,893.7366634208748,-2039243860.0,5.1566122046990115,-0.01565248897924676,3.65526002699667,3.65526002699667,23327.75,20868.25,22170.56218878525,21635.0,24839.5,0,1016.0,3.1851892876638654,46470604001.54913
2023-02-22,24186.6,24450.7,24474.3,23593.4,400240.0,67527.9,0.1,24492.266666666663,59.41056003352326,75.69685810832107,25391.71727059353,21064.92272940647,23422.784597536414,72.49417249417246,892.8197588908122,-2039644100.0,5.3212335507694455,-0.010801326751381457,3.69138183494502,3.69138183494502,23362.125,20893.9,22354.536457458136,21635.0,24839.5,0,1017.0,3.1852720202917078,46535236617.73822
2023-02-23,23936.3,24186.6,24590.4,23637.9,417460.0,67527.9,0.1,24191.199999999997,57.0104215630992,24.35625414137678,25437.551091332396,21069.598908667605,23471.69082634247,65.93855582619626,897.0826332557542,-2040061560.0,9.837329356429962,-0.010348705481547649,3.7477915686875343,3.7477915686875343,23485.775,20922.0,22527.472270010647,21635.0,24839.5,0,1018.0,3.185352269099455,46598977526.73801
2023-02-24,23191.5,23936.4,24123.4,22970.3,367990.0,67527.9,0.1,23771.466666666664,50.47581434937535,-62.54204088657059,25430.846646694725,21063.073353305273,23445.005985738426,46.43147115057228,915.3695880232005,-2040429550.0,7.194360989137971,-0.031115920171455036,3.9470046699144103,3.9470046699144103,23715.65,20946.65,22690.03193381001,21635.0,24839.5,0,1019.0,3.1854253928900693,46659996064.59568
2023-02-25,23166.1,23191.3,23215.3,22777.4,198350.0,67527.9,0.1,23431.3,50.26422055826458,-121.11888227406189,25438.097966605048,21078.832033394952,23418.443510906196,45.76621879992662,881.2646174501145,-2040627900.0,5.975809476756417,-0.0010952288553996992,3.8041129816849386,3.8041129816849386,23667.425,20972.199999999997,25236.8,21635.0,24839.5,0,1020.0,3.1854980775571584,46720915910.916214
2023-02-26,23558.7,23166.1,23671.8,23066.0,209120.0,67527.9,0.1,23305.43333333333,53.508333470990074,-131.9218524699562,25469.287282150028,21127.332717849975,23431.801271772274,56.048820093763936,861.5885733465349,-2040418780.0,8.13290616336498,0.01694717712519589,3.6571991380956286,3.6571991380956286,23667.425,20972.199999999997,25187.612,21635.0,24839.5,0,1021.0,3.1855742412035055,46783282645.25718
2023-02-27,23494.1,23558.7,23876.2,23166.8,297650.0,67527.9,0.1,23406.299999999992,52.896934861562166,-141.09153549852124,25482.93708362747,21137.922916372532,23437.734483984437,52.65174156387541,850.7179609646397,-2040716430.0,7.906726803413465,-0.002742086787471343,3.620985528131062,3.620985528131062,23667.425,21073.25,25139.407760000002,21635.0,24839.5,0,1022.0,3.185649602954714,46845410266.07071
2023-02-28,23130.5,23494.0,23595.0,23033.8,275100.0,67527.9,0.1,23394.43333333333,49.470626309645674,-167.51672116829604,25487.15002372379,21150.29997627621,23408.474056938303,33.888888888888914,830.0381066100226,-2040991530.0,4.198481879406266,-0.015476225946088551,3.5885004933314137,3.5885004933314137,23667.425,21075.3,25092.1676048,21635.0,24839.5,0,1023.0,3.1857213522034318,46906185436.93958
2023-03-01,23642.2,23130.6,23914.1,23025.3,328770.0,67527.9,0.1,23422.266666666663,53.987595399862734,-147.1306640682913,25466.18149557153,21356.238504428467,23430.733670563226,35.16304789786127,834.2353847093067,-2040662760.0,-2.8185745584288027,0.022122306046129525,3.5285861075082128,3.5285861075082128,23667.425,21171.949999999997,25045.872252704,21635.0,24839.5,0,1024.0,3.1857976890191315,46968851562.97758
2023-03-02,23465.4,23642.2,23780.5,23208.7,249260.0,67527.9,0.1,23412.699999999997,52.249642301151354,-142.07601867778493,25389.263096558738,21616.19690344127,23434.03522574768,27.974302675449323,815.4900000872133,-2040912020.0,-0.3152135125490539,-0.0074781534713350695,3.4752870187050435,3.4752870187050435,23505.825,21194.25,25000.502807649922,21635.0,24839.5,0,1025.0,3.185872183520084,47030864951.78827
2023-03-03,22354.4,23465.6,23473.4,22051.9,344630.0,67527.9,0.1,23154.0,42.90313097635382,-206.19041954463512,25338.661091433936,21716.258908566062,23331.212823295522,9.497943420515565,858.7764286524124,-2041256650.0,-9.030459641483708,-0.0473463056244513,3.8416438314265307,3.8416438314265307,23324.45,21280.35,24956.040751496923,21635.0,24839.5,0,1026.0,3.18593587468504,47088662758.09136
2023-03-04,22347.1,22354.7,22403.7,22167.4,123930.0,67527.9,0.1,22722.3,42.84889352031359,-239.3921505112915,25273.02573622629,21837.924263773708,23237.48779250547,9.268736852020387,814.3138266058114,-2041380580.0,-9.273934896108232,-0.0003265576351860755,3.6439351262839987,3.6439351262839987,23207.7,21576.15,24839.875121437046,21635.0,24839.5,0,1027.0,3.185999301889362,47146420842.22132
2023-03-05,22428.3,22347.1,22636.7,22213.5,160570.0,67527.9,0.1,22376.599999999995,43.7014543054573,-245.2844428789797,25189.527357317784,21986.99264268222,23160.422288457332,11.818267449527397,786.3771247053963,-2041220010.0,-7.7134827530870895,0.003633581091058824,3.506182477964876,3.506182477964876,23155.375,21980.3,24728.356116579565,21635.0,24839.5,0,1028.0,3.186063329330706,47204483050.121574
2023-03-06,22410.0,22428.2,22595.4,22320.1,215310.0,67527.9,0.1,22395.13333333333,43.543799658359966,-239.54162919071405,25165.673402998684,22031.996597001315,23088.953499080442,11.243681120286313,749.8716157978682,-2041435320.0,-9.78079268906379,-0.0008159334412326524,3.346147326184151,3.346147326184151,23155.375,22567.699999999997,24621.297871916384,21635.0,24839.5,0,1029.0,3.1861269857905876,47262463070.302795
2023-03-07,22197.8,22410.1,22535.1,21968.6,304750.0,67527.9,0.1,22345.366666666658,41.66673459510205,-238.63548540615375,25134.2441209002,21850.415879099797,23004.081737263255,8.742085590052653,736.7736432408776,-2041740070.0,-9.214051131460455,-0.00946898705934851,3.3191291174840645,3.3191291174840645,23134.55,22842.55,24518.521957039728,21635.0,24839.5,0,1030.0,3.186188371808255,47319602052.01113
2023-03-08,21710.8,22197.8,22274.3,21661.3,316510.0,67527.9,0.1,22106.199999999997,37.6549021049204,-257.801569644743,25216.58816423642,21585.19183576358,22880.91204800009,1.6899388890785554,727.932668723672,-2042056580.0,-10.23624651666625,-0.02193911108308033,3.3528597229198,3.3528597229198,23057.725,22842.55,24365.526639617343,21635.0,24839.5,0,1031.0,3.186244722729256,47374791592.89284
2023-03-09,20361.8,21710.8,21826.5,20079.6,468760.0,67527.9,0.1,21423.466666666664,29.25279272950641,-342.96706402403885,25356.31202166718,21024.29797833282,22640.996614857224,6.978584499727992,800.716049529124,-2042525340.0,-14.933385694530902,-0.062134974298505785,3.9324423652581015,3.9324423652581015,22327.524999999998,22658.199999999997,24149.188508447955,21635.0,24839.5,0,1032.0,3.186286880618479,47424359841.49069
2023-03-10,20156.7,20362.0,20362.6,19591.8,655270.0,67527.9,0.1,20743.099999999995,28.22172141975011,-391.252477158768,25398.96756545092,20534.17243454908,22404.396937251775,13.0694306272124,798.5791888484722,-2043180610.0,-13.08582885971153,-0.010072783349212688,3.9618548117919703,3.9618548117919703,22050.225,22414.3,23742.22965760316,20156.7,24839.5,1,1033.0,3.1863266505677212,47473017170.39643
2023-03-11,20467.5,20156.5,20669.5,19796.7,453460.0,67527.9,0.1,20328.66666666666,32.12586439210084,-380.0756924097028,25355.7629179846,20193.837082015398,22219.930562275415,20.26004673437755,803.8806753592955,-2042727150.0,-11.648918031088524,0.015419190641325242,3.9275958244011018,3.9275958244011018,21973.449999999997,22414.3,23244.17809869078,20156.7,24839.5,0,1034.0,3.186369583351827,47522986441.90375
2023-03-12,21994.8,20465.0,22028.6,20294.2,455690.0,67527.9,0.1,20872.999999999996,47.296401816587704,-253.71460210799307,25051.144993531663,20213.98500646834,22198.489556344422,55.59540059690443,870.34634140506,-2042271460.0,-6.638311961186319,0.07462074019787468,3.957055037577337,3.957055037577337,21764.275,22414.3,22805.892726847887,20156.7,24839.5,0,1035.0,3.1864280400296097,47579234388.08967
2023-03-13,24114.4,21994.8,24406.2,21859.6,733630.0,67527.9,0.1,22192.233333333326,60.49352289234036,-23.40480855352331,24987.76227357946,20243.73772642054,22380.95721764495,93.93901628447992,990.078745590413,-2041537830.0,2.640237336182288,0.09636823249131621,4.105757330020291,4.105757330020291,22206.65,22414.3,19591.8,20156.7,24839.5,1,1036.0,3.1865063775992404,47643535327.173454
2023-03-14,24699.7,24121.5,26365.9,23994.6,753060.0,67527.9,0.1,23602.966666666664,63.231466740448916,162.12270112928377,25090.663068459016,20192.14693154098,22601.789863583526,75.40337461803043,1088.7374066196694,-2040784770.0,6.7841162101986585,0.024271804399031316,4.40789728871067,4.40789728871067,22978.85,22978.85,19688.088,20156.7,24839.5,1,1037.0,3.1865897440040434,47709942306.36957
2023-03-15,24282.7,24699.6,25108.9,23932.4,614310.0,67527.9,0.1,24365.599999999995,60.03896150157594,245.52192935672412,25148.922662739165,20168.52733726083,22761.876543242237,69.24757532365922,1095.006163289693,-2041399080.0,2.709138743433352,-0.016882796147321577,4.509408604849102,4.509408604849102,22978.85,22978.85,19955.20048,20156.7,24839.5,0,1038.0,3.1866691931896574,47774857103.05707
2023-03-16,25004.1,24283.2,25139.0,24147.9,462580.0,67527.9,0.1,24662.166666666668,63.47467700131993,332.62763831621544,25434.800242396796,20063.909757603204,22975.42163436202,79.89696048183518,1087.5842944832862,-2040936500.0,6.5573141732082005,0.029708393218216944,4.349623839623447,4.349623839623447,22978.85,22978.85,20211.6284608,20156.7,24839.5,0,1039.0,3.186754822365322,47842349860.06985
2023-03-17,27391.8,25004.4,27742.2,24900.1,674960.0,67527.9,0.1,25559.53333333333,72.04244836549583,523.0715199410746,26323.4921498293,19597.7878501707,23396.029097756116,95.70082449941106,1212.9068448773373,-2040261540.0,22.534266184733195,0.09549233925636202,4.427992482704084,4.427992482704084,23667.0,23667.0,20457.799322368,20156.7,24839.5,0,1040.0,3.1868601233579232,47917887234.76481
2023-03-18,26914.5,27391.9,27659.1,26688.7,392470.0,67527.9,0.1,26436.8,68.57935987639098,584.2725905930865,26903.50977033751,19353.35022966249,23731.121564636487,89.84467020023557,1195.5849273860988,-2040654010.0,20.43844615184969,-0.017424922787111496,4.442159160995369,4.442159160995369,23667.0,23667.0,20894.863363025917,20156.7,24839.5,0,1041.0,3.1869613752946093,47991898872.33323
2023-03-19,27958.7,26914.5,28347.3,26844.6,393270.0,67527.9,0.1,27421.66666666666,71.7758471401387,657.0254100015161,27675.0220581223,19028.2979418777,24133.748082290156,95.56164696476502,1217.5217182870917,-2040260740.0,24.658132805428863,0.03879693102231152,4.354715055732533,4.354715055732533,24020.775,23969.55,21305.70356124436,20156.7,24839.5,0,1042.0,3.1870707034881245,48069296191.641396
2023-03-20,27720.5,27958.9,28457.8,27157.0,503900.0,67527.9,0.1,27531.233333333326,70.02576448635452,649.867552832439,28302.213772793893,18860.106227206106,24475.343503024425,91.68396120009025,1223.470166980871,-2040764640.0,23.697010263275324,-0.00851970942854996,4.413593430785415,4.413593430785415,24200.4,24024.8,21869.031276344813,20156.7,24839.5,0,1043.0,3.1871779469370316,48145966284.2039
2023-03-21,28114.0,27719.8,28437.8,27350.6,438780.0,67527.9,0.1,27931.066666666662,71.27192619958717,631.8308970382675,28923.04671766022,18686.45328233978,24821.8822170221,96.12226483194226,1213.7365836250945,-2040325860.0,26.652190757642654,0.014195270648076352,4.317196356353043,4.317196356353043,24591.75,24024.8,22527.908148710332,20156.7,24839.5,0,1044.0,3.187288040084893,48223913611.00929
2023-03-22,27261.7,28114.2,28760.3,26668.7,262029.99999999997,67527.9,0.1,27698.733333333334,64.97134542095756,526.9770163194885,29325.59785762819,18663.53214237181,25054.245815400947,83.65490538255986,1276.4411133661592,-2040587890.0,25.56745951323766,-0.030315856868464053,4.6821772426743715,4.6821772426743715,25261.199999999997,24176.05,23120.897333839297,20156.7,24839.5,0,1045.0,3.18739120950724,48299159567.82535
2023-03-23,28310.7,27262.8,28734.1,27144.6,158460.0,67527.9,0.1,27895.466666666664,68.6452896852766,493.33983163705295,29882.810417634348,18701.949582365654,25364.384309172285,95.09625347657743,1298.8024624114335,-2040429430.0,39.03829720358712,0.03847889163184992,4.587673432346898,4.587673432346898,25261.199999999997,24176.05,23797.62565377858,20156.7,28310.7,0,1046.0,3.1875023803790574,48377785137.68343
2023-03-24,27462.2,28306.9,28374.5,27026.5,110360.0,67527.9,0.1,27678.199999999997,62.89868024828322,383.8847707746796,30226.5149349032,18869.755065096804,25564.176279727308,85.51809540809498,1302.3165722391882,-2040539790.0,36.24353192734922,-0.029971000363820055,4.7422150164196175,4.7422150164196175,25315.074999999997,24176.05,24393.14657532515,20156.7,28310.7,0,1047.0,3.187606707265806,48453734584.58036
2023-03-25,27475.6,27462.2,27761.9,27176.7,61360.0,67527.9,0.1,27749.499999999996,62.95142873917836,286.7758425153329,30528.022718594068,19072.977281405932,25746.216634038992,84.82536232739986,1251.093959936389,-2040478430.0,34.240136802247456,0.00048794342769320487,4.553472753775674,4.553472753775674,25503.125,24176.05,24917.20498628613,20156.7,28310.7,0,1048.0,3.187710922769626,48529752617.210396
2023-03-26,27973.5,27474.9,28153.7,27429.1,60640.0,67527.9,0.1,27637.099999999995,64.94569895919071,232.7618794372563,30854.978222607962,19302.371777392036,25958.33885936861,88.59825814772415,1213.4872485123612,-2040417790.0,27.182334006219655,0.01812153328771715,4.3379886267802075,4.3379886267802075,25945.275,24176.05,25378.376387931796,20156.7,28310.7,0,1049.0,3.187818827455278,48607398583.49751
2023-03-27,27129.8,27974.8,28023.3,26611.5,107240.0,67527.9,0.1,27526.3,59.1367129945805,122.44221766107557,31008.9329136601,19641.617086339902,26069.90658704779,66.22755235195424,1227.6524450471927,-2040525030.0,12.50456158975549,-0.030160687793804875,4.525106875270709,4.525106875270709,25930.975,24176.05,25784.20722137998,20156.7,28310.7,0,1050.0,3.1879198522864227,48682336415.72835
2023-03-28,27262.2,27127.8,27465.0,26665.6,94160.0,67527.9,0.1,27455.16666666666,59.74520126510187,44.627724799339376,31092.219886625164,20113.47011337484,26183.458340662288,68.96994552496946,1197.062984686679,-2040430870.0,10.374619934655078,0.0048802423902867265,4.39092584122587,4.39092584122587,25930.975,24176.05,26141.338354814383,20156.7,28310.7,0,1051.0,3.188021720489912,48757731806.564575
2023-03-29,28350.4,27262.9,28627.4,27249.8,109320.0,67527.9,0.1,27580.8,64.43302489483665,52.16121384641792,31053.132402809046,20951.417597190957,26389.83373678969,91.11308646257918,1209.958485780488,-2040321550.0,16.75143208951229,0.03991607427133537,4.267870949900135,4.267870949900135,25930.975,24176.05,26455.613752236655,20156.7,28310.7,0,1052.0,3.188131881367878,48836657661.06809
2023-03-30,28029.5,28350.3,29160.4,27716.7,122510.0,67527.9,0.1,27880.699999999997,62.13509768041319,22.749890501467462,30740.927028649727,22050.902971350275,26545.992428524005,73.45492101495198,1226.6543082247388,-2040444060.0,12.099615663031269,-0.011319064281280045,4.376297501649115,4.376297501649115,26131.025,24376.1,26665.6,28029.5,28310.7,0,1053.0,3.1882393472645614,48914593445.91015
2023-03-31,28473.7,28029.3,28646.3,27587.5,98440.0,67527.9,0.1,28284.53333333333,64.04654318792115,20.499107643401658,30270.754372952644,23321.695627047353,26729.583625807434,73.05896661304875,1214.6647147801143,-2040345620.0,3.9497221796304056,0.015847589147148566,4.265918074504241,4.265918074504241,26131.025,24376.1,27014.872,28029.5,28310.7,0,1054.0,3.1883500105214413,48993971122.50843
2023-04-01,28456.1,28473.7,28795.1,28285.6,38090.0,67527.9,0.1,28319.766666666663,63.90888402904419,5.872296368217121,29875.223777072773,24363.35622292722,26894.013756682914,72.36847267448694,1164.2958065815349,-2040383710.0,5.727767560237042,-0.0006181142598258305,4.091550868114516,4.091550868114516,26131.025,24376.1,27315.24592,28029.5,28310.7,0,1055.0,3.1884603183453097,49073325425.22647
2023-04-02,28198.3,28456.1,28522.8,27871.7,45040.0,67527.9,0.1,28376.03333333333,61.81310772993822,-31.087195138873767,29743.271834642786,24903.698165357207,27018.231494141684,62.25430577896341,1127.6389632542823,-2040428750.0,0.8569783287491856,-0.009059568950066876,3.998960799957027,3.998960799957027,26131.025,24376.1,27573.5674912,28029.5,28310.7,0,1056.0,3.1885684287238276,49151891402.13407
2023-04-03,27802.1,28194.7,28458.4,27256.9,98000.0,67527.9,0.1,28152.16666666666,58.63091413205302,-88.86841100829588,29582.906400919204,25374.303599080795,27092.885637556763,46.7103456392953,1132.914751593262,-2040526750.0,0.29436698472249256,-0.014050492405570547,4.074925101317031,4.074925101317031,26131.025,24376.1,29160.4,28029.5,28310.7,0,1057.0,3.1886732471583525,49229209862.06047
2023-04-04,28164.4,27802.2,28429.1,27668.9,64060.0,67527.9,0.1,28054.93333333333,60.627016850092254,-108.0630464187634,29198.70102211304,26146.678977886964,27194.934624456117,60.92432029502925,1106.2922693366004,-2040462690.0,0.17927011453368946,0.013031389715165487,3.9279809594260855,3.9279809594260855,26131.025,24376.1,29122.33,28029.5,28310.7,0,1058.0,3.188780659317283,49307724692.26423
2023-04-05,28173.5,28164.4,28744.4,27823.5,77320.0,67527.9,0.1,28046.66666666666,60.678338022468225,-124.36024755670815,28755.360351444655,26906.959648555337,27288.13132688887,61.28133704735372,1093.0499643839862,-2040385370.0,3.3446190076187445,0.0003231029242589667,3.879709529820527,3.879709529820527,26195.775,24376.1,29085.0214,28029.5,28310.7,0,1059.0,3.1888879228911278,49386297767.53023
2023-04-06,28036.7,28173.5,28173.5,27734.5,51290.0,67527.9,0.1,28124.866666666665,59.424353710210454,-147.01462180308772,28768.849214687143,26957.960785312855,27359.423581470885,55.9143159794421,1046.3321097851301,-2040436660.0,-0.9678319504639589,-0.0048556267414413545,3.732008794847932,3.732008794847932,26466.2,24376.1,29048.458972,28029.5,28310.7,0,1060.0,3.1889939116731805,49464458584.43566
2023-04-07,27910.4,28037.6,28102.5,27779.4,30940.0,67527.9,0.1,28040.199999999997,58.227911905579845,-171.46080773117296,28707.094592506088,27119.305407493914,27411.897526092704,50.9592373180588,994.6726733719064,-2040467600.0,1.6320615245683183,-0.004504809767197915,3.5638065859747847,3.5638065859747847,26859.325,24376.1,29012.62779256,28029.5,28310.7,0,1061.0,3.189098703263442,49542237214.95945
2023-04-08,27941.2,27910.4,28153.1,27863.8,23730.0,67527.9,0.1,27962.766666666663,58.44762453320785,-185.33200819690387,28706.055629061524,27118.594370938477,27462.307285512445,52.167601710541796,944.2889109881987,-2040443870.0,1.6945944765537502,0.0011035313001603875,3.379557467067265,3.379557467067265,27286.2,24376.1,28977.5132367088,28029.5,28310.7,0,1062.0,3.189203517307643,49620142463.96058
2023-04-09,28326.6,27941.2,28522.7,27809.2,39350.0,67527.9,0.1,28059.399999999998,61.19786183240016,-168.79570867162897,28750.899836385342,27134.360163614652,27544.6208773684,67.28784966063783,927.803988774756,-2040404520.0,1.26226607324789,0.013793251542524976,3.2753806979120546,3.2753806979120546,27286.2,24376.1,28943.100971974625,28029.5,28310.7,0,1063.0,3.1893110854405653,49699320950.12579
2023-04-10,29641.0,28326.5,29755.4,28182.9,85730.0,67527.9,0.1,28636.266666666663,68.78584582141787,-74.39610813867648,29114.88210986674,26923.07789013326,27744.276031904745,96.29749498349402,973.8537038622735,-2040318790.0,9.256242213359481,0.046401615442728694,3.285495441659436,3.285495441659436,27728.9,24673.6,27256.9,28029.5,28310.7,0,1064.0,3.1894282693421423,49782663003.45761
2023-04-11,30209.6,29641.0,30484.6,29597.8,89380.0,67527.9,0.1,29392.399999999994,71.39212170748749,16.43246805921399,29566.07814263787,26766.67185736213,27979.068790770958,91.49870161988376,967.6355821578254,-2040229410.0,10.811306497641414,0.019182888566512624,3.2030731362144,3.2030731362144,28281.55,25038.199999999997,27306.870000000003,28029.5,28310.7,0,1065.0,3.1895493475413255,49867779933.30229
2023-04-12,29886.4,30209.8,30473.0,29679.5,78690.0,67527.9,0.1,29912.33333333333,67.92060286500852,43.31136582348222,29833.200251886054,26657.119748113953,28160.719382126103,81.4666790593922,955.1973262894093,-2040308100.0,5.417912974772843,-0.010698585879985067,3.196093628839235,3.196093628839235,28812.4,25038.199999999997,27433.9792,28029.5,28310.7,0,1066.0,3.1896678675842924,49951958466.99615
2023-04-13,30387.4,29892.4,30524.1,29864.5,65870.0,67527.9,0.1,30161.13333333333,70.32912503575704,81.1986109754439,30189.067646901436,26593.772353098568,28372.784202876,95.81598922624886,934.0832315544513,-2040242230.0,8.412208565975138,0.01676347770223252,3.0739162664606097,3.0739162664606097,28848.55,25057.949999999997,27556.004032,28029.5,28310.7,0,1067.0,3.1897897644552144,50037701237.30318
2023-04-14,30472.5,30387.4,30964.9,30026.0,98380.0,67527.9,0.1,30248.766666666663,70.73110763634706,97.27272856534728,30500.89672690948,26581.633273090527,28572.757135935426,86.72060409924484,934.4272864434191,-2040143850.0,7.01981126442998,0.002800502839992891,3.0664608628875842,3.0664608628875842,29068.95,25278.35,27734.08979008,28029.5,30472.5,0,1068.0,3.1899120397320537,50123746613.150826
2023-04-15,30299.6,30472.6,30586.5,30208.8,31710.0,67527.9,0.1,30386.499999999996,68.69476588192592,82.14550709496393,30740.81892137502,26574.32107862498,28737.218361084433,82.0577130528586,894.6610516974606,-2040175560.0,6.478400061849657,-0.005673968332102763,2.9527157180209,2.9527157180209,29080.175000000003,25278.35,27992.5546068736,28029.5,30472.5,0,1069.0,3.190032855042745,50209316090.9204
2023-04-16,30310.3,30299.2,30545.3,30134.6,34480.0,67527.9,0.1,30360.8,68.75471711720226,59.78458156793545,30894.636703602242,26738.553296397746,28887.035660028774,82.34627831715204,860.0924051476421,-2040141080.0,7.489813215690308,0.0003531399754452824,2.8376241909438114,2.8376241909438114,29087.625,25278.35,28230.342238323712,28029.5,30472.5,0,1070.0,3.190153520241487,50294963090.69546
2023-04-17,29434.9,30310.8,30312.2,29274.0,71900.0,67527.9,0.1,30014.93333333333,58.82864407793121,-22.62318591926328,30891.00784106193,26959.452158938067,28939.21321621651,53.58009708737864,872.8143762085249,-2040212980.0,5.872937655788602,-0.028881271382995122,2.965236424137758,2.965236424137758,29087.625,25278.35,28449.106859257816,28029.5,30472.5,0,1071.0,3.190267614514068,50377955386.97145
2023-04-18,30382.2,29434.1,30470.1,29149.2,76580.0,67527.9,0.1,30042.466666666664,64.75792604376538,-21.97518064503106,31071.68352072946,26981.95647927054,29076.640528957796,81.96198613174838,904.8204921936301,-2040136400.0,7.874479839797756,0.03218288494270394,2.978126969717894,2.978126969717894,29181.050000000003,25278.35,28650.37031051719,28029.5,30472.5,0,1072.0,3.19038834270188,50463907209.71098
2023-04-19,28813.7,30382.2,30408.4,28641.1,111270.0,67527.9,0.1,29543.599999999995,51.526194738215075,-129.8057883195563,31062.394624113058,27069.66537588694,29051.59857381896,33.40762753838535,966.4261713226567,-2040247670.0,2.2723481285605294,-0.05162562289761763,3.354050924812352,3.354050924812352,29295.6,25278.35,30964.9,28029.5,30472.5,0,1073.0,3.1904973743805507,50545007013.77663
2023-04-20,28240.5,28813.7,29082.1,28032.4,95450.0,67527.9,0.1,29145.466666666664,47.69117089051235,-236.16245592816142,31067.09374667019,27041.646253329814,28974.351090598106,14.474964683723075,972.3743019424667,-2040343120.0,0.7269043789033633,-0.01989331463852262,3.4431908144064964,3.4431908144064964,29143.425000000003,25278.35,30918.424000000003,28029.5,30472.5,0,1074.0,3.1906018401429104,50624279603.58935
2023-04-21,27264.8,28240.5,28353.4,27171.1,98720.0,67527.9,0.1,28106.33333333333,41.965490422446614,-361.1682418750996,31140.91582703343,26848.694172966578,28811.536701017336,2.469819178659936,987.3689946608621,-2040441840.0,-2.3131162577390585,-0.034549671570970775,3.6214056023182346,3.6214056023182346,28928.1,25278.35,30802.983040000003,27264.8,30472.5,0,1075.0,3.1906984849853894,50700321808.76474
2023-04-22,27813.9,27264.8,27872.0,27165.7,44300.0,67527.9,0.1,27773.066666666666,45.90182123175483,-393.1775747722123,31156.487870168705,26794.682129831293,28716.52368187283,17.061486628763966,967.2926378993718,-2040397540.0,-0.45559961633716256,0.0201395205539745,3.4777310549738503,3.4777310549738503,28940.275,25278.35,30585.0700576,27264.8,30472.5,0,1076.0,3.1907992313327873,50778232128.2958
2023-04-23,27591.4,27813.8,27815.0,27388.5,41770.0,67527.9,0.1,27556.699999999997,44.582256876946005,-413.56612859214886,31170.423800064313,26759.676199935686,28609.36904550399,11.204990524320927,928.6645923351309,-2040439310.0,-2.5954403281720966,-0.007999597323640306,3.3657755399694502,3.3657755399694502,28970.7,25278.35,30311.520452992,27264.8,30472.5,0,1077.0,3.1908980280779584,50855419353.34076
2023-04-24,27509.3,27591.4,27978.8,27054.3,66740.0,67527.9,0.1,27638.199999999997,44.07872438355902,-415.6996006738018,31202.76093586209,26661.829064137914,28504.600564979803,11.635043215874795,928.3671214540501,-2040506050.0,-7.191727674504911,-0.0029755648499171228,3.3747391662239683,3.3747391662239683,28904.699999999997,25278.35,30059.854816752642,27264.8,30472.5,0,1078.0,3.1909959689261083,50932350335.821686
2023-04-25,28298.8,27510.1,28375.6,27201.1,65310.0,67527.9,0.1,27799.83333333333,49.9346598620297,-349.7083617888922,31201.29457957625,26675.825420423746,28485.000511172202,31.823761059683918,945.9480413501894,-2040440740.0,-6.325141676817964,0.028699385298789792,3.3427143248130293,3.3427143248130293,28885.899999999998,25278.35,29759.29933507738,27264.8,30472.5,0,1079.0,3.1910998136977686,51011936532.70887
2023-04-26,28424.6,28298.8,29995.7,27307.8,164310.0,67527.9,0.1,28077.566666666662,50.81842094250728,-286.03597103334556,31195.950486570546,26719.959513429465,28479.248081536753,35.04065872244665,1070.3731812537474,-2040276430.0,-4.891187965094501,0.004445418180276217,3.7656578500796756,3.7656578500796756,28885.899999999998,25278.35,27054.3,27264.8,30472.5,1,1080.0,3.1912044020052424,51091962802.47728
2023-04-27,29475.9,28424.5,29859.8,28392.4,121630.0,67527.9,0.1,28733.099999999995,57.560564642574484,-167.43961959841442,31231.291503559773,26841.168496440227,28574.167311866586,61.92400143200534,1098.7322397356224,-2040154800.0,-2.999598517806722,0.036985568838259875,3.727561294941367,3.727561294941367,28870.475,25278.35,27113.128,27264.8,30472.5,0,1081.0,3.191316620538969,51175408183.23355
2023-04-28,29321.8,29475.9,29587.2,28927.8,69880.0,67527.9,0.1,29074.099999999995,56.34134100584995,-97.17919358017599,31244.354749095997,26966.165250904,28645.37042502215,64.19511918917387,1067.3513654687924,-2040224680.0,-3.7761916482074027,-0.005227999823584795,3.6401290693913486,3.6401290693913486,28767.3,25278.35,27170.779440000002,27264.8,30472.5,0,1082.0,3.1914274868825876,51258399227.65969
2023-04-29,29234.1,29318.4,29425.5,29058.5,25720.0,67527.9,0.1,29343.93333333333,55.619294054855,-56.43897290536722,31260.030281380437,27041.23971861956,28701.439908353375,62.44056144371239,1017.3262679353073,-2040250400.0,-3.516548073241891,-0.0029909487139261337,3.479930177208491,3.479930177208491,28767.3,25278.35,27227.2778512,27264.8,30472.5,0,1083.0,3.1915374872636666,51341144151.250496
2023-04-30,29252.1,29235.1,29941.3,29095.0,47620.0,67527.9,0.1,29269.33333333333,55.74465480623922,-29.462951824992956,31229.285203657364,27033.094796342626,28753.883726605436,64.34217460038644,1005.1101059399282,-2040202780.0,-3.4912224557328724,0.0006157193140887696,3.436027177330613,3.436027177330613,28767.3,25278.35,27282.646294176,27264.8,30472.5,0,1084.0,3.191647401996018,51423980329.53663
2023-05-01,28077.6,29252.1,29329.6,27685.9,84360.0,67527.9,0.1,28854.599999999995,46.51251446181101,-88.56360406995509,31109.288058619066,26939.89194138094,28689.47575264301,29.957842965044776,1050.7236698013617,-2040287140.0,-4.6111928357154355,-0.040150963520567795,3.7422132582605414,3.7422132582605414,28767.3,25380.800000000003,27336.90736829248,27264.8,30472.5,0,1085.0,3.1917482535404536,51503000999.45774
2023-05-02,28669.1,28079.0,28877.4,27913.2,65330.0,67527.9,0.1,28666.266666666663,50.920924214528746,-85.61344505284617,31015.0365647093,26912.4134352907,28687.535204772248,48.144062490683,1044.543407672693,-2040221810.0,-5.638498857883899,0.021066615380231912,3.6434468039551056,3.6434468039551056,28767.3,25629.550000000003,27390.08322092663,27264.8,30472.5,0,1086.0,3.1918533913283387,51584005907.4612
2023-05-03,29023.6,28669.1,29244.7,28164.4,81220.0,67527.9,0.1,28590.099999999995,53.399848569335944,-58.85534783691841,30840.946661605354,26950.12333839464,28719.541375746317,66.95111171550957,1047.0974499817864,-2040140590.0,0.7284729139263538,0.012365229463080496,3.607744904084216,3.607744904084216,28804.0,26412.25,27442.195556508097,27264.8,30472.5,0,1087.0,3.191960965291733,51666196509.03855
2023-05-04,28842.1,29023.6,29352.7,28687.4,53800.0,67527.9,0.1,28844.93333333333,51.953001545331176,-52.649724429438976,30619.90863726387,27008.12136273612,28731.21362567524,60.780580675868585,1019.8262035545159,-2040194390.0,2.130273897416825,-0.006253531608759744,3.5358944166843465,3.5358944166843465,28830.675,27448.65,27493.265645377935,27264.8,30472.5,0,1088.0,3.1920669694847925,51747826488.071045
2023-05-05,29513.2,28842.2,29653.9,28825.3,74520.0,67527.9,0.1,29126.299999999992,56.631945301357135,-5.120362927978789,30480.991267917783,27068.398732082216,28805.688518468072,83.59624668525193,1006.1671890149079,-2040119870.0,8.246530324814419,0.02326806993942898,3.409210756593348,3.409210756593348,28911.6,27448.65,27543.314332470374,27264.8,29513.2,0,1089.0,3.1921777183599627,51831658234.794876
2023-05-06,28857.1,29512.8,29816.4,28414.9,58940.0,67527.9,0.1,29070.8,51.36546714540021,-18.868783707452423,30257.692618214944,27146.377381785063,28810.58485004254,61.29054191881412,1034.4052469424146,-2040178810.0,3.7506426642793604,-0.02223073065611325,3.5845779615498943,3.5845779615498943,28911.6,27556.4,27592.362045820966,27264.8,29513.2,0,1090.0,3.192283401562692,51913398417.22529
2023-05-07,28424.8,28857.1,29122.0,28419.6,36500.0,67527.9,0.1,28931.699999999993,48.18582676726266,-55.978817400023615,30173.969237674264,27129.090762325734,28773.843435752773,46.593458897123796,1010.690586446528,-2040215310.0,3.020506389672136,-0.014980715317894022,3.5556647239260366,3.5556647239260366,28911.6,27932.5,27640.428804904546,27264.8,29513.2,0,1091.0,3.1923856159003874,51993738133.12231
2023-05-08,27670.5,28424.8,28627.8,27280.3,85720.0,67527.9,0.1,28317.466666666664,43.16492931992317,-126.20778889036987,29871.5733804606,27160.316619539393,28668.763108538224,16.796679310098085,1034.7484017003474,-2040301030.0,0.585983649165921,-0.026536686273957888,3.739536335448754,3.739536335448754,28810.199999999997,28788.2,29995.7,27264.8,29513.2,0,1092.0,3.1924818211216643,52071552554.83513
2023-05-09,27634.9,27670.5,27816.0,27366.3,49750.0,67527.9,0.1,27910.066666666662,42.937529736495605,-167.36014217266666,29857.4867249469,27056.523275053096,28570.299955344108,13.058849524931944,992.9592301503226,-2040350780.0,-2.346035874312684,-0.0012865687284291383,3.593134877094987,3.593134877094987,28778.975,28788.2,29941.392,27264.8,29513.2,0,1093.0,3.1925775399707295,52149263624.53579
2023-05-10,27603.3,27634.3,28311.7,26885.7,91450.0,67527.9,0.1,27636.233333333326,42.722382455337176,-187.49384183700857,29872.099175470066,26978.190824529935,28478.20472150181,23.484749312737232,1023.8907137110137,-2040442230.0,-2.889398619505637,-0.0011434816120197144,3.709305458807511,3.709305458807511,28543.575,28788.2,29888.17016,27264.8,29513.2,0,1094.0,3.192672803753344,52226884336.163445
2023-05-11,26983.5,27604.3,27607.4,26766.2,62850.0,67527.9,0.1,27407.233333333326,38.633436923325085,-230.508228272736,29907.50007685351,26914.659923146486,28335.85189088259,6.843878932946974,1010.84137701737,-2040505080.0,-8.455721453797853,-0.02245383704122328,3.7461462635216707,3.7461462635216707,28473.525,28788.2,29768.0713536,27264.8,29513.2,0,1095.0,3.192762968261762,52302361050.114395
2023-05-12,26799.2,26983.1,27044.0,25853.1,87490.0,67527.9,0.1,27128.666666666668,37.484577402704815,-257.29093321749076,29996.585667478437,26724.104332521565,28189.504091750914,23.14221417738863,1023.7027072304151,-2040592570.0,-8.603155331528074,-0.0068300998758500375,3.8199002478820825,3.8199002478820825,27998.175,28409.0,29587.959072384,27264.8,29513.2,0,1096.0,3.1928514521502698,52377197269.85027
2023-05-13,26777.5,26798.7,27011.9,26695.6,27950.0,67527.9,0.1,26853.399999999994,37.34376504642442,-261.53277079594653,30067.071977088046,26572.228022911957,28055.02751158416,22.611418228071066,973.1739424282429,-2040620520.0,-8.403200372168113,-0.0008097256634527206,3.63429723621788,3.63429723621788,27998.175,28409.0,29289.17034659328,27264.8,29513.2,0,1097.0,3.1929395579233764,52451967289.076744
2023-05-14,26920.0,26777.4,27176.1,26609.9,26350.0,67527.9,0.1,26832.233333333326,38.96522165960421,-240.34911877706085,30109.65784154238,26470.712158457616,27946.92965333805,26.919486286680307,944.1043751119396,-2040594170.0,-7.9724190741861225,0.005321631967136531,3.5070742017531185,3.5070742017531185,27982.75,28409.0,29014.28471886582,27264.8,29513.2,0,1098.0,3.1930286026362844,52527255219.49736
2023-05-15,27183.9,26920.4,27651.7,26752.1,53270.0,67527.9,0.1,26960.466666666664,41.96074085821136,-196.04447584851974,30116.675335342083,26352.204664657922,27874.260162543953,33.57807887366593,940.9254911753726,-2040540900.0,-3.182964355927847,0.009803120356612238,3.461333698164622,3.461333698164622,27705.975,28409.0,28761.389941356552,27264.8,29513.2,0,1099.0,3.193119542630608,52603488216.64902
2023-05-16,27035.3,27183.9,27295.3,26881.9,45290.0,67527.9,0.1,27046.399999999998,40.748007792939326,-165.44852764670696,30115.32458289798,26214.625417102015,27794.359194682624,29.82867812176721,903.2450989485602,-2040586190.0,-5.698818588654682,-0.005466470962591896,3.340984190848854,3.340984190848854,27582.425,28409.0,28528.72674604803,27264.8,29513.2,0,1100.0,3.1932090982453345,52679209816.75657
2023-05-17,27403.1,27035.5,27465.3,26597.7,58140.0,67527.9,0.1,27207.43333333333,44.98611542609496,-111.71628162346116,29941.03825559924,26181.631744400765,27757.096414236657,39.108823455201446,900.6990204522344,-2040528050.0,-5.583387312394052,0.01360443568223757,3.286850832395731,3.286850832395731,27503.4,28409.0,28314.676606364188,27264.8,29513.2,0,1101.0,3.193301356236668,52756239803.89323
2023-05-18,26828.0,27403.8,27467.0,26449.8,63390.0,67527.9,0.1,27088.799999999992,40.15025598041556,-106.21843668515345,29796.09722738053,26077.19277261947,27668.61104145221,24.598188378371578,909.0205189913605,-2040591440.0,-6.983194704962532,-0.020986676689863537,3.388327564452663,3.388327564452663,27503.4,28409.0,28117.750477855054,27264.8,29513.2,0,1102.0,3.193388847252762,52831247997.13922
2023-05-19,26882.9,26828.2,27154.7,26711.3,36670.0,67527.9,0.1,27037.999999999996,40.8044370784606,-90.79396449956334,29632.28079227133,26005.889207728676,27593.78141845676,25.983397673655848,875.7619104919777,-2040554770.0,-8.912283317295309,0.0020463694647383512,3.2576913595333004,3.2576913595333004,27338.4,28409.0,27936.57843962665,27264.8,29513.2,0,1103.0,3.1934765751280647,52906463050.76578
2023-05-20,27116.2,26883.0,27147.2,26831.3,17720.0,67527.9,0.1,26942.366666666665,43.62446524658949,-58.36424194990775,29424.061409858943,26000.51859014106,27548.29747384183,38.639909449662014,835.7717740282651,-2040537050.0,-6.032830741827827,0.008678379192720964,3.082186198760391,3.082186198760391,27338.4,28409.0,27769.900164456518,27264.8,29513.2,0,1104.0,3.1935659576771434,52982520549.60696
2023-05-21,26749.9,27116.2,27257.1,26677.6,27420.0,67527.9,0.1,26916.333333333332,40.37242444942662,-55.108024873924535,29398.355315960624,25893.454684039374,27472.259619190227,32.32061123725097,817.4666473119604,-2040564470.0,-5.892389744167057,-0.013508529956262283,3.055961507564366,3.055961507564366,27487.575,28409.0,27616.556151299996,27264.8,29513.2,0,1105.0,3.193652213586814,53057279344.91092
2023-05-22,26847.3,26749.9,27048.9,26546.1,35560.0,67527.9,0.1,26904.466666666664,41.61867830017445,-40.590039075737195,29274.1349077282,25835.49509227179,27412.739655457823,40.437647441633445,794.9904582182492,-2040528910.0,-2.975009486637396,0.003641135107047111,2.961156087272274,2.961156087272274,27473.975,28409.0,27475.479659195997,27264.8,29513.2,0,1106.0,3.193739048763438,53132398051.76845
2023-05-23,27220.7,26851.6,27448.1,26804.1,50890.0,67527.9,0.1,26939.3,46.256217866658616,-2.068263501315414,29050.361379938277,25878.978620061727,27394.45016446184,55.62515252582775,784.2054254883742,-2040478020.0,-1.498829378792761,0.013908288729220564,2.880915720346553,2.880915720346553,27473.975,28409.0,25853.1,27264.8,29513.2,0,1107.0,3.193828649136719,53208861184.63195
2023-05-24,26328.4,27220.7,27220.7,26088.7,72650.0,67527.9,0.1,26798.8,38.405214509473495,-31.290055758794892,28865.415311907687,25812.55468809232,27292.921577370238,26.426109196041494,809.0478950963474,-2040550670.0,-4.618650668579473,-0.03278020036222429,3.072909463151378,3.072909463151378,27337.524999999998,28409.0,25885.0,26328.4,29513.2,0,1108.0,3.1939108876158215,53282112401.54206
2023-05-25,26475.8,26327.1,26589.2,25892.5,50170.0,67527.9,0.1,26674.966666666664,40.21052157540926,-35.01780784782193,28387.659461946598,25986.570538053405,27215.10047476355,34.62137217836094,801.0230454466083,-2040500500.0,-1.8815201882632007,0.005598517190562147,3.025491374940921,3.025491374940921,27288.475,28409.0,27448.1,26328.4,29513.2,0,1109.0,3.193994126016419,53355909643.869576
2023-05-26,26711.5,26475.5,26911.6,26330.0,45880.0,67527.9,0.1,26505.233333333334,43.083246468439405,-16.85606215400753,28019.37901552598,26140.290984474024,27167.138524786067,46.555252387448824,785.3499707718504,-2040454620.0,-0.32724857458431866,0.00890246942490891,2.9401193147964375,2.9401193147964375,27257.25,28409.0,27416.987999999998,26328.4,29513.2,0,1110.0,3.194079067695476,53430572661.421295
2023-05-27,26857.5,26711.2,26882.9,26591.2,18680.0,67527.9,0.1,26681.599999999995,44.85085470104142,8.387501890749093,27713.002897630675,26289.937102369327,27137.649141473106,54.854479308776696,750.0892585738611,-2040435940.0,0.2987582858743348,0.005465810605918886,2.7928483983016332,2.7928483983016332,27252.525,28409.0,27386.498239999997,26328.4,29513.2,0,1111.0,3.19416497886128,53505772912.6964
2023-05-28,28071.2,26855.3,28181.9,26788.5,55230.0,67527.9,0.1,27213.399999999994,56.84826122234315,104.86550598471354,27824.01212514637,26218.997874853623,27226.558747047096,95.16467196645405,796.0400258185855,-2040380710.0,4.276374442793465,0.04519035651121661,2.8357890856770833,2.8357890856770833,27435.975,28409.0,25892.5,26328.4,28071.2,0,1112.0,3.1942601735689173,53585279021.73593
2023-05-29,27739.4,28068.4,28431.2,27548.8,54560.0,67527.9,0.1,27556.03333333333,53.42646056467849,142.06513153368888,27846.322852830413,26207.137147169586,27275.400771137847,72.74983259148387,802.2085954029724,-2040435270.0,2.043488976931198,-0.011819943572059621,2.891946456675243,2.891946456675243,27498.3,28409.0,25938.288,26328.4,28071.2,0,1113.0,3.1943526104018574,53663646329.89438
2023-05-30,27698.2,27738.9,28033.6,27583.8,45190.0,67527.9,0.1,27836.266666666663,52.999863572462765,158.3817699167745,27865.33960742179,26197.610392578208,27315.667364362816,71.12695474061528,777.0365528741886,-2040480460.0,2.451979449090639,-0.0014852520241966927,2.8053684097673806,2.8053684097673806,27498.3,28409.0,26038.00448,26328.4,28071.2,0,1114.0,3.194444523357325,53741884535.25176
2023-05-31,27216.1,27696.9,27825.0,26865.1,63080.0,67527.9,0.1,27551.233333333334,48.15453555908223,132.2558193007809,27880.449680469574,26205.760319530425,27306.184758233023,52.13692047110719,790.0982276688895,-2040543540.0,-0.6824045454711328,-0.017405463170892088,2.903054543703505,2.903054543703505,27498.3,28409.0,26133.7323008,26328.4,28071.2,0,1115.0,3.19453246619681,53818424444.484955
2023-06-01,26819.0,27216.4,27340.9,26662.3,51980.0,67527.9,0.1,27244.43333333333,44.542358123434205,86.0203053118444,27880.329939422343,26207.86006057766,27259.78620982988,36.495056524993096,782.1340685496833,-2040595520.0,-0.033547040405546444,-0.01459062834131264,2.9163431468350174,2.9163431468350174,27324.699999999997,28409.0,26225.631008768,26328.4,28071.2,0,1116.0,3.1946170556647893,53893539402.28446
2023-06-02,27244.7,26819.0,27299.4,26541.3,49370.0,67527.9,0.1,27093.266666666663,48.96225185643525,81.917364744841,27898.68301318933,26236.226986810667,27258.34942794132,53.26348130933155,780.4173493675632,-2040546150.0,1.3458369446748648,0.015873075058727038,2.8644740054673505,2.8644740054673505,27201.149999999998,28409.0,26313.85376841728,26328.4,28071.2,0,1117.0,3.1947048211099682,53970202742.57312
2023-06-03,27072.0,27246.0,27317.5,26931.4,20620.0,67527.9,0.1,27045.233333333326,47.314770394191704,66.06219160650832,27903.526185926632,26246.58381407337,27240.60186337548,46.46078701697718,752.2518244127372,-2040566770.0,-0.163002190572428,-0.006338847555671379,2.778707980247995,2.778707980247995,27261.375,28409.0,26398.54761768059,26328.4,28071.2,0,1118.0,3.1947910219546083,54046254281.84099
2023-06-04,27122.3,27070.9,27410.2,26956.1,23810.0,67527.9,0.1,27146.33333333333,47.86500615239153,57.75287108004704,27899.261849593706,26244.68815040629,27229.33501924448,48.44211604364434,730.9552655261132,-2040542960.0,1.3921547370270462,0.0018580082742316595,2.695034217327119,2.695034217327119,27314.2,28409.0,26479.853712973367,26328.4,28071.2,0,1119.0,3.1948774198253425,54122497332.62715
2023-06-05,25747.4,27122.3,27125.5,25437.5,85420.0,67527.9,0.1,26647.233333333334,36.60996559255996,-36.47583185258554,28016.761570586135,25998.39842941386,27088.198350745006,10.351738651167498,799.3156037028194,-2040628380.0,-4.096873801089859,-0.05069260350339011,3.1044517260104687,3.1044517260104687,26934.35,28012.0,28431.2,26328.4,28071.2,0,1120.0,3.1949524726202374,54193642482.69234
2023-06-06,27230.2,25745.6,27325.2,25425.6,88610.0,67527.9,0.1,26699.966666666664,50.2082097720868,2.8373588617483847,27997.32030493528,26000.54969506473,27101.72231734072,60.04125632153317,877.9073462954753,-2040539770.0,0.03489991072970203,0.057590280960407636,3.2240209263812805,3.2240209263812805,26928.4,27985.449999999997,28371.326,26328.4,28071.2,0,1121.0,3.19503932425864,54270289905.085976
2023-06-07,26342.5,27230.2,27342.0,26141.0,77480.0,67527.9,0.1,26440.03333333333,44.10796581849105,-27.49508003616819,28011.363304523875,25937.956695476132,27029.415429974935,30.506388075592255,900.9853929886557,-2040617250.0,0.05355433676181821,-0.03259983400782962,3.4202729163467995,3.4202729163467995,26829.0,27947.85,28253.49696,26328.4,28071.2,0,1122.0,3.1951188780951263,54343685832.3286
2023-06-08,26501.1,26341.8,26784.4,26231.3,39950.0,67527.9,0.1,26691.266666666663,45.384722840599565,-33.0548852444704,28012.1985366252,25898.9414633748,26979.099674739227,35.78320468458874,876.136436346609,-2040577300.0,0.09555896327967153,0.006020689000664214,3.3060379997306115,3.3060379997306115,26776.85,27947.85,28140.3810816,26328.4,28071.2,0,1123.0,3.19519952081515,54417676142.87564
2023-06-09,26479.3,26501.1,26773.9,26326.7,38960.0,67527.9,0.1,26440.966666666664,45.23177618837433,-34.23359718854519,27997.323468474468,25850.12653152553,26931.499705716444,35.05789193505456,845.4981194647083,-2040616260.0,-0.8692885086947596,-0.0008226073634679532,3.1930531376007236,3.1930531376007236,26673.15,27917.0,28031.789838336,26328.4,28071.2,0,1124.0,3.1952797905868864,54491589330.60047
2023-06-10,25844.0,26479.3,26525.1,25468.3,83570.0,67527.9,0.1,26274.8,40.9054567829914,-71.67864618204271,28049.55139097992,25707.30860902008,26827.92830517202,13.920681394729876,860.5911109315148,-2040699830.0,-3.7736200316485156,-0.023992326081127446,3.3299454841801377,3.3299454841801377,26673.15,27710.65,27927.54224480256,26328.4,28071.2,0,1125.0,3.1953546671087145,54563107999.95351
2023-06-11,25928.4,25843.3,26190.1,25660.8,39200.0,67527.9,0.1,26083.899999999994,41.70320871277161,-83.79885851584675,28074.821156243852,25590.148843756142,26742.258942774686,16.728772957146745,836.9274601506922,-2040660630.0,-7.6334463792071565,0.0032657483361708817,3.2278407466357053,3.2278407466357053,26673.15,27710.65,27827.464555010458,26328.4,28071.2,0,1126.0,3.1954300482045745,54634947566.84486
2023-06-12,25906.8,25927.9,26080.7,25635.0,40750.0,67527.9,0.1,25893.066666666662,41.54862166888401,-85.98427011208065,28058.057656069326,25475.52234393067,26662.691424415192,18.4509202453988,808.9826415685,-2040701380.0,-6.6064875231620075,-0.0008330633590967196,3.1226652522445844,3.1226652522445844,26673.15,27710.65,27731.38997281004,26328.4,28071.2,0,1127.0,3.1955050577984636,54706703697.73703
2023-06-13,25929.4,25906.9,26428.9,25726.4,56240.0,67527.9,0.1,25921.53333333333,41.79174552103118,-78.81146190282675,28076.34644737466,25417.333552625347,26592.85414589946,20.996915895640687,801.3767385993214,-2040645140.0,-6.385974539861793,0.0008723578365525952,3.090610421372347,3.090610421372347,26656.1,27710.65,27639.15837389764,26328.4,28071.2,0,1128.0,3.195580060939577,54778544944.62417
2023-06-14,25129.5,25929.0,26051.7,24847.4,60820.0,67527.9,0.1,25655.233333333326,36.07270171342119,-118.45951450360826,28182.16512841093,25176.884871589074,26453.487084385226,11.007491805837311,830.1569715565126,-2040705960.0,-7.666785468895244,-0.030849151927927476,3.303515675029398,3.303515675029398,26367.0,27421.550000000003,27550.616038941735,25129.5,28071.2,0,1129.0,3.195648171519133,54847276660.50339
2023-06-15,25591.3,25129.5,25732.8,24838.0,68380.0,67527.9,0.1,25550.066666666662,41.085263801344894,-104.58681952247349,28198.958151976876,25048.07184802313,26371.37402872949,29.286214135759234,834.7743307310474,-2040637580.0,-4.577724747380591,0.01837680813386644,3.2619457813047688,3.2619457813047688,26362.3,27416.85,27388.42307660523,25129.5,28071.2,0,1130.0,3.19571998634425,54917809029.69108
2023-06-16,26341.3,25591.9,26472.8,25276.0,69240.0,67527.9,0.1,25687.366666666665,48.190446968584915,-39.264961190956456,28173.88258070302,25021.527419296977,26368.509835517158,58.444133426638636,860.6333071074012,-2040568340.0,-3.315874280135224,0.029306834744620147,3.2672393052256385,3.2672393052256385,26222.9,27416.85,27184.389230476812,25129.5,28071.2,0,1131.0,3.1957977838520017,54991208749.7219
2023-06-17,26515.0,26341.3,26767.3,26183.5,35860.0,67527.9,0.1,26149.199999999997,49.703358610643654,18.191329370583162,27943.709841161188,25096.080158838813,26382.461279753617,65.19710753440633,840.8594994568724,-2040532480.0,-2.0574763593380614,0.006594207575176592,3.1712596622925604,3.1712596622925604,26220.275,27389.65,26996.678092038666,25129.5,28071.2,0,1132.0,3.1958767912973487,55065264070.466934
2023-06-18,26339.7,26515.0,26679.3,26290.6,27310.0,67527.9,0.1,26398.66666666666,48.17443041821209,45.39185435028577,27760.143818679273,25139.67618132072,26378.38877691994,59.972044728434525,808.5623923528101,-2040559790.0,-2.8854485054733505,-0.006611352064868958,3.0697479179823994,3.0697479179823994,26218.625,27389.65,26823.983844675575,25129.5,28071.2,0,1133.0,3.1959541865527723,55138661059.14725
2023-06-19,26845.9,26339.7,27029.7,26295.1,46450.0,67527.9,0.1,26566.866666666665,52.69918362942457,95.5910358225533,27602.77169902466,25211.818300975345,26422.913655308515,80.18769968051124,803.2793643276096,-2040513340.0,4.266450204680861,0.019218138399450302,2.992186383498447,2.992186383498447,26284.225,27389.65,24838.0,25129.5,28071.2,0,1134.0,3.196035453453211,55213958128.184456
2023-06-20,28307.7,26845.9,28393.0,26665.5,100550.0,67527.9,0.1,27164.43333333333,62.79977643005236,218.34009382079057,27879.16937997576,25044.58062002424,26602.417116707704,97.60056258790438,869.2951240184947,-2040412790.0,3.9570036209796475,0.05445151773641399,3.0708786797178673,3.0708786797178673,26625.05,27389.65,24881.834,25129.5,28071.2,0,1135.0,3.1961278457218922,55294555969.53814
2023-06-21,29996.9,28307.7,30769.5,28270.5,143490.0,67527.9,0.1,28383.5,70.60988840492429,394.1417959600265,28713.97461790309,24527.56538209691,26925.70120083078,86.97462699148615,985.7026151600309,-2040269300.0,13.8726392711398,0.05967280987151913,3.2860149387437727,3.2860149387437727,27803.75,27803.75,25022.280639999997,25129.5,28071.2,1,1136.0,3.1962324084378486,55380967521.48982
2023-06-22,29890.5,29992.8,30497.8,29590.4,79220.0,67527.9,0.1,29398.366666666665,69.61841497453716,478.4907258909667,29277.31674637323,24228.803253626764,27208.06299122785,85.1808142965523,980.1095712200286,-2040348520.0,12.789657787789945,-0.0035470331934300825,3.279000254997503,3.279000254997503,27803.75,27803.75,25367.113801599997,25129.5,28071.2,0,1137.0,3.196336001541782,55467053614.254814
2023-06-23,30679.4,29890.2,31395.4,29822.6,98850.0,67527.9,0.1,30188.93333333333,72.68136278947026,557.1424969123186,29983.77807659892,23883.08192340108,27538.666515872814,89.08103821636624,1022.4446018471697,-2040249670.0,15.861824141876872,0.026393001120757376,3.332674699789336,3.332674699789336,28116.7,28116.7,25691.256973503998,25129.5,30679.4,0,1138.0,3.1964449433626636,55555781971.47606
2023-06-24,30533.6,30680.7,30795.3,30269.4,38150.0,67527.9,0.1,30367.83333333333,71.25166437719597,567.1801324794451,30535.228618089954,23672.76138191005,27823.89827626588,86.85759599841397,986.9771302866574,-2040287820.0,18.145797864107717,-0.0047523745575207554,3.2324296194574416,3.2324296194574416,28226.2,28116.7,26147.58841562368,25129.5,30679.4,0,1139.0,3.1965526550077032,55644067710.57516
2023-06-25,30465.3,30533.6,31040.2,30315.8,37120.0,67527.9,0.1,30559.43333333333,70.55153914637442,537.338718472929,31006.275495226946,23673.504504773045,28075.46034519294,85.8160246439137,968.2216209804676,-2040324940.0,17.49780163835793,-0.0022368800272486444,3.178112872613983,3.178112872613983,28453.075,28116.7,26567.413342373784,25129.5,30679.4,0,1140.0,3.1966596760064356,55732162640.33246
2023-06-26,30267.0,30466.3,30645.9,29986.3,58710.0,67527.9,0.1,30421.966666666664,68.44857522563944,474.54522508390943,31372.62542095771,23610.83457904229,28284.178407555515,82.79196022813919,946.177219481863,-2040383650.0,16.830330260780958,-0.006509044716447865,3.1261017592819336,3.1261017592819336,28479.85,28116.7,26953.65227498388,25129.5,30679.4,0,1141.0,3.1967650918748505,55819633483.591415
2023-06-27,30689.1,30267.0,30993.7,30231.3,55820.0,67527.9,0.1,30473.799999999992,70.46655478495401,432.9006394844571,31789.857595766112,23628.262404233898,28513.218559216893,89.22896269863051,933.0502752331586,-2040327830.0,18.356383101807204,0.013945881653285808,3.040331176975404,3.040331176975404,28480.975,28116.7,27308.99209298517,25129.5,30679.4,0,1142.0,3.1968732493430614,55908533022.73041
2023-06-28,30078.6,30691.9,30703.4,29919.5,51060.0,67527.9,0.1,30344.899999999994,64.08255844891968,339.81006977432025,32053.992422205127,23721.877577794883,28662.30250595814,79.91887028395396,922.3966841450759,-2040378890.0,19.69438309556497,-0.019893056492370276,3.0666210666223694,3.0666210666223694,28573.575,28116.7,27635.904725546356,25129.5,30679.4,0,1143.0,3.196976910381811,55995438233.582664
2023-06-29,30445.7,30077.3,30823.1,30051.3,49570.0,67527.9,0.1,30404.466666666664,66.07295246456255,280.9677676496408,32341.873991628632,23830.636008371363,28832.14988634308,84.4805046246364,911.6397781347133,-2040329320.0,18.96894647790461,0.012204690377876748,2.9943137393284216,2.9943137393284216,28974.825,28116.7,27936.664347502647,25129.5,30679.4,0,1144.0,3.197082946718217,56083600186.321655
2023-06-30,30472.9,30445.7,31275.5,29714.5,118650.0,67527.9,0.1,30332.399999999994,66.22231194253999,224.3442205499606,32563.839331676514,24071.560668323487,28988.411801929455,82.30012087722328,958.022651125091,-2040210670.0,15.684875082095425,0.0008933938125910146,3.143851261695116,3.143851261695116,29304.800000000003,28116.7,28213.363199702435,25129.5,30679.4,0,1145.0,3.197188961789994,56171885329.58181
2023-07-01,30586.8,30472.9,30649.9,30329.0,22460.0,67527.9,0.1,30501.8,66.87984647255158,177.10131161465029,32757.84050556067,24343.399494439334,29140.639249364744,84.1600062686099,912.5138903304417,-2040188210.0,15.35659060908919,0.0037377473099047265,2.983358475978009,2.983358475978009,29335.825,28116.7,28467.92614372624,25129.5,30679.4,0,1146.0,3.1972955601912276,56260581646.140236
2023-07-02,30617.7,30587.1,30769.0,30227.9,28820.0,67527.9,0.1,30559.13333333333,67.0671463300881,132.51404048925372,32901.427531249996,24670.90246875001,29281.311701806197,84.75187734054859,885.98432673541,-2040159390.0,16.241642843312565,0.0010102397112481398,2.8936998100295255,2.8936998100295255,29305.85,28116.7,28702.12405222814,25129.5,30679.4,0,1147.0,3.197402161893666,56349414082.517944
2023-07-03,31151.3,30617.5,31377.0,30581.5,56490.0,67527.9,0.1,30785.266666666663,70.20106599140283,123.70772342225109,33065.87353772791,25028.646462272096,29459.4058254437,94.83921435971158,879.5211605400236,-2040102900.0,16.037458233845754,0.01742782769443818,2.823385093206459,2.823385093206459,29331.225,28116.7,28917.58612804989,25129.5,30679.4,0,1148.0,3.1975122311122153,56440037416.282745
2023-07-04,30768.4,31152.0,31326.5,30657.8,42120.0,67527.9,0.1,30845.8,65.39224128522366,79.01901304511011,32983.51461057077,25674.895389429224,29584.071937306206,79.93535793145382,864.4625062157363,-2040145020.0,8.692687855247867,-0.012291621858477764,2.8095790038342465,2.8095790038342465,29331.225,28116.7,29115.811237805898,25129.5,30679.4,0,1149.0,3.197619453395721,56529439084.72153
2023-07-05,30512.8,30768.6,30875.6,30233.3,43230.0,67527.9,0.1,30810.833333333332,62.32318370515745,22.126458030573758,32830.66934298339,26319.890657016607,29672.52222899133,51.10249307479212,848.5937557717551,-2040188250.0,1.7198443839196644,-0.008307224295056037,2.781107455794798,2.781107455794798,29331.225,28116.7,29298.178338781425,25129.5,30679.4,0,1150.0,3.197724688111885,56618024493.895836
2023-07-06,29913.1,30512.8,31463.6,29869.0,90810.0,67527.9,0.1,30398.099999999995,55.7159966803245,-61.442917423807785,32652.33189631842,26855.408103681584,29695.43439765882,11.354410839860426,901.8799160737725,-2040279060.0,0.0756093073049917,-0.019654046826249938,3.014999836438793,3.014999836438793,29369.925,28150.8,29465.95607167891,29913.1,30679.4,0,1151.0,3.1978254879926977,56704614839.64592
2023-07-07,30346.4,29912.7,30442.0,29757.4,46420.0,67527.9,0.1,30257.43333333333,59.090647905370865,-91.28827479973938,32440.72509185017,27450.154908149834,29757.431121691312,36.12715110628334,886.3599220685029,-2040232640.0,-1.0854188804213902,0.014485292396976712,2.9208074831561666,2.9208074831561666,29369.925,28150.8,29665.720464511018,29913.1,30679.4,0,1152.0,3.197929140001104,56792702818.79942
2023-07-08,30288.8,30346.8,30379.9,30055.9,17410.0,67527.9,0.1,30182.766666666663,58.45296170539837,-117.01594222463336,32012.06615586284,28273.72384413716,29808.037681530237,32.83402892916356,846.191356206467,-2040250050.0,-0.8017397227971784,-0.0018980834629479526,2.793743417390148,2.793743417390148,29369.925,28150.8,29757.4,29913.1,30679.4,0,1153.0,3.198032178401122,56880626623.95253
2023-07-09,30166.9,30288.8,30425.5,30071.9,20050.0,67527.9,0.1,30267.366666666665,57.04979818686092,-142.6508073030077,31408.75882147597,29209.13117852402,29842.215045194025,25.86473043279411,811.0062593345765,-2040270100.0,-0.9794750092728377,-0.004024589947439261,2.6883977449939382,2.6883977449939382,29380.65,28150.8,29757.4,29913.1,30679.4,0,1154.0,3.198134150142042,56968166603.73915
2023-07-10,30415.3,30166.9,31019.6,29969.1,55240.0,67527.9,0.1,30290.33333333333,59.19913136255601,-142.92687272464286,31019.66509573921,29808.984904260793,29896.794564699358,40.06631982162254,828.1129550963924,-2040214860.0,0.48997257739451966,0.008234190453775492,2.722685474403976,2.722685474403976,29380.65,28150.8,29928.02,29913.1,30679.4,0,1155.0,3.1982376572854334,57056577124.52507
2023-07-11,30623.3,30414.2,30782.2,30333.8,39840.0,67527.9,0.1,30401.83333333333,60.960845205023794,-129.5465363616047,31025.64348785108,29865.64651214892,29965.985558537515,51.95814990566577,800.9906011609359,-2040175020.0,-0.21440837300539697,0.006838663435836612,2.615624707856227,2.615624707856227,29490.15,28150.8,30071.9,29913.1,30679.4,0,1156.0,3.1983424041077093,57145718837.83523
2023-07-12,30387.3,30623.3,30951.3,30231.7,54060.0,67527.9,0.1,30475.3,57.90577504834514,-136.3478312446057,30992.953924539564,29948.01607546043,30006.110743438705,38.46549654107826,795.1769867922975,-2040229080.0,1.026311065009677,-0.007706550241156296,2.6168069778897682,2.6168069778897682,29717.025,28150.8,29969.1,29913.1,30679.4,0,1157.0,3.1984452967630697,57234095943.42204
2023-07-13,31466.1,30387.3,31764.5,30260.0,99810.0,67527.9,0.1,30825.566666666662,66.23570750774137,-71.22381781788124,31185.323929233215,29834.316070766778,30145.157339301684,85.44390243902431,845.8429163071334,-2040129270.0,3.351540611646301,0.035501673396451716,2.688108524116854,2.688108524116854,29894.25,28301.25,30118.55,29913.1,31466.1,0,1158.0,3.198555393849358,57326099867.544525
2023-07-14,30317.4,31465.4,31602.6,29944.3,82420.0,67527.9,0.1,30723.599999999995,53.985430756320554,-106.42383562950124,31179.546646779232,29818.473353220765,30161.561402225336,27.900951621742834,903.875565142338,-2040211690.0,-0.5102894703162482,-0.036505954026714416,2.9813755966617785,2.9813755966617785,29895.375,28301.25,31764.5,29913.1,31466.1,0,1159.0,3.198657377045283,57414302680.10525
2023-07-15,30291.4,30316.8,30395.4,30246.9,17060.0,67527.9,0.1,30691.63333333333,53.7431448195749,-130.7691169060697,31176.77026082151,29803.859739178493,30173.926982965782,26.605550296447632,849.920167632171,-2040228750.0,-0.9657760864163555,-0.0008575933292432891,2.805813424378441,2.805813424378441,29987.975,28301.25,31764.5,29913.1,31466.1,0,1160.0,3.1987589700904904,57502445594.71162
2023-07-16,30235.5,30291.8,30435.0,30075.4,20310.0,67527.9,0.1,30281.43333333333,53.19042096745632,-148.64473861932265,31177.3786001449,29800.101399855102,30179.791079826184,23.820437447062872,814.8972985155872,-2040249060.0,-1.2482975533759908,-0.0018454082676931938,2.6951672653522754,2.6951672653522754,30435.95,28301.25,31728.096,29913.1,31466.1,0,1161.0,3.1988599632858743,57590425675.47319
2023-07-17,30139.7,30235.5,30335.9,29693.3,42840.0,67527.9,0.1,30222.199999999997,52.19961007134571,-163.73576678742063,31159.511846647372,29763.02815335262,30175.9728817475,21.552723059096238,802.5903486216168,-2040291900.0,-3.2473765139817554,-0.0031684609151494403,2.6629009201206943,2.6629009201206943,30703.175000000003,28301.25,31692.42008,29913.1,31466.1,0,1162.0,3.1989600755565757,57678104501.038605
2023-07-18,29866.8,30139.7,30242.4,29624.6,42400.0,67527.9,0.1,30080.666666666668,49.37789825474852,-187.21929036390236,31177.64955535259,29723.71044464741,30146.527845390596,11.318285901210363,789.3910380057872,-2040334300.0,-2.9302791175361804,-0.009054502864992098,2.6430385511865593,2.6430385511865593,30694.55,28301.25,31612.4552768,29913.1,31466.1,0,1163.0,3.199058050564653,57764865880.22681
2023-07-19,29909.7,29866.7,30185.5,29789.3,34960.0,67527.9,0.1,29972.066666666666,49.83695642024629,-194.15169349522182,31188.16966132583,29659.590338674167,30123.972812496253,13.3230524790879,761.3059638625167,-2040299340.0,-1.9765475472588505,0.0014363775161718717,2.545348043820288,2.545348043820288,30694.55,28301.25,31493.183960192,29913.1,31466.1,0,1164.0,3.1991561250921166,57851800691.183945
2023-07-20,29801.0,29909.7,30408.0,29621.4,50330.0,67527.9,0.1,29859.16666666666,48.633528022610285,-199.579013805032,31200.679655158558,29579.890344841435,30093.21349702042,8.380383556530198,763.1126807294796,-2040349670.0,-0.3747521988693868,-0.0036342724935388704,2.5606948784587082,2.5606948784587082,30692.95,28301.25,31381.06892258048,29913.1,31466.1,0,1165.0,3.199253222009927,57938380982.450356
2023-07-21,29903.1,29801.0,30058.9,29739.9,32590.000000000004,67527.9,0.1,29871.266666666663,49.858281935577644,-189.8708237858486,31187.85191975106,29524.348080248936,30075.107449685143,13.144510288833805,731.3903463916596,-2040317080.0,-1.4607993040360732,0.003426059528203629,2.445867974864344,2.445867974864344,30692.95,28301.25,31240.295408774044,29913.1,31466.1,0,1166.0,3.1993508400685666,58025341011.91551
2023-07-22,29788.9,29904.5,29988.0,29657.3,18470.0,67527.9,0.1,29830.999999999996,48.46629872301125,-184.55591514827717,31172.330343202786,29456.989656797206,30047.849597334178,7.815780878167146,702.769607363684,-2040335550.0,-1.6504450489950009,-0.0038190020432663507,2.3591660227926643,2.3591660227926643,30652.475,28301.25,31110.78377607212,29913.1,31466.1,0,1167.0,3.199447441946538,58111925744.75261
2023-07-23,30085.9,29788.9,30337.0,29735.7,23320.0,67527.9,0.1,29925.966666666664,52.20367019767587,-155.61078283768114,31032.571285826885,29490.208714173106,30051.473445207113,21.674210256170984,695.5217782662779,-2040312230.0,-0.2685062104492009,0.009970156669094843,2.3117865121744003,2.3117865121744003,30360.575,28301.25,30991.63307398635,29913.1,31466.1,0,1168.0,3.199545943519159,58199569889.02484
2023-07-24,29178.1,30085.9,30098.2,28890.7,55730.0,67527.9,0.1,29684.3,42.14315187089952,-189.90488870422737,31049.470327044608,29314.279672955392,29968.295021854054,10.000695942654252,732.091651247258,-2040367960.0,-4.067689616738946,-0.030173602916981124,2.5090449729326383,2.5090449729326383,29995.225,28301.25,30882.014428067443,29913.1,31466.1,0,1169.0,3.19963774473418,58284033740.84621
2023-07-25,29228.6,29178.3,29365.4,29058.7,29050.0,67527.9,0.1,29497.53333333333,42.80350256226869,-200.44907132309538,31064.277026708758,29171.052973291244,29897.847876915574,11.757951144825594,701.7065333010253,-2040338910.0,-4.5543752632799235,0.0017307501173826623,2.400753143499946,2.400753143499946,29988.475,28301.25,30682.882985260698,29913.1,31466.1,0,1170.0,3.1997297117026218,58368696085.24906
2023-07-26,29352.2,29228.8,29681.8,29109.7,44330.0,67527.9,0.1,29252.966666666664,44.473933597100505,-190.43258348118408,31090.49272238266,29088.747277617345,29845.881412447423,16.058876748555925,692.4489237795234,-2040294580.0,-3.4063572610926225,0.0042287348692719995,2.3591039982676714,2.3591039982676714,29988.475,28301.25,30503.664686734628,29913.1,31466.1,0,1171.0,3.1998223720847325,58453818604.80665
2023-07-27,29222.7,29352.9,29568.8,29094.0,30420.0,67527.9,0.1,29267.83333333333,43.055137209024345,-183.77236289891133,31094.68051971242,28972.189480287576,29786.530801738143,12.242339319296445,676.9025720809859,-2040325000.0,-7.129577545358331,-0.004411935050865012,2.316358762472276,2.316358762472276,29988.475,28301.25,30342.368218061165,29913.1,31466.1,0,1172.0,3.1999138944882377,58538495191.04428
2023-07-28,29315.0,29222.7,29533.0,29125.1,31420.0,67527.9,0.1,29296.63333333333,44.41620373101469,-164.9913131585634,31083.35626059662,28886.13373940337,29741.62310633451,27.475231496470858,657.6881026466299,-2040293580.0,-3.306352127820992,0.0031585034921481903,2.243520732207504,2.243520732207504,29988.475,28301.25,30197.201396255048,29913.1,31466.1,0,1173.0,3.2000058844831742,58623520526.81259
2023-07-29,29353.5,29315.0,29400.1,29256.9,13900.0,67527.9,0.1,29297.066666666666,45.00664772184216,-142.65503791940853,31072.520154852344,28815.629845147658,29704.659000969317,29.968270413779674,620.9389524575846,-2040279680.0,-3.0962583439524134,0.0013133208255160511,2.1153830121027632,2.1153830121027632,29970.725,28301.25,30066.551256629544,29913.1,31466.1,0,1174.0,3.2000979518082953,58708701778.10468
2023-07-30,29281.7,29354.2,29446.6,29054.5,20580.0,67527.9,0.1,29316.733333333326,44.06651831275669,-125.97526930227167,31029.26868211626,28745.52131788374,29664.377191353193,25.769458907269506,604.5933129963285,-2040300260.0,-3.154569959153972,-0.002446045616365966,2.0647479927611045,2.0647479927611045,29970.725,28301.25,29948.96613096659,29913.1,31466.1,0,1175.0,3.200189299999917,58793642728.89111
2023-07-31,29232.4,29282.0,29502.3,29128.3,31840.0,67527.9,0.1,29289.199999999997,43.39621710182129,-111.99224992717842,30941.24749599586,28694.452504004137,29623.236506462414,22.520266262439918,588.1223620680194,-2040332100.0,-3.010315298426989,-0.0016836454167620252,2.011885312420531,2.011885312420531,29970.725,28301.25,29843.13951786993,29913.1,31466.1,0,1176.0,3.200280091413933,58878422906.66945
2023-08-01,29712.2,29232.3,29712.2,28611.0,64010.00000000001,67527.9,0.1,29408.766666666663,51.179479601530886,-66.41133479655295,30877.183312036035,28691.006687963967,29631.70922013266,61.279910962715675,624.7707647774466,-2040268090.0,-0.5176316177159874,0.016413294837235304,2.102741516203602,2.102741516203602,29771.175,28301.25,29747.895566082938,29913.1,31466.1,0,1177.0,3.200374128700387,58964940076.20075
2023-08-02,29173.7,29711.8,30025.9,28961.6,67410.0,67527.9,0.1,29372.766666666663,43.885746621974796,-68.2490598492636,30476.307899372492,28862.642100627505,29588.08929440574,31.313299944351737,656.1657101504863,-2040335500.0,-2.460740161218601,-0.018123868309987134,2.2491686352793314,2.2491686352793314,29753.1,28301.25,28611.0,29173.7,31466.1,0,1178.0,3.200464094228145,59049542131.611084
2023-08-03,29189.3,29180.9,29409.8,28981.0,36080.0,67527.9,0.1,29358.399999999994,44.13413091423043,-64.19461239907648,30387.92835893397,28838.21164106603,29550.109361605195,33.505214368481994,639.9253022825944,-2040299420.0,-2.052615684037451,0.0005347281969718676,2.1923283610178883,2.1923283610178883,29753.1,28301.25,28611.0,29173.7,31466.1,0,1179.0,3.2005539738529114,59134216446.22094
2023-08-04,29105.5,29189.1,29319.1,28875.8,31430.0,67527.9,0.1,29156.16666666666,43.032214286694874,-62.856769486005916,30292.585551839828,28814.964448160175,29507.765612880892,28.65005793742758,625.8806378338377,-2040330850.0,-2.6672819874862426,-0.0028709150270818107,2.1503861395057213,2.1503861395057213,29753.1,28301.25,28639.298,29173.7,31466.1,0,1180.0,3.200643046512787,59218601341.488594
2023-08-05,29068.1,29105.6,29139.3,28983.0,14550.0,67527.9,0.1,29120.966666666664,42.52194486400793,-60.18737071019362,30192.8568262288,28797.9531737712,29465.89269736843,26.483198146002234,592.3391637028492,-2040345400.0,-2.4196932414422916,-0.0012849805019670146,2.0377636092584286,2.0377636092584286,29753.1,28301.25,28667.030039999998,29173.7,31466.1,0,1181.0,3.200731648977667,59302864352.54579
2023-08-06,29081.3,29067.9,29198.9,28987.4,16030.000000000002,67527.9,0.1,29084.966666666664,42.77983927853003,-53.45695982926301,30095.562579702375,28789.407420297634,29429.26482142858,31.623184507799827,565.1363662955029,-2040329370.0,-3.3391056940294357,0.0004541060475229397,1.9432981548125525,1.9432981548125525,29753.1,28520.25,28694.2074392,29173.7,31466.1,0,1182.0,3.200820149496205,59387189827.47616
2023-08-07,29204.2,29081.3,29270.2,28721.0,41190.0,67527.9,0.1,29117.866666666665,45.2432681448077,-37.41136755009154,30039.805031255386,28778.904968744613,29407.83007653062,41.92522439748393,563.9980544172528,-2040288180.0,0.0894506496310664,0.0042260834281824255,1.93122240779495,1.93122240779495,29753.1,28974.0,28720.841290416,29173.7,31466.1,0,1183.0,3.2009093436139566,59471978422.71602
2023-08-08,29777.4,29204.2,30168.6,29137.7,62570.0,67527.9,0.1,29354.3,54.978566283417045,12.454025594360871,30014.5525608468,28790.9274391532,29443.027212099132,74.88443759630216,597.3481933874489,-2040225610.0,1.8776130228611803,0.019627313879510444,2.0060455022515358,2.0060455022515358,29748.3,29027.55,28721.0,29173.7,29777.4,0,1184.0,3.201002447191857,59558854089.4218
2023-08-09,29578.0,29771.3,30104.0,29384.2,49670.0,67527.9,0.1,29519.866666666665,51.54532241762785,31.569076106420624,29981.707215144525,28801.472784855483,29455.881763327787,62.08269131997951,606.094751002631,-2040275280.0,0.7692779416875031,-0.006696353610456285,2.0491404118014436,2.0491404118014436,29456.4,29029.8,28721.0,29173.7,29777.4,0,1185.0,3.20109393060893,59645032069.458336
2023-08-10,29449.0,29578.0,29719.4,29377.5,32000.0,67527.9,0.1,29601.466666666664,49.39623381998296,34.82917627821078,29911.56994092791,28826.200059072085,29455.22635729657,53.800719054956396,587.2236973595861,-2040307280.0,0.7743979851279973,-0.004361349651768154,1.9940361212930358,1.9940361212930358,29483.9,29215.0,28778.904,29173.7,29777.4,0,1186.0,3.2011842912425297,59730760558.61183
2023-08-11,29420.8,29448.9,29544.9,29271.2,27710.0,67527.9,0.1,29482.599999999995,48.91610145954823,34.33423867495206,29858.81894441597,28842.141055584038,29451.94765660166,51.99024139702106,564.8291475481872,-2040334990.0,0.3609073852976267,-0.000957587693979467,1.9198293300936315,1.9198293300936315,29477.15,30017.5,28834.49184,29173.7,29777.4,0,1187.0,3.2012742508381944,59816402921.17698
2023-08-12,29428.2,29420.8,29480.8,29375.4,11070.0,67527.9,0.1,29432.66666666666,49.056036721047555,33.70531574533834,29701.160318961385,28934.029681038617,29449.68597502055,52.465331278890694,532.0127798661737,-2040323920.0,0.2544841330676094,0.0002515227322166247,1.807833234333645,1.807833234333645,29477.15,30187.75,28887.856166399997,29173.7,29777.4,0,1188.0,3.2013640651534043,59902088199.5994
2023-08-13,29300.1,29428.2,29468.5,29272.3,13490.0,67527.9,0.1,29383.03333333333,46.67258124359092,24.30126790834548,29702.03738185795,28945.35261814205,29435.43969168526,44.241140215716435,508.02615273287563,-2040337410.0,0.06283788168035946,-0.0043529675617265395,1.7338717367274368,1.7338717367274368,29477.15,30187.75,28939.085919743997,29173.7,29777.4,0,1189.0,3.2014527603023493,59987321330.64948
2023-08-14,29426.7,29300.1,29689.0,29116.0,39300.0,67527.9,0.1,29384.999999999996,49.294612995896664,26.089088978049134,29711.837909271322,28955.362090728675,29434.607340096187,52.369029275809034,512.6671418233844,-2040298110.0,0.6646734445341445,0.0043208043658555795,1.7421836013667331,1.7421836013667331,29477.15,30187.75,28988.266482954237,29173.7,29777.4,0,1190.0,3.2015421679911795,60073032145.15085
2023-08-15,29195.3,29426.7,29472.0,29118.6,33810.0,67527.9,0.1,29307.366666666665,44.94470336500436,11.891850163449789,29708.60474325438,28942.905256745616,29411.81616484893,32.76457584968222,501.2909174074285,-2040331920.0,-1.7396894205074058,-0.0078636068604363,1.7170260877861454,1.7170260877861454,29459.4,30187.75,29035.47982363607,29173.7,29777.4,0,1191.0,3.201629711935271,60157909402.19161
2023-08-16,28726.3,29195.3,29251.1,28717.6,43710.0,67527.9,0.1,29116.099999999995,37.6860569035585,-26.770452641149333,29763.37957950111,28838.4904204989,29346.528911053792,0.5995864920744816,503.5915661640407,-2040375630.0,-1.5335730469566817,-0.016064229516394746,1.7530679766069448,1.7530679766069448,29458.55,30187.75,30168.6,29173.7,29777.4,0,1192.0,3.2017136426633575,60241056309.57984
2023-08-17,26635.7,28726.1,28771.8,25489.4,132920.0,67527.9,0.1,28185.766666666663,21.228204242825043,-182.16595015823725,30417.059780939755,27916.880219060247,29088.35472904867,24.497777397845784,702.077882866609,-2040508550.0,-8.748411232883278,-0.07277651490097914,2.6358529449821444,2.6358529449821444,27854.95,28626.95,30139.579999999998,29173.7,29777.4,1,1193.0,3.2017814412880914,60316067778.633125
2023-08-18,26053.2,26635.7,26801.9,25691.0,93050.0,67527.9,0.1,27138.399999999994,18.76875630935139,-305.92285201237326,30842.052468589663,27161.857531410347,28799.29237390118,12.049068216789186,731.2794626618513,-2040601600.0,-10.487021353352457,-0.021869145545264423,2.8068700300226124,2.8068700300226124,27716.7,28626.95,29953.572799999998,29173.7,29777.4,1,1194.0,3.2018443928844915,60388685987.6747
2023-08-19,26099.4,26053.3,26262.2,25799.5,33040.0,67527.9,0.1,26262.766666666663,19.5647352911743,-362.5423284489231,31068.598750091776,26617.081249908217,28542.159766862973,13.036416481449828,712.095215328862,-2040568560.0,-10.21291381273629,0.0017732946432684749,2.728396880115489,2.728396880115489,27709.1,28626.95,29775.005888,29173.7,29777.4,0,1195.0,3.2019075371420045,60461483437.419525
2023-08-20,26190.8,26099.5,26269.1,25998.5,24000.0,67527.9,0.1,26114.466666666664,21.20963904322926,-370.40241508187364,31188.318916544344,26193.201083455653,28318.22074144745,14.98974183621128,680.5598428053718,-2040544560.0,-9.939376850415902,0.003501996214472225,2.598469091457198,2.598469091457198,27709.1,28626.95,29603.58165248,29173.7,29777.4,0,1196.0,3.201971237368284,60534646910.903465
2023-08-21,26126.0,26190.8,26220.9,25850.8,41100.0,67527.9,0.1,26138.733333333334,20.883568031672695,-356.4131191424563,31197.73425041175,25825.16574958825,28109.43781369055,13.604889724739248,658.3841397478453,-2040585660.0,-10.540264756439145,-0.0024741512286756695,2.520034217820735,2.520034217820735,27709.1,28626.95,29439.0143863808,29173.7,29777.4,0,1197.0,3.202034234289845,60607530886.6208
2023-08-22,26039.9,26126.8,26138.8,25481.9,47720.0,67527.9,0.1,26118.899999999994,20.434050935303773,-330.0093741547487,31227.37430018203,25482.145699817975,27912.33897429145,12.07243460764588,658.2781297658563,-2040633380.0,-12.551465205155587,-0.0032955676337746986,2.5279595150743908,2.5279595150743908,27705.35,28623.2,29281.029810925567,26039.9,29777.4,0,1198.0,3.2020963549459656,60680045191.87022
2023-08-23,26436.2,26042.0,26807.7,25812.6,60960.0,67527.9,0.1,26200.699999999997,28.10494742181453,-265.6708218104138,31179.030119565028,25255.17988043497,27771.75431007322,22.52035398230087,682.336834782581,-2040572420.0,-10.622083981337479,0.015218952453734502,2.581070028152991,2.581070028152991,27651.1,28623.2,29053.082022270035,26039.9,29777.4,0,1199.0,3.2021614773980027,60754184594.616165
2023-08-24,26177.0,26436.2,26560.5,25943.6,41040.0,67527.9,0.1,26217.699999999997,26.31778579493941,-222.15516145249399,31130.385188152995,25010.974811847005,27619.8729472091,16.522069834327656,677.6627751552539,-2040613460.0,-11.11073381099528,-0.009804737443354195,2.588771727681759,2.588771727681759,27595.875,28623.2,28838.81110093383,26039.9,29777.4,0,1200.0,3.202224342678382,60827244335.11969
2023-08-25,26057.2,26176.1,26265.7,25811.6,39960.0,67527.9,0.1,26223.466666666664,25.51035725070014,-184.56953032088336,31063.857580176315,24776.41241982369,27471.046952236808,13.674502626512313,661.6940055013074,-2040653420.0,-11.43272786599956,-0.004576536654314789,2.5393902856074613,2.5393902856074613,27476.05,28623.2,28637.396434877803,26039.9,29777.4,0,1201.0,3.2022860616047817,60899793447.31793
2023-08-26,26017.1,26057.2,26114.1,25993.5,12090.0,67527.9,0.1,26083.766666666663,25.23131696490303,-147.16408841534735,30967.51026765191,24566.33973234809,27332.57581392854,12.72135200019009,623.0444336797854,-2040665510.0,-11.591262802346055,-0.0015389220637674894,2.394749736441746,2.394749736441746,26985.025,28623.2,28448.066648785134,26039.9,29777.4,0,1202.0,3.2023472766343257,60972161792.12284
2023-08-27,26100.6,26017.1,26176.8,25968.7,14290.0,67527.9,0.1,26058.3,27.021398007541364,-103.60916072652742,30819.485426205105,24404.0045737949,27215.244784030583,14.706092082432015,593.4055455598007,-2040651220.0,-10.91975795304453,0.003209427645663787,2.2735322006383023,2.2735322006383023,26985.025,28623.2,28270.096649858027,26039.9,29777.4,0,1203.0,3.2024089868400476,61044865320.81069
2023-08-28,26118.9,26100.6,26215.7,25891.0,28840.0,67527.9,0.1,26078.866666666665,27.431461058971294,-62.407841210271954,30537.43019467069,24320.20980532931,27110.83099507529,15.964512167614853,574.2122923055292,-2040622380.0,-11.2408119157092,0.0007011333072803883,2.198455112219616,2.198455112219616,26985.025,28623.2,28102.804850866545,26039.9,29777.4,0,1204.0,3.202470665015836,61117631993.441124
2023-08-29,27723.9,26118.1,28046.0,25919.8,98320.0,67527.9,0.1,26647.8,52.591826830128085,76.56016832280716,30289.536741152217,24382.693258847787,27169.21851935383,59.482118221373284,685.0685571408486,-2040524060.0,-5.03985230499429,0.0614497547752777,2.4710396341815133,2.4710396341815133,27294.6,28623.2,25481.9,26039.9,27723.9,1,1205.0,3.202544710882956,61196892146.36031
2023-08-30,27298.8,27723.9,27757.3,27043.2,46540.0,67527.9,0.1,27047.199999999997,47.85887773831682,139.79077698304775,30018.567053130937,24438.642946869062,27181.559612748708,55.22660263229882,687.1422316307879,-2040570600.0,-4.969313834360848,-0.015333340547325713,2.5171151538924343,2.5171151538924343,27294.6,28623.2,25533.182,26039.9,27723.9,0,1206.0,3.2026153192099454,61274463350.40766
2023-08-31,25937.3,27300.6,27464.5,25731.0,69110.0,67527.9,0.1,26986.66666666666,36.522281084324284,92.15852520751264,29706.766794679486,24402.093205320514,27063.05869724883,17.760617760617684,761.8820722285889,-2040639710.0,-2.622044849581582,-0.0498739871349656,2.937399313839871,2.937399313839871,27356.875,28623.2,25583.43836,26039.9,27723.9,0,1207.0,3.2026749831088885,61346435798.93766
2023-09-01,25803.2,25938.3,26144.9,25361.9,58080.0,67527.9,0.1,26346.43333333333,35.62712900152252,55.65629427708325,29340.90014669628,24405.45985330372,26943.072154653706,16.441265228568216,763.3904956408325,-2040697790.0,-0.9595750234136305,-0.005170160348224262,2.9585109429870418,2.9585109429870418,27234.6,28563.2,28046.0,26039.9,27723.9,0,1208.0,3.2027333791066703,61417825776.47721
2023-09-02,25869.7,25803.5,25977.4,25752.7,21240.0,67527.9,0.1,25870.066666666662,36.4588384445069,40.718623459534115,28936.693012197084,24466.626987802923,26840.846235162877,18.918818225848497,724.9126030950587,-2040676550.0,-0.880096860464228,0.0025771997271655245,2.802168572094221,2.802168572094221,27234.6,28563.2,27992.318,26039.9,27723.9,0,1209.0,3.2027921390640555,61489481435.89474
2023-09-03,25971.0,25869.7,26090.4,25816.6,21360.0,67527.9,0.1,25881.3,37.77766457849013,42.20830725483131,28399.05096699102,24658.69903300898,26758.003736575938,22.692895197645353,692.6902743025547,-2040655190.0,-0.8392259877514215,0.0039157779177956265,2.667168281169592,2.667168281169592,27218.45,28482.25,27939.70964,26039.9,27723.9,0,1210.0,3.2028515431290123,61561549701.97649
2023-09-04,25823.3,25971.0,26094.2,25660.9,27130.0,67527.9,0.1,25888.0,36.58533806667038,37.929447423885904,27796.052513234852,24924.49748676515,26668.984333092514,17.190119593159647,674.1623975666579,-2040682320.0,-1.1586159381459111,-0.005687112548611983,2.6106748462305664,2.6106748462305664,27122.300000000003,27898.45,27888.153447200002,26039.9,27723.9,0,1211.0,3.2029095711128908,61632976530.82351
2023-09-05,25790.2,25824.4,25864.0,25596.3,28400.0,67527.9,0.1,25861.499999999996,36.308768875347894,37.48633649658086,27172.965949137302,25253.974050862693,26585.290587083706,15.956931559926959,645.1293691690396,-2040710720.0,-0.9589130526614953,-0.0012817881525598596,2.501451594671773,2.501451594671773,27114.7,27898.45,27837.628378256002,26039.9,27723.9,0,1212.0,3.20296715293677,61704245793.76763
2023-09-06,25758.0,25790.1,26018.4,25411.7,37780.0,67527.9,0.1,25790.499999999996,36.023473406506554,39.44262423213695,27128.106701950932,25211.063298049066,26506.501007361447,14.757274319138585,642.384414228394,-2040748500.0,-2.5654216566677537,-0.001248536265713307,2.493921943584106,2.493921943584106,27114.7,27884.95,27788.113810690884,26039.9,27723.9,0,1213.0,3.2030242959941764,61775360610.1362
2023-09-07,26249.8,25758.0,26417.7,25626.5,39770.0,67527.9,0.1,25932.66666666666,43.34555667228637,76.15081485120027,27136.992742593735,25221.837257406267,26482.053292374643,33.079989568197846,653.0140989263658,-2040708730.0,0.2781067349199651,0.019093097290162175,2.4876917116563395,2.4876917116563395,27042.525,27884.95,27739.589534477065,26039.9,27723.9,0,1214.0,3.2030852347793664,61848540141.2285
2023-09-08,25909.5,26248.5,26415.4,25701.6,41010.0,67527.9,0.1,25972.43333333333,39.93933474490538,79.44027975829385,27134.225374044403,25205.6146259556,26427.52440738658,20.401624380611707,657.3559490030541,-2040749740.0,-0.5668298973028596,-0.012963908296444115,2.53712325210079,2.53712325210079,26969.325,27884.95,27692.035743787525,26039.9,27723.9,0,1215.0,3.2031432555883983,61920267741.90179
2023-09-09,25901.1,25909.5,25938.5,25814.3,13480.0,67527.9,0.1,26020.13333333333,39.85607694613232,82.61111778581869,27126.728589555147,25184.141410444856,26377.388749540238,20.088670317797302,619.2733812171217,-2040763220.0,-0.4458606070622783,-0.00032420540728306246,2.3909153712279467,2.3909153712279467,26653.375,27884.95,27645.433028911775,26039.9,27723.9,0,1216.0,3.2032010318915054,61991942924.53308
2023-09-10,25840.2,25901.1,25995.1,25626.7,23600.0,67527.9,0.1,25883.599999999995,39.21776983737187,82.00266741607368,27122.111746587732,25160.17825341227,26326.227916250693,17.819753362393335,601.3538539873272,-2040786820.0,-0.997678214293916,-0.002351251491249373,2.327202784759124,2.327202784759124,26610.6,27849.45,27599.76236833354,26039.9,27723.9,0,1217.0,3.203258137938717,62063341316.323425
2023-09-11,25166.4,25840.2,25897.4,24923.1,56320.0,67527.9,0.1,25635.899999999994,32.93329837126892,39.75658144937847,27166.413959434227,25028.52604056577,26215.76811470301,7.790835441416721,627.9928644168041,-2040843140.0,-3.646784512364609,-0.02607564956927577,2.4953623260251927,2.4953623260251927,26258.925,27630.05,27555.00512096687,25166.4,27723.9,0,1218.0,3.2033095243614285,62131802167.96225
2023-09-12,25834.5,25166.4,26472.6,25133.5,78710.0,67527.9,0.1,25613.699999999997,42.73247195696499,59.173751566156966,27130.35433215918,25004.415667840818,26179.456865683675,32.157222496648124,678.7862312441752,-2040764430.0,-6.815058487442248,0.02654730116345605,2.6274409461927855,2.6274409461927855,26091.199999999997,27630.05,27449.728916128195,25166.4,27723.9,0,1219.0,3.203366235139186,62203138818.96266
2023-09-13,26223.0,25836.1,26382.3,25766.9,42580.0,67527.9,0.1,25741.3,47.53314136620427,98.24408808454018,27133.791553457373,25005.578446542622,26183.60383085666,51.14897300700404,674.2586432981625,-2040721850.0,-3.9408325640687476,0.015038030540556191,2.5712490687494283,2.5712490687494283,26091.199999999997,27545.85,27348.663759483068,25166.4,27723.9,0,1220.0,3.203425901084647,62276110375.592545
2023-09-14,26524.7,26223.0,26760.3,26148.6,53820.0,67527.9,0.1,26194.066666666662,50.970462658930856,141.82122558852825,27175.42488746214,25010.695112537862,26216.089180298884,87.1761376006968,669.7901687768652,-2040668030.0,2.2646921614817326,0.011505167219616474,2.5251564344813144,2.5251564344813144,26163.125,27545.85,27251.641209103745,25166.4,27723.9,0,1221.0,3.203487788643076,62350334760.69463
2023-09-15,26601.0,26523.3,26837.4,26233.1,36470.0,67527.9,0.1,26449.566666666662,51.829962812783265,171.2310123981806,27226.134967166232,25018.375032833763,26252.747353603754,87.65083842657884,665.112299578518,-2040631560.0,3.091864574936439,0.0028765641081709425,2.5003281815665503,2.5003281815665503,26182.4,27545.85,27158.499560739594,25166.4,27723.9,0,1222.0,3.2035500999188695,62424864811.831604
2023-09-16,26562.0,26599.9,26769.0,26463.5,18450.0,67527.9,0.1,26562.566666666662,51.33460034147679,182.4708218859829,27265.59435489235,25025.05564510765,26282.199986593874,85.61354019746116,639.425706751481,-2040650010.0,2.6761037043336384,-0.0014661102966053718,2.40729503332385,2.40729503332385,26182.4,27545.85,27069.083578310012,25166.4,27723.9,0,1223.0,3.203611924981921,62499219274.00072
2023-09-17,26529.1,26562.0,26614.4,26408.7,16570.0,67527.9,0.1,26564.03333333333,50.89271076001714,181.70623204930865,27298.370995503417,25033.29900449658,26305.714273584934,83.89489630674385,608.4452991263753,-2040666580.0,2.148935350968382,-0.0012386115503351114,2.2935014724448823,2.2935014724448823,26182.4,27545.85,26983.24423517761,25166.4,27723.9,0,1224.0,3.2036733120040704,62573422848.43847
2023-09-18,26763.5,26530.3,27413.3,26405.2,63350.0,67527.9,0.1,26618.199999999997,53.9351349993669,190.10191462280272,27044.82173196635,25190.808268033656,26349.312914195893,73.90571038470809,636.9920634744913,-2040603230.0,3.6408979487517117,0.008835580551168398,2.3800775813122024,2.3800775813122024,26326.375,27545.85,24923.1,25166.4,27723.9,0,1225.0,3.2037363641167693,62648591896.99796
2023-09-19,27209.2,26759.0,27480.7,26672.2,52170.0,67527.9,0.1,26833.93333333333,59.12123925111662,216.8503545728978,27018.067186401546,25208.602813598452,26431.20692236771,89.38457929308728,649.2426303691706,-2040551060.0,5.502089941140433,0.016653277785042997,2.3861143670860243,2.3861143670860243,26343.225,27545.85,24972.904,25166.4,27723.9,0,1226.0,3.203802696949431,62725589008.14589
2023-09-20,27125.0,27209.2,27378.6,26851.8,47230.0,67527.9,0.1,27032.566666666662,57.797404084038995,219.38852399339788,27174.183711979076,25171.25628802092,26497.282453570784,86.09243040350327,640.4967281999441,-2040598290.0,5.307089059709605,-0.0030945415521220765,2.3612782606449554,2.3612782606449554,26395.824999999997,27545.85,25073.215839999997,25166.4,27723.9,0,1227.0,3.203868199743238,62802231791.88474
2023-09-21,26570.0,27125.2,27155.6,26382.3,47810.0,67527.9,0.1,26968.066666666662,49.87056174950544,176.07372289241098,27211.713295408004,25210.40670459199,26504.20793418309,64.39239912417892,649.9826761856623,-2040646100.0,1.219818817667185,-0.020460829493087584,2.4463028836494627,2.4463028836494627,26554.175000000003,27545.85,25169.515206399996,25166.4,27723.9,0,1228.0,3.2039291935445218,62876557231.37186
2023-09-22,26581.9,26569.5,26736.4,26488.5,28790.0,67527.9,0.1,26758.966666666664,50.02881411296924,142.06672762395402,27246.886906681197,25246.453093318807,26511.607178546605,64.85767907413205,621.2624850295437,-2040617310.0,2.5951870935371253,0.00044787354158826176,2.3371635775830306,2.3371635775830306,26649.6,27545.85,25261.962598143997,25166.4,27723.9,0,1229.0,3.203990103604345,62950918825.41809
2023-09-23,26579.2,26581.7,26636.2,26517.5,12920.0,67527.9,0.1,26577.03333333333,49.990253476653834,114.42085091388968,27278.90395579807,25275.256044201928,26518.044590113594,64.75211135439478,585.3651646702905,-2040630230.0,2.61803552744865,-0.00010157287477574606,2.202343052726532,2.202343052726532,26670.725,27545.85,25350.712094218237,25166.4,27723.9,0,1230.0,3.2040508150409597,63025255097.26459
2023-09-24,26251.5,26579.0,26727.6,26162.2,22320.0,67527.9,0.1,26470.866666666665,45.414947333568676,71.20971361573456,27278.676357592718,25318.303642407278,26492.659391055153,51.93931811072882,583.9390814795553,-2040652550.0,1.5917059465483985,-0.012329189742354973,2.224402725480659,2.224402725480659,26580.824999999997,27545.85,25435.911610449508,25166.4,27723.9,0,1231.0,3.204108753335343,63098188190.43602
2023-09-25,26302.7,26251.6,26423.6,26013.6,38200.0,67527.9,0.1,26377.8,46.24279363792755,44.52598322929924,27276.20246085162,25372.027539148385,26474.568020478473,49.81254260395366,571.5148613738728,-2040614350.0,4.515147180367471,0.0019503647410623604,2.172837242465119,2.172837242465119,26474.525,27545.85,25517.703146031527,25166.4,27723.9,0,1232.0,3.204166923890374,63171322900.49209
2023-09-26,26218.9,26303.1,26396.2,26093.4,26410.0,67527.9,0.1,26257.699999999997,45.03880718107113,20.883248207835777,27265.01785697508,25429.30214302493,26450.21868519481,26.37413933947953,552.3209427043104,-2040640760.0,1.4879328030347072,-0.003185984708794165,2.1065755722181723,2.1065755722181723,26474.525,27545.85,25596.223020190264,25166.4,27723.9,0,1233.0,3.2042242515200674,63244083087.67464
2023-09-27,26366.1,26218.9,26836.9,26109.1,50800.0,67527.9,0.1,26295.899999999998,47.618703523761695,15.080224599828767,27269.764910236187,25436.18508976381,26442.207381842923,24.026992025083462,564.8551610825741,-2040589960.0,0.5457041528429186,0.005614270621574491,2.142353860004226,2.142353860004226,26474.525,27545.85,25671.602099382653,25166.4,27723.9,0,1234.0,3.204282575067868,63317454620.975426
2023-09-28,27022.6,26368.2,27283.6,26339.4,64560.0,67527.9,0.1,26535.866666666665,57.2555953410727,53.230955879760884,27345.89161577804,25471.368384221954,26497.482869286454,68.77513461931692,591.9512210052471,-2040525400.0,1.8771183085953764,0.024899397332180273,2.1905783344505974,2.1905783344505974,26449.0,27545.85,25743.966015407346,25166.4,27723.9,0,1235.0,3.204345865374539,63393574259.6035
2023-09-29,26909.8,27022.6,27229.5,26728.8,42240.0,67527.9,0.1,26766.16666666666,55.37064725717338,67.71487193203963,27390.194160273084,25527.93583972692,26536.75116744965,61.08649717129026,585.4332766477295,-2040567640.0,1.1608586143378041,-0.004174283747677809,2.1755393077902085,2.1755393077902085,26425.25,27513.55,25813.435374791054,25166.4,27723.9,0,1236.0,3.204408102810375,63469211583.90194
2023-09-30,26962.7,26908.1,27085.7,26887.5,17550.0,67527.9,0.1,26965.03333333333,56.10056123778783,77.02586689316978,27425.427505056152,25604.952494943853,26577.31772293064,64.69225001704048,557.7737568871775,-2040550090.0,1.5085460432196398,0.0019658265761917093,2.0686865814149824,2.0686865814149824,26425.25,27321.25,25880.12595979941,25166.4,27723.9,0,1237.0,3.2044705729349605,63545057441.02554
2023-10-01,27974.5,26962.5,28038.4,26955.7,35110.0,67527.9,0.1,27282.33333333333,67.1627594254571,143.62567769233036,27556.565755302756,25754.624244697246,26710.38270169915,96.84413275385216,595.2684885380934,-2040514980.0,5.44835671017864,0.03752591543131811,2.1278967936445454,2.1278967936445454,26753.375,27306.05,25944.148921407435,25166.4,27974.5,0,1238.0,3.2045405626654637,63625044469.52182
2023-10-02,27505.3,27974.6,28556.6,27325.2,84300.0,67527.9,0.1,27480.83333333333,59.655506987880024,147.80042417100142,27629.861048294762,25848.40895170524,26786.089111061134,58.65906409752263,640.706453642515,-2040599280.0,2.7716853176901353,-0.016772417737582423,2.329392712104631,2.329392712104631,27012.475,27306.05,26069.803986122988,25166.4,27974.5,1,1239.0,3.2046068363762084,63703117452.02739
2023-10-03,27428.4,27501.6,27670.8,27194.1,44060.0,67527.9,0.1,27636.066666666662,58.501333031287245,137.32830505123493,27705.275400173658,25893.53459982634,26847.26157667436,55.635076681085444,628.991706953764,-2040643340.0,0.8056098672507854,-0.0027958248046738854,2.2932132641851655,2.2932132641851655,27012.475,27306.05,26268.74766723315,25166.4,27974.5,0,1240.0,3.2046723452487105,63780865449.25693
2023-10-04,27790.9,27428.7,27832.7,27242.5,40930.0,67527.9,0.1,27574.866666666665,62.2126925868108,145.95326261553447,27855.73486743004,25869.695132569967,26937.131902705372,69.88989382618965,626.2208707427809,-2040602410.0,2.4549308755760424,0.013216228434761002,2.2533306612696276,2.2533306612696276,27032.425,27306.05,26451.7758538545,25166.4,27974.5,0,1241.0,3.2047404162854156,63860089089.63226
2023-10-05,27410.3,27783.5,28089.1,27371.7,46260.0,67527.9,0.1,27543.199999999997,56.4993795582737,118.3402003542435,27916.002645091805,25890.357354908196,26982.195531019148,54.92331891466774,632.733665689725,-2040648670.0,3.1625893865261547,-0.0136951304203895,2.3083792066840747,2.3083792066840747,27036.35,27197.55,26620.161785546137,25166.4,27974.5,0,1242.0,3.2048054272975066,63937744573.784
2023-10-06,27936.9,27410.3,28223.6,27195.7,52510.0,67527.9,0.1,27712.699999999997,61.735417178592584,127.08703502655572,28066.15571585052,25877.69428414948,27073.119766160184,75.63114431773508,660.9598324261731,-2040596160.0,5.0974535304097905,0.019211756164653426,2.365902560506617,2.365902560506617,27093.925,27087.1,26775.076842702445,25166.4,27974.5,0,1243.0,3.204874231255219,64017547031.7166
2023-10-07,27961.1,27935.5,28021.3,27859.0,17290.0,67527.9,0.1,27769.43333333333,61.96200891830742,125.81337379972524,28198.21511406123,25888.834885938773,27157.689312240167,76.58277624852536,625.3412729671606,-2040578870.0,5.199178304839867,0.000866237843139217,2.236468783299515,2.236468783299515,27243.875,26847.449999999997,26917.598695286248,25166.4,27974.5,0,1244.0,3.204943034501186,64097441723.62032
2023-10-08,27922.7,27961.1,28097.5,27714.4,24110.0,67527.9,0.1,27940.233333333326,61.341282139039045,114.04408741541135,28309.284134422072,25893.68586557792,27230.547472979197,75.07274872198201,608.0383248980777,-2040602980.0,6.366112412624044,-0.0013733365282481147,2.1775771143122893,2.1775771143122893,27441.9,26739.85,27048.718799663347,25166.4,27974.5,0,1245.0,3.205011369669795,64177174313.67194
2023-10-09,27581.4,27922.7,27986.4,27279.5,44810.0,67527.9,0.1,27821.733333333326,55.97403769242803,76.72301204218485,28345.303797679284,25894.88620232072,27263.96199936213,60.409223773952654,615.0998731196438,-2040647790.0,4.861478099206548,-0.012223030007843083,2.230125639451383,2.230125639451383,27520.625,26739.85,27169.34929569028,25166.4,27974.5,0,1246.0,3.2050769584129393,64255502038.71926
2023-10-10,27391.0,27581.5,27728.1,27300.1,34320.0,67527.9,0.1,27631.699999999997,53.17859420120654,34.79822099851174,28364.289849250217,25902.500150749784,27276.06085656574,52.375893769152256,601.7355964682407,-2040682110.0,4.470439263279537,-0.006903202883102422,2.1968369043417204,2.1968369043417204,27580.225,26739.85,27279.5,25166.4,27974.5,0,1247.0,3.2051409232420403,64333032017.81499
2023-10-11,26876.6,27391.9,27475.9,26558.4,55780.0,67527.9,0.1,27283.0,46.4317886329795,-28.57055827619729,28358.62914641438,25938.820853585617,27238.01696546424,24.228756990799106,624.2901967205091,-2040737890.0,1.9361983759448687,-0.018779891205140453,2.322801979121277,2.322801979121277,27338.05,26739.85,28556.6,25166.4,27974.5,0,1248.0,3.2052007568384075,64408391048.479935
2023-10-12,26761.1,26878.2,26942.8,26565.3,32750.0,67527.9,0.1,27009.566666666662,45.04975230974986,-76.53613363509848,28353.23484384203,25962.135156157965,27192.596302086695,10.14412971674494,606.6623255261869,-2040770640.0,-0.9677085106540452,-0.004297418572289602,2.2669558632723876,2.2669558632723876,27338.05,26739.85,28516.636,26761.1,27974.5,0,1249.0,3.2052595171225082,64483243944.61297
2023-10-13,26863.5,26761.1,27114.8,26682.9,33660.0,67527.9,0.1,26833.733333333326,46.568222673286705,-98.25253419346453,28346.170474810086,25997.629525189917,27161.253797126057,15.268741867680863,594.1793022743162,-2040736980.0,-0.17205627689540343,0.003826449585405678,2.2118461938106213,2.2118461938106213,27338.05,26739.85,28477.471279999998,26761.1,27974.5,0,1250.0,3.2053188986514636,64558516807.00848
2023-10-14,26852.8,26863.5,26975.7,26805.1,13560.0,67527.9,0.1,26825.8,46.42386281590478,-109.3718912938561,28309.319171487474,26094.610828512534,27131.877245018815,14.73325993394046,563.923637826151,-2040750540.0,-0.4076001290671982,-0.00039830997450074346,2.100055256160069,2.100055256160069,27338.05,26739.85,28439.089854399997,26761.1,27974.5,0,1251.0,3.2053780220706933,64633728729.948395
2023-10-15,27161.2,26852.8,27286.9,26812.6,21950.0,67527.9,0.1,26959.16666666666,51.126539752335,-92.65283459243906,28273.218686564116,26216.561313435875,27134.669888350356,30.16715043539186,557.5219494099975,-2040728590.0,-2.907290568196033,0.011484835845796404,2.052641081432328,2.052641081432328,27306.525,26739.85,28401.476057311997,26761.1,27974.5,0,1252.0,3.2054393497358764,64710231152.71885
2023-10-16,28509.7,27161.2,29969.5,27119.7,119180.0,67527.9,0.1,27507.899999999994,65.41959533659255,7.226286669563592,28415.081463509934,26303.778536490066,27265.625137078896,57.20442086130574,721.2560958807119,-2040609410.0,3.6516598619175262,0.04964802733310747,2.529862102655278,2.529862102655278,28127.75,27446.3,26558.4,26761.1,27974.5,1,1253.0,3.2055105942160633,64792268213.96715
2023-10-17,28403.6,28508.3,28608.5,28096.9,53420.0,67527.9,0.1,28024.83333333333,63.8376978793606,61.14705278277097,28507.05987085198,26415.55012914802,27374.003695452335,54.093987276831456,706.280660460661,-2040662830.0,3.5554388881597063,-0.0037215403880083153,2.4865885326531183,2.4865885326531183,28127.75,27446.3,26626.622000000003,26761.1,27974.5,0,1254.0,3.2055808799366474,64873874572.41207
2023-10-18,28321.7,28405.2,28876.0,28169.0,45010.0,67527.9,0.1,28411.666666666668,62.579764616546214,84.8404175528307,28615.42947148303,26437.09052851697,27464.260486361636,51.693002257336346,706.332041856328,-2040707840.0,1.9099777265219882,-0.002883437310763348,2.493960609201877,2.493960609201877,28127.75,27446.3,26693.479560000003,26761.1,27974.5,0,1255.0,3.205650382798784,64955145249.446144
2023-10-19,28723.0,28321.8,28883.8,28170.2,50100.0,67527.9,0.1,28482.766666666663,66.10424896627843,118.98911411405163,28784.75814563946,26449.081854360546,27584.14044004148,63.457535692298656,706.851181723733,-2040657740.0,4.789075639449407,0.014169347179018077,2.4609239345602236,2.4609239345602236,28127.75,27446.3,26758.999968800003,26761.1,27974.5,0,1256.0,3.205722633467485,65038027077.33725
2023-10-20,29674.5,28724.0,30165.9,28586.1,82680.0,67527.9,0.1,28906.399999999994,72.67571410623816,192.74215735913685,29184.792678667367,26320.22732133263,27783.22230289467,86.37837837837834,769.2046687434666,-2040575060.0,6.219730893549387,0.03312676252480595,2.5921402845657604,2.5921402845657604,28227.675,27544.5,26823.209969424002,26761.1,27974.5,0,1257.0,3.205801484135712,65124654768.31895
2023-10-21,29912.9,29674.7,30264.8,29469.1,34680.0,67527.9,0.1,29436.8,74.03403849356698,241.5045070112148,29563.332215533475,26135.527784466525,27986.04875023803,90.50561191452628,771.0971924046477,-2040540380.0,6.980412072486429,0.008033833762995268,2.577808211188643,2.577808211188643,28326.475,27593.949999999997,26956.91757064704,26761.1,27974.5,0,1258.0,3.2058818130388462,65212209041.65427
2023-10-22,29984.2,29912.7,30193.4,29713.6,29070.0,67527.9,0.1,29857.199999999997,74.4432318487117,260.83260187790813,29913.4200642989,26033.3299357011,28176.348869262983,92.42931146125625,750.2902500900302,-2040511310.0,7.382882027884123,0.002383587014298083,2.5022853705952808,2.5022853705952808,28360.949999999997,27593.949999999997,27155.390516408217,26761.1,27974.5,0,1259.0,3.205962449602167,65300044747.29729
2023-10-23,33041.8,29984.2,34375.6,29891.4,133460.0,67527.9,0.1,30979.63333333333,85.2083185552267,450.6828646083276,31174.15785773521,25333.932142264795,28639.725167428413,82.9376247249655,1016.9980893693136,-2040377850.0,19.797399696897187,0.10197370615190682,3.0779137013398588,3.0779137013398588,30475.8,29649.35,27341.955085423724,26761.1,27974.5,1,1260.0,3.206063095220345,65399095504.72051
2023-10-24,33917.0,33037.3,35191.4,32866.5,159080.0,67527.9,0.1,32314.33333333333,86.90821264635483,597.1579871794652,32371.213327122925,24749.486672877072,29142.32277053047,85.23804007876751,1110.4196544143626,-2040218770.0,23.825344091124823,0.026487661083839154,3.2739324068000197,3.2739324068000197,31015.225000000002,30057.25,27904.646678589826,26761.1,27974.5,1,1261.0,3.20616897715614,65501200832.84616
2023-10-25,34496.8,33917.0,35123.9,33713.4,75810.0,67527.9,0.1,33818.53333333333,87.90026747311843,688.5551625138655,33475.843621692286,24353.50637830771,29652.272982860904,91.94769362747941,1131.8539648133367,-2040142960.0,28.352544592694034,0.017094672288233026,3.281040458284063,3.281040458284063,31259.525,30057.25,28633.322010730844,26761.1,34496.8,0,1262.0,3.2062781798526645,65605308287.665504
2023-10-26,34153.7,34497.6,34826.0,33749.9,56620.0,67527.9,0.1,34189.166666666664,83.85103821185541,680.1726781666515,34296.61359627185,24154.41640372816,30080.980317826532,87.80396074513716,1127.871538755241,-2040199580.0,27.624425004951213,-0.009945850049859817,3.3023407090746866,3.3023407090746866,31277.550000000003,30057.25,29289.12980965776,26761.1,34496.8,0,1263.0,3.206385099497109,65708302083.993454
2023-10-27,33901.8,34153.7,34245.8,33423.6,47330.0,67527.9,0.1,34184.1,80.90427150507689,613.9595796869603,34946.28497048023,24098.81502951977,30444.86790660496,84.62253914121844,1106.0378574155814,-2040246910.0,26.20023451895696,-0.0073754820121976206,3.2624753181706616,3.2624753181706616,31277.850000000002,30057.25,29879.356828691984,26761.1,34496.8,0,1264.0,3.2064902768495758,65810478392.84673
2023-10-28,34082.6,33901.6,34387.8,33867.3,22000.0,67527.9,0.1,34046.033333333326,81.40926842866185,541.184937729013,35547.5690987694,24113.5209012306,30791.318582166394,86.76660142263806,1064.2137247430398,-2040224910.0,26.92382172436394,0.0053330501625281634,3.1224546388568943,3.1224546388568943,31381.825,30057.25,30410.561145822787,26761.1,34496.8,0,1265.0,3.2065963566691744,65913312299.80646
2023-10-29,34526.7,34082.6,34737.9,33937.6,27720.0,67527.9,0.1,34170.36666666666,82.62475579411324,483.6823353625923,36144.470400559934,24211.149599440065,31147.06919338864,91.76505568839274,1045.3627444042515,-2040197190.0,27.117726757286114,0.01303010920528358,3.027693768602999,3.027693768602999,31602.575,30057.25,30888.645031240507,26761.1,34496.8,0,1266.0,3.2067049226424587,66017693765.94032
2023-10-30,34477.9,34526.7,34853.3,34089.5,45200.0,67527.9,0.1,34362.399999999994,81.99038870143018,406.20819660126926,36634.91565612194,24429.394343878055,31464.291174970673,89.94291352456128,1025.251119803948,-2040242390.0,20.933927750905834,-0.001413398905774299,2.973647234326766,2.973647234326766,31663.7,30057.25,31318.920528116458,26761.1,34496.8,0,1267.0,3.2068129902033085,66121954774.91593
2023-10-31,34650.6,34478.9,34704.6,34053.9,43400.0,67527.9,0.1,34551.73333333333,82.50238464659799,333.4873900024736,37033.059040925815,24808.650959074188,31767.749158306797,92.29892914103436,998.4974683893801,-2040198990.0,21.993690940584997,0.005009005768912722,2.8816166773140437,2.8816166773140437,31708.15,30057.25,31706.16847530481,26761.1,34496.8,0,1268.0,3.206921891005684,66226842741.07099
2023-11-01,35423.8,34648.3,35557.5,34138.7,71660.0,67527.9,0.1,34850.76666666666,84.61168079481513,305.1204466662816,37453.433001423145,25254.54699857686,32115.944476563294,98.1901371272319,1028.5190777901387,-2040127330.0,25.076531422901883,0.022314187921709916,2.9034690738716304,2.9034690738716304,32634.975,30240.3,32054.69162777433,26761.1,34496.8,0,1269.0,3.207035168709828,66334355319.781555
2023-11-02,34931.4,35423.8,35907.6,34357.4,63660.0,67527.9,0.1,35001.93333333333,78.1506450519451,224.57762104469248,37680.13496915366,25834.63503084634,32384.08309784298,86.6666666666667,1065.7820008051285,-2040190990.0,21.61473383699475,-0.013900259147804572,3.051071531072698,3.051071531072698,32949.3,30520.55,32475.02863244141,26761.1,34496.8,0,1270.0,3.207145333615248,66440281030.10519
2023-11-03,34718.7,34931.4,34940.6,34124.2,54540.0,67527.9,0.1,35024.633333333324,75.46975567205632,132.89209397527702,37754.52955815282,26546.83044184718,32606.427564715075,81.53451890968391,1047.9690007476195,-2040245530.0,16.9984329980286,-0.006089077448942937,3.0184569144225435,3.0184569144225435,32949.3,30837.25,32955.58862389961,34718.7,34496.8,0,1271.0,3.2072540256710447,66545537911.34375
2023-11-04,35065.8,34718.6,35242.2,34601.1,23800.0,67527.9,0.1,34905.299999999996,76.86450733094952,74.45108458214509,37789.84989740628,27301.970102593707,32840.65351093269,86.40942847917347,1018.9069292656466,-2040221730.0,17.22634716125819,0.009997494145806307,2.905699939159085,2.905699939159085,32949.3,30960.6,33368.87021655367,34718.7,34496.8,0,1272.0,3.2073645772756465,66652007529.878494
2023-11-05,35019.4,35065.8,35360.2,34550.0,31020.0,67527.9,0.1,34934.63333333333,76.24044426372262,14.628729302834017,37875.45095791149,27867.339042088523,33048.153176558146,85.23652804095613,1003.9992914609574,-2040252750.0,16.792844231295152,-0.0013232266196693265,2.8669802779629503,2.8669802779629503,33060.225,30960.6,33724.29238623616,34718.7,34496.8,0,1273.0,3.207474648727095,66758369364.42463
2023-11-06,35042.0,35020.3,35275.6,34742.9,29810.0,67527.9,0.1,35042.399999999994,76.34120016340698,-38.553363131072956,37845.508367914495,28561.12163208551,33238.043350219275,71.53661504061034,970.335056356603,-2040222940.0,6.053544298434095,0.0006453565737847278,2.769062999704934,2.769062999704934,33079.524999999994,30960.6,34029.95545216309,34718.7,34496.8,0,1274.0,3.207584648851187,66864854388.92459
2023-11-07,35426.1,35042.1,35877.9,34536.9,53490.0,67527.9,0.1,35162.49999999999,78.04524608606583,-61.62761790891909,37713.935811126306,29403.134188873682,33446.42969781744,80.6159420289855,996.8111237597028,-2040169450.0,4.449391160774828,0.010961132355459036,2.8137760683781248,2.8137760683781248,33138.0,30960.6,34292.82568886026,34718.7,34496.8,0,1275.0,3.207696704365512,66972671745.29194
2023-11-08,35636.9,35426.2,36050.2,35148.8,46330.0,67527.9,0.1,35368.33333333332,78.94168991848352,-75.54041209824004,37506.559279287096,30301.900720712896,33655.04591707292,84.2648290565752,989.9960434911521,-2040123120.0,3.3049442267108793,0.005950415089439831,2.7780083101817277,2.7780083101817277,33239.85,31031.899999999998,34518.894092419825,34718.7,34496.8,0,1276.0,3.207809783553663,67081239885.32152
2023-11-09,36700.5,35636.9,37942.0,35578.1,115560.0,67527.9,0.1,35921.16666666666,82.76542282563634,-28.385773033321357,37491.08736843114,31019.97263156886,33945.08916306598,72.52345963172804,1088.1320403846414,-2040007560.0,7.456878756913608,0.02984546916258135,2.964897046047442,2.964897046047442,34205.2,31977.8,34536.9,34718.7,34496.8,0,1277.0,3.2079287512815586,67193336957.45299
2023-11-10,37303.0,36700.5,37496.1,36347.2,59560.0,67527.9,0.1,36546.799999999996,84.48413598764552,25.211198155719103,37454.95077986147,31795.119220138524,34264.890195154934,84.31786389182025,1092.4726089285957,-2039948000.0,10.032505648667613,0.016416670072614714,2.9286454411939946,2.9286454411939946,34281.975,31977.8,35148.8,34718.7,34496.8,0,1278.0,3.208050882869539,67307423364.51165
2023-11-11,37150.5,37306.3,37401.3,36767.6,29530.0,67527.9,0.1,37051.333333333336,82.2483639838395,31.796658914287264,37095.92888799659,32870.77111200341,34539.71017656875,80.23424233343323,1059.7031368622677,-2039977530.0,9.001367266581779,-0.004088143044795323,2.8524599584454253,2.8524599584454253,34526.274999999994,31977.8,35578.1,34718.7,34496.8,0,1279.0,3.2081719534870428,67421090425.5995
2023-11-12,37064.4,37149.0,37215.3,36761.9,21450.0,67527.9,0.1,37172.63333333333,80.94590156104516,12.736016824432681,37285.29103158015,33083.66896841984,34780.15682641934,77.428564080142,1016.3957699435343,-2039998980.0,7.349963940950061,-0.0023176000323009704,2.742242610007269,2.742242610007269,34647.475,31977.8,36003.602,34718.7,34496.8,0,1280.0,3.2082923319511627,67534546790.61317
2023-11-13,36478.3,37067.8,37404.6,36358.4,44550.0,67527.9,0.1,36897.73333333333,72.52638390365465,-53.33777519606656,37400.91693572143,33224.17306427857,34941.884747712735,62.35436331370084,1018.524643518996,-2040043530.0,5.801977498629561,-0.01581301734278706,2.792138459081141,2.792138459081141,34647.774999999994,31977.8,36352.51364,34718.7,34496.8,0,1281.0,3.208409198465247,67646171206.68279
2023-11-14,35549.3,36478.3,36744.5,34984.3,63560.0,67527.9,0.1,36363.99999999999,61.59090923421101,-167.17631078183877,37421.463360493304,33308.87663950669,34999.73381935914,37.32778039708745,1071.5014546962104,-2040107090.0,2.59360588272643,-0.025467195565582856,3.0141281395026356,3.0141281395026356,34751.75,31977.8,37942.0,34718.7,34496.8,0,1282.0,3.208520514927902,67754781356.40801
2023-11-15,37874.9,35549.3,37954.1,35379.6,75510.0,67527.9,0.1,36634.166666666664,72.6914519547211,-96.90326084326239,37799.80423991488,33302.65576008511,35273.55916989637,97.93206088931835,1178.858493646481,-2040031580.0,6.919359300809055,0.06541900965701153,3.1125058908313448,3.1125058908313448,34978.55,31983.85,34984.3,34718.7,37874.9,0,1283.0,3.2086447436393457,67871000316.03155
2023-11-16,36161.2,37873.9,37907.6,35561.6,66920.0,67527.9,0.1,36528.46666666667,59.13009305055395,-172.47429265636742,37793.830494712354,33534.56950528764,35358.096391811,53.186767278519,1262.2257441003037,-2040098500.0,3.520614690507668,-0.045246324082704015,3.4905527031744072,3.4905527031744072,35151.524999999994,32023.75,34984.3,34718.7,37874.9,0,1284.0,3.208759176353753,67981758183.59853
2023-11-17,36595.4,36161.8,36690.6,35875.2,51370.0,67527.9,0.1,36877.166666666664,61.109794972348304,-198.0289471642966,37825.84574203727,33753.83425796272,35475.93483068614,60.239377267938714,1230.3096195217108,-2040047130.0,5.405444328272673,0.01200734488899724,3.3619242296073026,3.3619242296073026,35195.975,32031.6,35043.696,34718.7,37874.9,0,1285.0,3.2088758717257506,68093999016.16695
2023-11-18,36568.6,36617.5,36845.2,36220.6,20880.0,67527.9,0.1,36441.73333333333,60.91366654067478,-219.86328313143986,37868.248416720315,33915.62158327968,35579.998180144605,59.4551094463303,1187.0446466987316,-2040068010.0,4.285657250084115,-0.0007323324789455521,3.2460762695283156,3.2460762695283156,35939.75,32146.75,35101.90408,34718.7,37874.9,0,1286.0,3.208992207102243,68206210712.69373
2023-11-19,37354.2,36568.6,37504.6,36393.3,26140.0,67527.9,0.1,36839.399999999994,64.50945219829197,-185.87462055934088,37998.10279550052,34073.39720449948,35748.969782035594,82.44469156034174,1181.6343147916791,-2040041870.0,6.667161630410559,0.021482911568941665,3.1633238425442904,3.1633238425442904,36079.024999999994,32256.25,35158.9479984,34718.7,37874.9,0,1287.0,3.209112730681953,68321031073.34582
2023-11-20,37454.1,37356.6,37735.6,36857.6,51800.0,67527.9,0.1,37125.633333333324,64.95101552724454,-162.01505205061926,38122.934915616424,34228.91508438358,35911.363136127446,85.36813765656092,1159.9461494494165,-2039990070.0,6.883454140745387,0.002674398059655969,3.096980435918675,3.096980435918675,36079.024999999994,32256.25,35214.851038431996,34718.7,37874.9,0,1288.0,3.209233595895369,68436237398.65598
2023-11-21,35813.6,37452.7,37631.2,35799.2,71070.0,67527.9,0.1,36873.96666666667,53.23736467187848,-256.453958507323,38119.58901736658,34271.240982633404,35902.05236125817,27.924439356185495,1207.9499959173154,-2040061140.0,1.0938263032058284,-0.043800278207192234,3.3728806819680663,3.3728806819680663,36079.024999999994,32256.25,35269.63601766335,34718.7,37874.9,0,1289.0,3.209344990313486,68546119099.16727
2023-11-22,37410.8,35797.5,37862.5,35695.6,64810.0,67527.9,0.1,36892.83333333332,60.67367410978723,-212.88245313149628,38221.18855481544,34417.581445184565,36045.742612566915,81.70583877702214,1276.4464247803644,-2039996330.0,4.9777056926949355,0.044597583041079414,3.4119730793791216,3.4119730793791216,36189.95,32256.25,35323.32529731009,34718.7,37874.9,0,1290.0,3.2094651987938834,68661310180.62354
2023-11-23,37293.1,37410.8,37642.5,36915.3,32350.0,67527.9,0.1,36839.166666666664,59.917513410385524,-194.04849514386115,38244.70375707086,34651.50624292913,36164.538554227205,77.74260892989423,1237.2145372960524,-2040028680.0,1.6146918979305418,-0.003146150309536355,3.317542755351667,3.317542755351667,36306.35,32256.25,35375.940791363886,34718.7,37874.9,0,1291.0,3.2095845457757783,68776185771.74094
2023-11-24,37717.3,37295.0,38400.8,37257.4,65830.0,67527.9,0.1,37473.73333333333,61.766918280257734,-156.6817920173737,38340.6460049014,34820.71399509862,36312.42059668176,79.99414605590516,1230.513498917763,-2039962850.0,1.1106345334155507,0.01137475833331103,3.2624644365258457,3.2624644365258457,36604.275,32479.600000000002,35427.50397553661,34718.7,37874.9,0,1292.0,3.209706020077991,68892492251.53377
2023-11-25,37787.0,37718.6,37887.4,37599.9,16090.0,67527.9,0.1,37599.13333333333,62.076540476372955,-131.92419992609894,38399.65715030359,35038.46284969642,36452.856730331114,82.03424557295469,1163.1553918522084,-2039946760.0,1.713301301462968,0.0018479583639336994,3.0781893028083953,3.0781893028083953,36637.775,32479.600000000002,35546.43581651514,34718.7,37874.9,0,1293.0,3.2098276648490556,69009089451.12221
2023-11-26,37451.8,37786.4,37819.1,37166.3,29200.0,67527.9,0.1,37652.03333333333,59.577733695833004,-141.90667838265608,38359.81673778271,35319.283262217294,36547.994184585295,72.22303527001317,1126.701435291336,-2039975960.0,1.0452078004770116,-0.00887077566358796,3.0084039626702483,3.0084039626702483,36655.35,32479.600000000002,35660.61038385454,34718.7,37874.9,0,1294.0,3.2099472583441213,69124673860.7944
2023-11-27,37248.6,37451.8,37563.3,36751.5,45240.0,67527.9,0.1,37495.799999999996,58.0521780083732,-164.39289636688727,38313.38686134656,35547.963138653446,36614.718547958124,66.27542806966181,1104.2084756276695,-2040021200.0,2.1116663879621465,-0.005425640423157296,2.964429470175173,2.964429470175173,36655.35,32479.600000000002,35770.21796850036,37248.6,37874.9,0,1295.0,3.2100655187953566,69239662011.55693
2023-11-28,37823.3,37244.3,38379.4,36881.1,57500.0,67527.9,0.1,37507.899999999994,61.08705027078907,-143.51900599808982,38339.48481139077,35740.50518860923,36729.82154339068,80.88507877664507,1132.3578702256932,-2039963700.0,6.396750428278475,0.015428767792615039,2.99381035030178,2.99381035030178,36655.35,32479.600000000002,35875.44124976034,37248.6,37874.9,0,1296.0,3.2101867314613615,69356574489.98029
2023-11-29,37855.5,37823.3,38362.9,37607.6,49340.0,67527.9,0.1,37642.46666666667,61.25618497975696,-130.85605733961074,38433.89313172358,35761.59686827643,36837.029015448716,80.79388560157784,1105.4251652095725,-2039914360.0,-0.05122125734985823,0.0008513270920305072,2.9201177245303125,2.9201177245303125,36758.525,32479.600000000002,35976.45559976993,37248.6,37874.9,0,1297.0,3.210307909272137,69473657902.56674
2023-11-30,37712.9,37857.6,38144.4,37509.2,33530.0,67527.9,0.1,37797.23333333333,60.0121681883418,-134.86046077718584,38478.706413259955,35757.773586740055,36920.445299691695,74.57119621469761,1071.837653408889,-2039947890.0,4.291063349667612,-0.00376695592450238,2.8420982035560485,2.8420982035560485,36758.525,32479.600000000002,36073.42937577913,37248.6,37874.9,0,1298.0,3.210428097829992,69590348321.30026
2023-12-01,38688.2,37712.9,38950.8,37618.3,62500.0,67527.9,0.1,38085.53333333333,65.2153324426879,-77.45257951178428,38718.26990036515,35671.98009963485,37088.80289019725,91.93290734824265,1090.4563924511112,-2039885390.0,5.718751537078418,0.02586117747508143,2.8185761871865616,2.8185761871865616,37297.5,32754.600000000002,36166.52420074797,37248.6,37874.9,0,1299.0,3.210553344586872,69710223749.31837
2023-12-02,39458.4,38688.2,39673.4,38646.5,37090.0,67527.9,0.1,38619.83333333332,68.68107643815401,2.5254433005611645,39126.92956859098,35502.72043140901,37314.47880541656,94.5950022625572,1085.916650133175,-2039848300.0,7.902408076874703,0.01990787888813661,2.752054442484173,2.752054442484173,37658.8,33119.35,36333.58074870309,37248.6,37874.9,0,1300.0,3.2106824448242777,69832585579.1042
2023-12-03,39970.2,39456.8,40178.9,39280.3,35270.0,67527.9,0.1,39372.26666666666,70.76549896867404,75.96117313838317,39594.66055024794,35384.17944975205,37567.40463347213,95.34494680257836,1072.5368894093767,-2039813030.0,7.003228552612558,0.012970622224925288,2.683341312801479,2.683341312801479,38023.4,33430.9,36600.766288806844,37248.6,37874.9,0,1301.0,3.210813987801018,69956608023.81308
2023-12-04,41987.8,39968.6,42394.4,39968.6,104210.0,67527.9,0.1,40472.13333333333,77.20599182328264,237.37020547785096,40515.37280198506,35107.31719801494,37988.394668379544,93.93025616528337,1169.19854016585,-2039708820.0,12.104682798411934,0.050477605816333426,2.78461491234561,2.78461491234561,39131.15,34599.75,36958.57965992616,37248.6,37874.9,1,1302.0,3.210955468340904,70086761208.12213
2023-12-05,44076.2,41989.6,44424.1,41424.9,96840.0,67527.9,0.1,42011.399999999994,81.70003279132152,449.4351471931991,41965.376561197954,34277.44343880204,38568.185652343396,96.01420633556738,1299.9129301540036,-2039611980.0,23.07112381888444,0.04973825730331183,2.949240021040842,2.949240021040842,40146.0,35618.35,37610.87810073502,37248.6,37874.9,0,1303.0,3.2111067331502183,70222987499.4835
2023-12-06,43776.3,44076.2,44283.7,43466.7,72520.0,67527.9,0.1,43280.1,79.28266877697821,528.6933567643198,42954.49618457151,34049.833815428494,39064.1965425964,91.55696895446138,1265.4191494287174,-2039684500.0,17.01514001304436,-0.006804125582513754,2.890648934306274,2.890648934306274,40178.399999999994,35771.9,38564.72916663212,37248.6,37874.9,0,1304.0,3.2112563622013948,70358495786.8851
2023-12-07,43289.7,43774.4,44046.4,42860.5,63090.0,67527.9,0.1,43714.06666666666,75.38516935918173,507.4362762692024,43656.84516319442,34016.914836805576,39466.625443301506,85.21492062664545,1259.739210183809,-2039747590.0,16.07965012294499,-0.011115603648549688,2.9100206519883693,2.9100206519883693,40335.424999999996,36260.5,39385.04108330362,37248.6,37874.9,0,1305.0,3.2114034603652897,70492744780.31102
2023-12-08,44175.5,43288.3,44697.6,43108.4,58440.0,67527.9,0.1,43747.16666666666,77.54885674863479,510.7193024564874,44444.5157674538,33989.9342325462,39915.0896867966,93.42948112910737,1283.272123742108,-2039689150.0,17.122646636954386,0.020462142264788152,2.904940801444484,2.904940801444484,40472.174999999996,36433.3,40090.509331641115,37248.6,44175.5,0,1306.0,3.211554505860421,70629613149.95738
2023-12-09,43718.4,44175.5,44361.2,43617.4,31670.0,67527.9,0.1,43727.86666666666,73.93708564761874,442.3467170948013,45037.932723498634,34032.93727650136,40277.309716625496,87.67697360969535,1244.7384006176715,-2039720820.0,15.69693280757933,-0.01034736448936624,2.847172816520439,2.847172816520439,40499.45,36433.9,40827.64383857854,37248.6,44175.5,0,1307.0,3.211703180641068,70765316869.17537
2023-12-10,43791.0,43716.6,44045.4,43576.8,23810.0,67527.9,0.1,43894.96666666665,74.14306888534345,365.4420053975384,45564.678252783815,34139.88174721618,40611.94688647069,88.59062936534906,1189.2999434306948,-2039697010.0,16.92628925712515,0.0016606280193236511,2.7158547268404347,2.7158547268404347,40855.325,36641.85,41446.83682440597,37248.6,44175.5,0,1308.0,3.211851970438632,70901345400.90671
2023-12-11,41256.1,43791.0,43806.3,40277.1,105190.0,67527.9,0.1,42921.83333333332,57.157170584097386,119.98351961788512,45552.778663069585,34696.03133693041,40673.294802044904,55.97134267255166,1356.435661757074,-2039802200.0,10.75879361908904,-0.0578863236738143,3.287842674797361,3.287842674797361,41059.274999999994,37083.35,44697.6,37248.6,44175.5,0,1309.0,3.2119882559035045,71030083823.25368
2023-12-12,41487.0,41256.1,42070.9,40691.5,57040.0,67527.9,0.1,42178.033333333326,58.09882584954663,-42.02043902636342,45638.552952438375,35017.87704756162,40750.790535183485,55.33637527127041,1358.075971631569,-2039745160.0,9.686357351156554,0.005596748117248085,3.2734976537989464,3.2734976537989464,41264.85,37205.6,44609.189999999995,37248.6,44175.5,0,1310.0,3.2121254713544136,71159612677.47214
2023-12-13,42884.5,41487.0,43417.5,40649.3,63110.0,67527.9,0.1,41875.86666666666,63.34940691803273,-68.67874194393744,45837.659340470076,35377.910659529916,40954.000960404104,74.77741917533807,1458.7991165150283,-2039682050.0,13.28472745043653,0.03368525080145579,3.4016931910481136,3.4016931910481136,41341.975,37294.5,44522.5482,37248.6,44175.5,0,1311.0,3.212269286076917,71293369481.09486
2023-12-14,43025.9,42886.3,43392.7,41591.2,59150.0,67527.9,0.1,42465.799999999996,63.843097306542454,-89.1123724196068,46027.65469807653,35718.775301923466,41151.32467846086,76.38608336982473,1483.2777510496692,-2039622900.0,14.088017627920419,0.003297228602408886,3.44740668074269,3.44740668074269,41341.975,38782.05,44437.639235999995,37248.6,44175.5,0,1312.0,3.2124135547322403,71427647818.38322
2023-12-15,41929.0,43025.2,43080.7,41697.9,45280.0,67527.9,0.1,42613.13333333333,57.3854039481201,-183.3956421092205,46051.70099880427,36108.92900119572,41225.38899479791,54.246335377038896,1476.1007688318352,-2039668180.0,8.376714347010207,-0.025493946669331802,3.520476922492392,3.520476922492392,41341.975,39060.6,44354.42845127999,37248.6,44175.5,0,1313.0,3.212552286857626,71558807297.43378
2023-12-16,42271.7,41929.0,42690.3,41698.2,30110.0,67527.9,0.1,42408.86666666666,58.78795721408435,-226.73404556261812,46025.884349673644,36616.735650326365,41325.037661960014,55.21938973289271,1441.5292853438475,-2039638070.0,7.1297873203170825,0.008173340647284588,3.4101521475215035,3.4101521475215035,41341.975,39060.6,44272.88188225439,37248.6,44175.5,0,1314.0,3.2126924731374857,71691087888.20055
2023-12-17,41368.7,42271.7,42413.2,41276.9,35460.0,67527.9,0.1,41856.46666666666,53.766486074759996,-314.85021416713744,45845.45387978457,37209.17612021544,41329.195979868586,29.606682173821074,1419.7271935335723,-2039673530.0,3.4988566482029118,-0.02136180943751964,3.4318873774945122,3.4318873774945122,41257.875,39060.6,44192.966244609306,41368.7,44175.5,0,1315.0,3.2128279978563796,71820762616.06436
2023-12-18,42659.7,41369.1,42728.0,40554.0,61580.0,67527.9,0.1,42100.033333333326,59.14006299062884,-285.6794615738995,45759.74015073929,37778.529849260696,41455.91064845253,53.89888021716997,1473.6038225668885,-2039611950.0,1.6002267325270534,0.03120716870484208,3.4543229853160913,3.4543229853160913,41442.9,39282.45,44114.64891971712,41368.7,44175.5,0,1316.0,3.212969622731262,71954395946.97218
2023-12-19,42259.3,42659.7,43473.3,41842.7,55290.0,67527.9,0.1,42095.899999999994,56.930021512015934,-291.81479335374434,45555.23855580964,38423.41144419035,41532.42392002848,44.841081325641994,1484.8178352406826,-2039667240.0,-4.122179316728744,-0.009385907542715843,3.5135883349716694,3.5135883349716694,41383.125,39317.6,44037.89794132278,41368.7,44175.5,0,1317.0,3.213109087368256,72086949148.44171
2023-12-20,43662.8,42259.5,44278.7,42217.2,70190.0,67527.9,0.1,42860.6,62.25460507521582,-203.97188189326312,45330.545997261725,39243.094002738275,41735.31688002577,76.59088338423265,1526.0094184377765,-2039597050.0,-0.25927271149000714,0.033211624423499675,3.4949875373035546,3.4949875373035546,41570.45,39375.75,40277.1,41368.7,44175.5,0,1318.0,3.213255046380211,72223726761.71413
2023-12-21,43865.9,43660.3,44241.8,43310.2,48960.0,67527.9,0.1,43262.666666666664,62.968065006299334,-137.9719292717723,45173.41649898668,39917.99350101333,41938.22955811855,81.18538626852173,1483.5516028350787,-2039548090.0,1.331032555088172,0.004651556931758893,3.382015649593599,3.382015649593599,41570.45,39375.75,40357.132,41368.7,44175.5,0,1319.0,3.2134017346885377,72361206997.78351
2023-12-22,43968.9,43865.9,44394.6,43419.3,44500.0,67527.9,0.1,43832.533333333326,63.3464497738182,-95.1962288707798,45051.630839415455,40490.82916058454,42131.62674305964,89.66120218579242,1447.2479169182873,-2039503590.0,-0.4676800488958779,0.002348065353725781,3.291526321828127,3.291526321828127,41599.425,39410.899999999994,40435.56336,41368.7,44175.5,0,1320.0,3.213548680149818,72499102020.16989
2023-12-23,43710.4,43968.9,43994.6,43325.7,21290.0,67527.9,0.1,43848.399999999994,61.644069619506446,-92.07252673985772,44873.33563040771,41043.1443695923,42281.98610086349,83.38312082574384,1391.6516371384098,-2039524880.0,-0.0182989313424096,-0.005879155493996868,3.1837998214118604,3.1837998214118604,41631.825,39410.899999999994,40593.9248256,41368.7,44175.5,0,1321.0,3.213694189765112,72636368130.28796
2023-12-24,42981.5,43710.4,43935.7,42748.5,30860.0,67527.9,0.1,43553.6,56.993049193843895,-143.775655712157,44870.57749671179,41145.272503288215,42348.60647220982,65.68063145112328,1377.0479487713803,-2039555740.0,-1.848553355712361,-0.01667566528789488,3.2038154758940016,3.2038154758940016,41788.85,39410.899999999994,40745.951832576,41368.7,44175.5,0,1322.0,3.2138360223512046,72771614610.9483
2023-12-25,43578.5,42982.0,43792.7,42745.3,32670.0,67527.9,0.1,43423.46666666667,59.67657294891395,-142.1892825335931,44800.694021426156,41165.385978573846,42465.73918914222,78.75071603395305,1353.5016667162813,-2039523070.0,5.629228162623228,0.01388969672998841,3.1058931966824956,3.1058931966824956,41788.85,39617.25,40891.89775927296,41368.7,44175.5,0,1323.0,3.2139804655137136,72908724998.46678
2023-12-26,42513.3,43579.9,43594.9,41796.6,56030.0,67527.9,0.1,43024.43333333333,53.287555162318895,-213.03888476035536,44710.47462508944,41129.30537491056,42470.2687901763,51.015466333385504,1385.272976236547,-2039579100.0,2.473786969412112,-0.02444324609612536,3.2584461244752747,3.2584461244752747,41816.125,39617.25,41032.00584890204,41368.7,44175.5,0,1324.0,3.214119605949965,73042796306.00449
2023-12-27,43446.5,42514.3,43676.7,42115.3,50100.0,67527.9,0.1,43179.43333333333,57.57304385098548,-197.5571217460747,44726.07901184578,41129.380988154226,42563.24319111189,75.31375305941783,1397.8534779339363,-2039529000.0,1.3104967995429584,0.02195077775660792,3.2174133196780788,3.2174133196780788,42383.825,39617.25,41166.50961494596,41368.7,44175.5,0,1325.0,3.214262982802468,73179743431.11765
2023-12-28,42581.1,43446.5,43782.6,42309.3,49840.0,67527.9,0.1,42846.96666666667,52.74087674829225,-243.1082886150748,44557.185980291884,41138.83401970812,42564.94383957743,52.78081549757849,1403.242515224369,-2039578840.0,-1.0337959229208522,-0.019918750647347938,3.2954585842647774,3.2954585842647774,42542.274999999994,39617.25,41295.63323034812,41368.7,44175.5,0,1326.0,3.2144020092049046,73314230882.16008
2023-12-29,42072.4,42581.1,43108.0,41459.0,60980.0,67527.9,0.1,42699.99999999999,50.080047442243455,-301.2079924443144,44457.74658223065,41073.673417769365,42518.034902474814,39.53548924647196,1420.7966212797712,-2039639820.0,0.3420067256552779,-0.011946614812675005,3.3770277456949715,3.3770277456949715,42629.95,39840.95,41419.59190113419,41368.7,44175.5,0,1327.0,3.21453835063169,73447283679.00377
2023-12-30,42136.7,42074.7,42592.2,41527.3,35180.0,67527.9,0.1,42263.399999999994,50.42053825359376,-326.8731583443159,44327.533692128214,41038.45630787179,42481.71729271531,41.20970681664317,1395.3754340455014,-2039604640.0,-0.3193625995642475,0.0015283178520835161,3.311544174189012,3.311544174189012,42707.075,39840.95,44394.6,41368.7,44175.5,0,1328.0,3.214674787501309,73580631920.87653
2023-12-31,42272.5,42141.6,42878.8,41971.4,35580.0,67527.9,0.1,42160.533333333326,51.177930573085554,-325.55560081506917,44257.190259450785,41210.43974054922,42461.79183626623,44.745612664687826,1360.5200458993943,-2039569060.0,2.184743537988873,0.003222843744289383,3.218451820685775,3.218451820685775,42607.075,39840.95,44337.254,41368.7,44175.5,0,1329.0,3.214811666407207,73714493514.0821
2024-01-01,44183.4,42272.5,44187.0,42196.7,36300.0,67527.9,0.1,42864.2,60.35545245585118,-193.37012141531045,44403.99041719392,41333.279582806084,42625.75451852659,92.80555934050969,1405.504328335152,-2039532760.0,3.5717550756334537,0.04520432905553262,3.1810687460339224,3.1810687460339224,42655.175,39840.95,44281.05492,41368.7,44175.5,0,1330.0,3.2149573915214216,73854146173.34677
2024-01-02,44943.7,44182.9,45885.4,44166.0,97840.0,67527.9,0.1,43799.86666666666,63.31061510468386,-59.07641954349742,44753.74028641934,41189.44971358066,42846.51123104787,78.72537502259163,1427.9254477397842,-2039434920.0,6.352211229244199,0.01720782013154243,3.1771426200775292,3.1771426200775292,43376.725,40434.850000000006,41527.3,41368.7,44175.5,1,1331.0,3.215106390436464,73996117142.92961
2024-01-03,42836.1,44943.7,45492.7,40888.3,117650.0,67527.9,0.1,43987.73333333333,51.78661332763193,-113.38925338381728,44745.01373403735,41179.196265962644,42845.51968523379,38.97860759240352,1654.816487186942,-2039552570.0,-1.8933737643944144,-0.04689422544205302,3.863135269520199,3.863135269520199,43234.05,40434.850000000006,45885.4,41368.7,44175.5,1,1332.0,3.215245321398244,74132010857.79184
2024-01-04,44157.0,42836.1,44744.5,42632.8,68050.0,67527.9,0.1,43978.93333333333,57.06179155373511,-64.01254395147714,44862.699605934926,41284.31039406507,42970.422572354386,65.41193892457622,1687.4510238164457,-2039484520.0,0.6636134218151196,0.030836140545007718,3.8214802269548334,3.8214802269548334,43234.05,40434.850000000006,45885.4,41368.7,44175.5,0,1333.0,3.2153902558508407,74271938824.12473
2024-01-05,44156.9,44163.0,44312.1,42629.0,68070.0,67527.9,0.1,43716.666666666664,57.061282544372865,-36.3908826627561,44976.59009964524,41358.93990035476,43083.42042260635,65.40993776390306,1687.140236400985,-2039552590.0,0.42757494501795584,-2.264646601912723e-06,3.8207850560183916,3.8207850560183916,43234.05,40632.5,45785.458,41368.7,44175.5,0,1334.0,3.215534967198961,74411984276.5063
2024-01-06,43967.9,44156.6,44203.2,43424.0,24260.0,67527.9,0.1,44093.93333333333,56.0437368057262,-35.82505172497224,44936.32381102928,41659.12618897072,43167.65657283432,61.627744091573106,1622.287362372343,-2039576850.0,0.5891046524396939,-0.004280191770708597,3.6897085427603846,3.6897085427603846,43303.275,40723.5,45687.514839999996,41368.7,44175.5,0,1335.0,3.2156785776242964,74551590528.17146
2024-01-07,43927.3,43973.5,44481.2,43627.9,29530.0,67527.9,0.1,44017.36666666666,55.813486362385056,-42.694759035282004,44994.13767631317,41728.072323686836,43240.003565897714,60.815272858257806,1567.3596936314611,-2039606380.0,2.200481602549941,-0.0009234009356825501,3.56807655747442,3.56807655747442,43303.275,40790.5,45591.530543199995,41368.7,44175.5,0,1336.0,3.215821777187127,74691192247.95905
2024-01-08,46962.2,43934.2,47196.7,43251.0,103090.0,67527.9,0.1,44952.46666666667,66.79533642780214,142.50373880300685,45786.31968519417,41406.18031480583,43594.49846438364,96.28273413226809,1737.2411440863566,-2039503290.0,7.764608694654468,0.06908915412511107,3.6992328810966195,3.6992328810966195,43958.925,41446.149999999994,40888.3,41368.7,46962.2,0,1337.0,3.2159784321828173,74839610490.15825
2024-01-09,46129.0,46959.2,47880.1,45333.9,100090.0,67527.9,0.1,45672.833333333336,62.223116700342906,191.20055510688985,46172.652442939405,41266.46755706059,43835.879563013776,74.95494722389085,1795.0239195087595,-2039603380.0,8.504867888401975,-0.017741928614928515,3.891313315937392,3.891313315937392,44300.625,41787.85,41014.468,41368.7,46962.2,0,1338.0,3.2161311936263304,74985836215.16078
2024-01-10,46629.3,46112.0,47654.3,44403.6,131480.0,67527.9,0.1,46573.49999999999,63.8243803872582,236.45306428357958,46620.03574564193,41095.42425435808,44101.91960463151,82.11047226751343,1899.0007824009913,-2039471900.0,7.325791490683951,0.01084567192005026,4.07254833849316,4.07254833849316,44300.625,41787.85,41289.09328,41368.7,46962.2,1,1339.0,3.216285935455399,75133607383.3034
2024-01-11,46348.2,46629.3,48923.7,45651.8,131039.99999999999,67527.9,0.1,46368.833333333336,62.22835398991277,226.7684903028288,46945.15230269215,41008.23769730785,44315.85107085708,67.94807974711898,1997.0650122294915,-2039602940.0,8.846882771934023,-0.006028398453333139,4.3088297112498255,4.3088297112498255,44822.425,42309.649999999994,41552.7335488,41368.7,46962.2,1,1340.0,3.216439211926552,75280726585.76546
2024-01-12,42835.9,46348.1,46503.2,41857.9,136920.0,67527.9,0.1,45271.13333333333,46.56112018916288,-23.566388309361855,46941.323585668804,40924.6164143312,44174.90334982307,24.237747965253753,2186.224654213099,-2039739860.0,1.8147288959032524,-0.07578072071838815,5.103720604009951,5.103720604009951,45064.825,42309.649999999994,48923.7,41368.7,46962.2,0,1341.0,3.2165761410584386,75417645303.84373
2024-01-13,42851.3,42836.7,43248.6,42443.3,48180.0,67527.9,0.1,44011.79999999999,46.62457421248407,-186.42996248224222,46943.571986918345,40909.34801308165,44048.84588793516,24.429399905418542,2087.587178912163,-2039691680.0,1.6959087920981135,0.0003595115312156061,4.871700926021294,4.871700926021294,45148.4,42837.6,48923.7,41368.7,46962.2,0,1342.0,3.2167129264862133,75554714916.3635
2024-01-14,41746.1,42851.3,43069.4,41739.6,37140.0,67527.9,0.1,42477.76666666666,42.70544230377784,-357.0198024345656,46996.479852609154,40673.20014739085,43829.536755750865,10.675261965801283,2033.45952327558,-2039728820.0,-1.2452540067419753,-0.025791516243381274,4.871016749530089,4.871016749530089,45118.825,42837.6,48782.384,41368.7,46962.2,0,1343.0,3.2168441520497946,75688449575.34273
2024-01-15,42510.7,41747.6,43348.9,41719.2,52080.0,67527.9,0.1,42369.36666666666,46.082092940214956,-403.3697266444616,46996.567404059584,40672.852595940414,43703.93325520316,20.19065634567035,2004.6195573273249,-2039676740.0,-3.785810960677549,0.01831548336251765,4.715564686837255,4.715564686837255,45113.725,42837.6,48500.67264,41368.7,46962.2,0,1344.0,3.216978874350421,75824669415.26567
2024-01-16,43145.5,42515.2,43563.7,42093.1,63930.0,67527.9,0.1,42467.43333333333,48.78101907547122,-376.7829105406506,46991.61474709309,40647.705252906904,43650.74913566,28.090698658436402,1966.4753032325157,-2039612810.0,-4.001005702690248,0.014932711058627701,4.557776137100081,4.557776137100081,45113.725,42837.6,48093.7842816,41368.7,46962.2,0,1345.0,3.2171164104701284,75962946037.34961
2024-01-17,42768.7,43139.1,43192.3,42211.8,50440.0,67527.9,0.1,42808.29999999999,47.26854187048634,-369.5736677099498,46987.36901858029,40670.710981419696,43566.74445607333,14.567284336178776,1896.0484958587645,-2039663250.0,-0.1573439225326336,-0.008733239851201224,4.433261931877201,4.433261931877201,45113.725,42837.6,47711.309224704,41368.7,46962.2,0,1346.0,3.2172519368314823,76100168440.42891
2024-01-18,41292.7,42763.5,42908.0,40682.6,70350.0,67527.9,0.1,42402.299999999996,41.801081608465616,-444.19387574535324,47051.71258011267,40528.39741988733,43350.16879359015,7.403137930616042,1919.5736032974241,-2039733600.0,-6.4866272618158,-0.03451121965362525,4.648699657076007,4.648699657076007,44803.149999999994,42902.399999999994,47351.78267122176,41368.7,46962.2,0,1347.0,3.217380071855572,76232841164.4977
2024-01-19,41648.0,41293.8,42164.6,40305.4,72640.0,67527.9,0.1,41903.13333333333,43.49538387540507,-448.3097882311614,47083.29769176068,40447.942308239326,43188.057479914896,15.578478354199776,1915.2612030618936,-2039660960.0,-5.681784726735803,0.00860442644825854,4.598687099168973,4.598687099168973,44614.55,43216.45,46818.24805752402,41368.7,46962.2,0,1348.0,3.2175097454674324,76366738236.40623
2024-01-20,41695.4,41647.6,41858.0,41449.5,22270.0,67527.9,0.1,41545.36666666666,43.73073433107193,-426.64688122628587,47115.364639659376,40358.16536034062,43045.899624684906,16.128470812109125,1807.635402843187,-2039638690.0,-5.168543414627489,0.0011381098732232697,4.335335319587261,4.335335319587261,44009.425,43216.45,46166.963251771616,41368.7,46962.2,0,1349.0,3.2176394390465077,76500877388.51938
2024-01-21,41583.2,41695.4,41878.0,41504.5,16110.0,67527.9,0.1,41642.2,43.271292869713,-399.17479956600823,47104.611057916976,40108.89894208302,42906.59489852444,14.826589930728755,1705.1971597829595,-2039654800.0,-5.336317051127672,-0.002690944324793776,4.100687681041766,4.100687681041766,43274.55,43271.0,45580.80692659446,41368.7,46962.2,0,1350.0,3.217768370178241,76634749152.70729
2024-01-22,39556.4,41581.7,41684.9,39468.4,85100.0,67527.9,0.1,40944.99999999999,35.92816384488957,-490.7772707225669,47193.340949844496,39481.4390501555,42587.528717712594,0.9306949541526979,1741.718791227034,-2039739900.0,-15.769704145035787,-0.04874083764597226,4.40312766385979,4.40312766385979,42856.05,43785.1,45053.26623393501,39556.4,46962.2,0,1351.0,3.2178868890926324,76762051410.72249
2024-01-23,39888.8,39555.0,40159.4,38546.9,82670.0,67527.9,0.1,40342.799999999996,37.792644285017445,-500.53419867070056,47326.42297644119,39053.627023558816,42330.5069350733,12.931732325957926,1732.4888775679603,-2039657230.0,-13.527715753647374,0.008403191392543308,4.34329655835212,4.34329655835212,42395.3,43735.3,44383.08228586281,39556.4,46962.2,0,1352.0,3.218006910569821,76890541246.11484
2024-01-24,40086.0,39891.3,40535.2,39510.0,58640.0,67527.9,0.1,39843.73333333333,38.92808067593686,-465.9677809235885,47308.979357372795,38663.9706426272,42116.74436982822,14.832125510754754,1681.9682434559631,-2039598590.0,-14.03259324073062,0.004943743607227935,4.195899424876424,4.195899424876424,42395.3,43735.3,43566.01676584202,39556.4,46962.2,0,1353.0,3.218127732174066,77019763855.4559
2024-01-25,39935.7,40085.1,40285.8,39546.3,46300.0,67527.9,0.1,39970.166666666664,38.3534846080421,-426.5469808655102,47257.97289802061,38292.85710197939,41909.02585841601,17.455349848547648,1614.6490832091088,-2039644890.0,-13.835488756844928,-0.0037494387067804613,4.043122026680662,4.043122026680662,42302.450000000004,43735.3,42863.34041862414,39556.4,46962.2,0,1354.0,3.2182475808065907,77148558808.00778
2024-01-26,41811.3,39942.0,42214.8,39831.2,69470.0,67527.9,0.1,40610.99999999999,48.557824415607556,-255.8896595195805,47133.93871697171,38201.23128302829,41899.718633804965,65.06936692712495,1669.574148694173,-2039575420.0,-2.3919189278152166,0.04696549703648634,3.993117048965645,3.993117048965645,42231.375,43735.3,42259.03876001676,39556.4,46962.2,0,1355.0,3.2183765849364736,77283580568.10039
2024-01-27,42120.9,41811.5,42191.8,41413.0,20460.0,67527.9,0.1,41289.299999999996,50.0282608499566,-111.27720513040867,47011.008478947224,38143.521521052775,41920.78352582354,71.2406314782332,1605.9474237874463,-2039554960.0,-1.7044990467033707,0.007404696816410761,3.8127091866210034,3.8127091866210034,42058.075000000004,43735.3,38546.9,39556.4,46962.2,0,1356.0,3.218506882075238,77419683908.89207
2024-01-28,42030.7,42121.3,42817.1,41649.0,32530.0,67527.9,0.1,41987.633333333324,49.58357325176216,-15.830671331387975,46284.05565265688,38377.32434734312,41931.251761459396,69.44267261999678,1574.6726078026284,-2039587490.0,0.6817403302344376,-0.002141454717254465,3.746481994833844,3.746481994833844,42208.65,43735.3,38619.798,39556.4,46962.2,0,1357.0,3.2186365299427835,77555592505.34735
2024-01-29,43299.8,42031.4,43305.6,41824.7,45230.0,67527.9,0.1,42483.799999999996,55.56784102443298,130.5795826537468,45774.12320962385,38604.33679037614,42061.58968893946,94.73967469303152,1567.974564388155,-2039542260.0,1.8562385470011218,0.03019459585493478,3.6212050965319813,3.6212050965319813,42330.775,43735.3,38787.69008,39556.4,43299.8,0,1358.0,3.2187720300468086,77695601018.27394
2024-01-30,42946.2,43303.3,43817.9,42702.9,55130.0,67527.9,0.1,42758.899999999994,53.65682205088842,197.4033013155247,44986.276681119096,39023.8733188809,42145.83828999284,83.46234111174341,1535.6192383604296,-2039597390.0,-0.46192534563280735,-0.008166319474916861,3.575681290452775,3.575681290452775,42458.850000000006,43735.3,39058.7646752,39556.4,43299.8,0,1359.0,3.2189056437546655,77834607361.53456
2024-01-31,42580.5,42946.2,43739.7,42315.4,56480.0,67527.9,0.1,42942.166666666664,51.67739510955188,209.6185959443427,44061.524885600156,39571.85511439985,42187.23464332686,76.52437867577308,1527.6678641918272,-2039653870.0,-0.4400414321688457,-0.008515305195803013,3.5877170634253406,3.5877170634253406,42458.850000000006,43735.3,39439.495501184,39556.4,43299.8,0,1360.0,3.2190373009117463,77972558638.63895
2024-02-01,43081.4,42580.1,43263.1,41890.5,47690.0,67527.9,0.1,42869.36666666666,54.17120706931392,241.79266668376215,44098.50711970332,39559.422880296675,42272.3932487243,86.02731929425157,1516.5915881781252,-2039606180.0,4.331758397973503,0.011763600709244981,3.520293184943213,3.520293184943213,42699.625,43735.3,39789.767861089276,39556.4,43299.8,0,1361.0,3.2191711278299135,78112190010.90082
2024-02-02,43194.7,43083.7,43459.3,42596.3,42650.0,67527.9,0.1,42952.19999999999,54.74017759981685,259.5030727775383,44151.27162178783,39540.99837821217,42360.23198694103,88.17681654335031,1469.9064747368304,-2039563530.0,3.71374375720322,0.00262990524913298,3.4029787791947403,3.4029787791947403,42708.700000000004,43735.3,40112.01843220214,39556.4,43299.8,0,1362.0,3.219305275692004,78252279015.07707
2024-02-03,43005.7,43194.7,43370.4,42882.0,14570.0,67527.9,0.1,43093.93333333333,53.54592994414384,247.33598555966233,44268.07784860686,39550.15215139314,42421.705131041876,84.59115917283239,1399.7988693984855,-2039578100.0,3.1425528955232367,-0.004375536813544301,3.2549147424608496,3.2549147424608496,42779.925,43735.3,40408.48895762597,39556.4,43299.8,0,1363.0,3.219438316424156,78391874881.34592
2024-02-04,42581.4,43006.2,43113.2,42379.4,20330.0,67527.9,0.1,42927.26666666666,50.863136455794596,201.50005813609283,44275.417076545506,39549.8829234545,42436.914166180744,76.54145323468033,1352.2275215843076,-2039598430.0,2.400488658881482,-0.00986613402409442,3.1756295508938353,3.1756295508938353,43175.375,43735.3,40681.241841015886,39556.4,43299.8,0,1364.0,3.219569125052902,78530222464.56927
2024-02-05,42697.2,42581.4,43532.2,42272.5,39260.0,67527.9,0.1,42761.43333333333,51.576218806703075,170.9726098373984,44213.97733621273,39566.49266378727,42461.703293211154,78.73837981407694,1345.618412899714,-2039559170.0,7.940055212304445,0.0027194972452759814,3.1515378359698394,3.1515378359698394,43234.375,43735.3,40932.174493734616,39556.4,43299.8,0,1365.0,3.2197002745187553,78669036137.23218
2024-02-06,43087.7,42697.6,43375.5,42566.8,33320.0,67527.9,0.1,42788.766666666656,54.00049754431633,168.78155005237556,44258.036434318805,39554.333565681205,42521.32202719105,83.04974581582664,1307.2670976925913,-2039525850.0,8.01954433324641,0.009145798787742576,3.033968157252746,3.033968157252746,42673.175,43735.3,41163.03253423585,39556.4,43299.8,0,1366.0,3.2198330647066915,78809189059.09679
2024-02-07,44339.8,43088.4,44367.9,42783.5,48570.0,67527.9,0.1,43374.899999999994,60.78048291135849,239.0666604468569,44617.36406773254,39499.71593226745,42694.51040555381,99.41720590675297,1327.0623050002634,-2039477280.0,10.611684877513355,0.02905933711941011,2.99293705655024,2.99293705655024,42293.3,43735.3,41375.42193149698,39556.4,43299.8,0,1367.0,3.2199714703644338,78953357445.49548
2024-02-08,45293.3,44346.2,45579.2,44336.4,66380.0,67527.9,0.1,44240.26666666666,65.00995782585767,331.49313289228587,45151.77121792614,39329.83878207386,42942.01417645345,95.02609603340302,1321.0435689288156,-2039410900.0,13.415565521575948,0.02150438206757821,2.9166423487112123,2.9166423487112123,42898.95,43735.3,41674.669738347286,39556.4,43299.8,0,1368.0,3.2201139879262772,79100550798.28357
2024-02-09,47127.5,45293.3,48118.8,45254.2,98110.0,67527.9,0.1,45586.86666666666,71.3994852233119,488.40091032886056,46103.38639919939,38921.4336008006,43340.63187393408,85.21727459810906,1431.297599719615,-2039312790.0,12.714744578618692,0.04049605570801851,3.0370751678311283,3.0370751678311283,44168.75,43735.3,42143.21336974561,39556.4,43299.8,1,1369.0,3.2202643607761723,79253309364.21545
2024-02-10,47758.2,47128.0,48149.0,46875.0,31200.0,67527.9,0.1,46726.333333333336,73.2109988953437,599.5812326798489,47045.46841080606,38596.85158919393,43761.352647845124,93.98769230769227,1420.0620568824995,-2039281590.0,13.383617159177499,0.013382844411437,2.973441329201058,2.973441329201058,44279.35,43735.3,42979.79549798122,39556.4,43299.8,0,1370.0,3.2204172134198723,79408032750.83911
2024-02-11,48277.3,47759.3,48531.6,47590.2,36500.0,67527.9,0.1,47721.0,74.63501610619461,667.7835976626559,47829.5568838675,38684.8531161325,44191.44287185988,96.20838241214278,1385.871909962321,-2039245090.0,14.86199373315221,0.010869337621602249,2.8706491663003546,2.8706491663003546,44470.65,43735.3,43806.868218304226,39556.4,43299.8,0,1371.0,3.220572038972024,79564388278.79668
2024-02-12,49941.3,48280.2,50277.3,47729.9,81850.0,67527.9,0.1,48658.93333333333,78.56789461434553,777.0157603240544,48913.67021215311,38605.98978784689,44739.04831263513,95.99370439261696,1468.8382021078698,-2039163240.0,15.338408029598288,0.03446754478813019,2.941129290002202,2.941129290002202,45343.5,44412.100000000006,44657.31993900947,39556.4,43299.8,0,1372.0,3.2207335264809855,79725565317.80704
2024-02-13,49716.0,49941.0,50326.6,48398.3,78510.0,67527.9,0.1,49311.533333333326,76.83087676132135,783.8967864842061,49721.337917184625,38761.32208281538,45213.04371143179,92.76205829708042,1501.6569019573074,-2039241750.0,15.763443564273446,-0.004511296261811459,3.020470073934563,3.020470073934563,45368.15,44436.75,45781.31595120757,49716.0,43299.8,0,1373.0,3.2208938649908987,79886282562.33934
2024-02-14,51782.4,49708.6,52010.7,49263.8,80350.0,67527.9,0.1,50479.899999999994,80.98354009716246,870.7296692232492,50858.02398441533,38809.306015584654,45838.69669129543,97.7441157289382,1590.602837531785,-2039161400.0,21.610596399760457,0.04156408399710365,3.07170551680066,3.07170551680066,46283.775,45278.8,46690.37276096606,49716.0,43299.8,0,1374.0,3.221062248553279,80052798444.39705
2024-02-15,51901.3,51805.2,52819.4,51327.5,74720.0,67527.9,0.1,51133.23333333333,81.19242263038622,876.8534342118021,51928.92937396343,38747.40062603657,46416.087482600626,91.29507248575412,1583.5526348509434,-2039086680.0,20.47264016489715,0.002296146953405076,3.0510847220608026,3.0510847220608026,46742.3,45683.15,47754.438208772845,49716.0,43299.8,0,1375.0,3.221230863861812,80219814551.91393
2024-02-16,52134.2,51901.4,52556.7,51612.6,52860.0,67527.9,0.1,51939.299999999996,81.61834397604096,837.3459572394861,52881.739398281745,38795.92060171826,46960.66962711485,93.50330428846388,1537.8774466473044,-2039033820.0,20.695826108295694,0.004487363514979359,2.9498437621509574,2.9498437621509574,47130.525,45683.15,48767.43056701827,49716.0,43299.8,0,1376.0,3.221400154285673,80387635872.91385
2024-02-17,51646.0,52134.2,52175.5,50652.3,32450.000000000004,67527.9,0.1,51893.833333333336,77.64876826400675,723.381350862916,53566.822519121015,39072.36748087897,47406.89156738962,88.87445600128946,1536.8290576010681,-2039066270.0,20.091057697002963,-0.00936429445546294,2.9756981326744922,2.9756981326744922,47359.975000000006,45683.15,49577.824453614616,49716.0,43299.8,0,1377.0,3.221567299641569,80554332781.91675
2024-02-18,52117.5,51646.0,52350.3,51199.6,26890.0,67527.9,0.1,51965.899999999994,78.72497332391819,628.3197507760999,54286.7072414806,39234.25275851939,47855.52094192394,93.34496392304847,1509.2484106295635,-2039039380.0,22.394989361552224,0.009129458234906851,2.8958572660422384,2.8958572660422384,48005.95,45683.15,50226.139562891694,49716.0,43299.8,0,1378.0,3.2217360568377376,80722477482.72783
2024-02-19,51783.6,52119.6,52484.8,51694.2,36730.0,67527.9,0.1,51849.033333333326,75.93651823519164,497.2586607312203,54818.10345097283,39586.59654902717,48229.62370935976,89.89719680861437,1457.9163812988809,-2039076110.0,21.281020769511823,-0.0064066772197438615,2.8154017513245138,2.8154017513245138,48193.825000000004,45683.15,50652.3,49716.0,43299.8,0,1379.0,3.2219032753041548,80889908835.30238
2024-02-20,52263.5,51783.1,52936.8,50801.8,68100.0,67527.9,0.1,52054.86666666666,77.18720524571775,401.3056884569128,55296.548890513404,40076.451109486596,48613.802403706446,93.36865846572047,1506.2794969203894,-2039008010.0,21.295636573778605,0.009267412848855683,2.8820869190168845,2.8820869190168845,48358.675,45741.850000000006,52819.4,49716.0,43299.8,0,1380.0,3.2220721326936816,81058812920.71645
2024-02-21,51858.2,52263.5,52367.3,50676.9,59020.0,67527.9,0.1,51968.43333333333,73.70313676889751,274.9817647541263,55634.11812361,40616.561876390006,48922.7926509725,87.45872285009993,1519.430961426076,-2039067030.0,16.956323664067032,-0.007754934131851132,2.929972427554516,2.929972427554516,48921.225000000006,45741.850000000006,52936.8,49716.0,43299.8,0,1381.0,3.2222391764473337,81226810849.70096
2024-02-22,51320.4,51850.2,52015.8,50947.3,50270.0,67527.9,0.1,51814.033333333326,69.23722734037723,127.16144637916477,55804.926755289955,41258.323244710045,49151.13620802273,78.96024783276495,1487.221607038499,-2039117300.0,13.306824629691363,-0.01037058748664621,2.8979150728336083,2.8979150728336083,49196.600000000006,45741.850000000006,52936.8,49716.0,43299.8,0,1382.0,3.2224038725986723,81393525554.1117
2024-02-23,50740.5,51320.6,51532.5,50537.6,43270.0,67527.9,0.1,51306.36666666666,64.68577774140607,-29.35996067637916,55786.5018248677,42050.22817513231,49302.504188211045,63.768187667029565,1452.0557779643207,-2039160570.0,7.666436793804042,-0.01129960015900111,2.861729344338981,2.861729344338981,49558.975,45741.850000000006,52846.404,49716.0,43299.8,0,1383.0,3.2225660325847936,81558816707.30833
2024-02-24,51571.6,50739.6,51689.9,50592.0,20990.0,67527.9,0.1,51210.833333333336,67.93871612027795,-93.01628981558997,55671.8081052529,43063.9418947471,49518.60855123856,74.46601578573294,1426.758936681155,-2039139580.0,7.984806797576127,0.0163794207782737,2.7665593789627527,2.7665593789627527,49575.425,45741.850000000006,52707.87576,49716.0,43299.8,0,1384.0,3.222731257186242,81726569881.11461
2024-02-25,51722.7,51572.1,51952.0,51299.0,23610.0,67527.9,0.1,51344.93333333333,68.50670541628025,-138.31362570804777,55398.9739450724,44239.3260549276,49728.52202254917,76.6828631239316,1371.4904412039298,-2039115970.0,7.13668742866729,0.002929907158203404,2.651621901416457,2.651621901416457,49575.425,45741.850000000006,52577.6592144,49716.0,43299.8,0,1385.0,3.2228968433245186,81894914860.75934
2024-02-26,54495.1,51722.7,54899.1,50925.2,78050.0,67527.9,0.1,52596.46666666667,76.67257100666009,-2.1288522122604263,55403.85598499374,45375.18401500627,50182.48182992544,93.78538026089096,1557.376838260792,-2039037920.0,9.11830488994078,0.0536012234473453,2.857829122729919,2.857829122729919,50556.575,46723.0,50537.6,49716.0,43299.8,0,1386.0,3.2230727810689994,82070832190.09842
2024-02-27,57056.2,54491.1,57555.2,54464.0,100480.0,67527.9,0.1,54424.66666666666,81.45603106595095,227.18654041417358,56034.890789202844,46015.789210797164,50837.12165564683,93.98171599488626,1666.935635527878,-2038937440.0,14.76426100249416,0.04699688595855411,2.921567919924352,2.921567919924352,51980.125,48051.05,50624.83,49716.0,43299.8,0,1387.0,3.223257787792101,82253471660.96292
2024-02-28,62467.6,57048.7,63915.3,56704.9,173640.0,67527.9,0.1,58006.29999999999,87.35579457592877,684.2349921633677,58346.2403558918,45421.8696441082,51944.78625987093,89.17825934203934,2062.8973758473153,-2038763800.0,20.63481028303052,0.09484332990980815,3.302347738423303,3.302347738423303,55160.175,51231.100000000006,50902.0448,49716.0,62467.6,1,1388.0,3.223460909856087,82449225442.01163
2024-02-29,61169.3,62467.1,63653.4,60512.5,119290.0,67527.9,0.1,60231.033333333326,80.72042022503142,830.3059894997064,59832.268787922905,45340.02121207709,52823.31137797846,79.47330258564627,2139.897563286793,-2038883090.0,17.856970827320318,-0.02078357420486776,3.4983195218627525,3.4983195218627525,55160.175,51231.100000000006,51682.840112000005,49716.0,62467.6,0,1389.0,3.223659523186513,82642269275.27841
2024-03-01,62397.7,61157.3,63147.3,60790.9,74960.0,67527.9,0.1,62011.533333333326,82.10540505851385,933.1607158576608,61377.56613893549,45258.67386106453,53735.157913409086,88.65574799853484,2155.362023052022,-2038808130.0,19.686693187964906,0.02008196922312333,3.454233125663321,3.454233125663321,55160.175,51231.100000000006,52416.78770528,49716.0,62467.6,0,1390.0,3.2238619119009004,82838423097.65028
2024-03-02,61994.5,62397.7,62446.3,61621.9,33800.0,67527.9,0.1,61853.833333333336,80.07213867045061,897.2847437742471,62550.73359621428,45457.226403785724,54521.76192165584,85.6417769870755,2060.2933071197344,-2038841930.0,20.037369786624325,-0.006461776635997785,3.3233485343372946,3.3233485343372946,55233.75,51231.100000000006,53106.69844296321,49716.0,62467.6,0,1391.0,3.224062734260188,83033931280.92789
2024-03-03,63135.8,61955.6,63227.3,61399.4,38010.0,67527.9,0.1,62509.333333333336,81.47089167048372,872.8570236401642,63866.04178355131,45461.36821644868,55342.14650054576,94.17313888037556,2043.6937851826108,-2038803920.0,21.141267328632424,0.018409697634467648,3.2369808970229426,3.2369808970229426,55301.525,51231.100000000006,53755.214536385414,49716.0,62467.6,0,1392.0,3.224266997024982,83232334394.88153
2024-03-04,67361.7,63135.8,67822.8,62746.8,123680.0,67527.9,0.1,64164.0,85.52286840168195,1051.7479355870219,65982.51976058619,45109.46023941382,56486.86588144617,97.33239997223055,2260.287086240996,-2038680240.0,30.083076495261047,0.066933498902366,3.3554484020459636,3.3554484020459636,57726.8,53184.850000000006,54364.81966420229,49716.0,62467.6,0,1393.0,3.2244841186436197,83440341051.39006
